Field1	Field2
Ἆ	
ἀάατος	not to be injured, inviolable
ἀαγής	unbroken, not to be broken, hard, strong
ἄατος	insatiate
ἀάω	to hurt, damage
Ἀβαντιάδαο	
Ἀβαντιάδην	
Ἀβαντιάδης	
Ἀβαντίς	
Ἀβαρνίδος	
Ἄβας	
ἀβλής	not thrown or shot
ἀβληχρός	weak, feeble
ἀβόλησαν	
ἀβολήσομεν	
ἄβρομος	very noisy, boisterous
Ἄβυδος	Abydos
ἀγαθός	good
ἀγαίομαι	to be indignant at
ἀγάλλω	to make glorious, glorify, exalt
ἄγαμαι	to wonder, be astonished
Ἀγαμήστορα	
ἀγανός	mild, gentle, kindly
ἀγανόφρων	gentle of mood
ἀγαπάζω	to treat with affection, shew affection to
ἀγαπάω	to treat with affection, to caress, love, be fond of
ἀγαυός	illustrious, noble
ἀγγελία	a message, tidings, news
ἀγγέλλω	to bear a message
ἄγγελος	a messenger, envoy
Ἄγγουρον	
Ἀγγούρου	
ἄγε	come! come on! well!
ἀγείρω	to bring together, gather together
ἀγέλη	a herd
ἀγεληδόν	in herds or companies
ἀγέληθεν	
ἀγέραστος	without a gift of honour, unrecompensed, unrewarded
ἀγέρονται	
ἀγή	a fragment, piece, splinter
ἄγη	wonder, awe, amazement
ἀγηνορία	manliness, manhood, courage
Ἀγηνορίδαο	
Ἀγηνορίδης	
ἀγήνωρ	manly, courageous, heroic
Ἀγήνωρ	
ἀγητός	admirable, wondrous
ἀγινέω	to lead, bring, carry
ἅγιος	devoted to the gods, sacred, holy
Ἀγκαῖος	
ἀγκάλη	the bent arm
ἀγκάς	in or into the arms
ἀγκή	
ἄγκοινα	
ἀγκοίνη	the bent arm
ἀγκύλη	a loop or noose
ἀγκύλος	crooked, curved
ἀγκών	the bend of the arm, the elbow
ἀγλαία	splendour, beauty, adornment
ἀγλαός	splendid, shining, bright, beautiful
Ἁγνιάδαο	
Ἁγνιάδην	
Ἁγνιάδης	
ἁγνίζω	to cleanse away
ἄγνυμι	to break, shiver
ἄγονος	unborn
ἀγορά	an assembly of the people
ἀγοράζω	to be in the ἀγορά
ἀγοράομαι	to meet in assembly, sit in debate
ἀγορευσεν	
ἀγορεύω	to speak in the assembly, harangue, speak
ἀγορῆθεν	from the Assembly or market
ἀγορήνδε	to the Assembly or market
ἄγος	any matter of religious awe
ἀγός	a leader, chief
ἀγοστός	the flat of the hand
ἄγρα	a catching, hunting
ἄγραυλος	dwelling in the field
ἀγρεύς	a hunter
ἀγρέω	to capture, seize
ἄγρηθεν	
ἀγριάς	wild
ἄγριος	living in the fields
ἀγρόθεν	from the country
ἀγροιώτης	a countryman
ἀγρότερος	wild
ἀγρότης	a country-man, rustic
ἀγρώστης	
ἀγυιά	a street, highway
ἄγχαυρος	
ἄγχι	near, nigh, close by
ἀγχίαλος	near the sea
ἀγχιβαθής	deep near shore
ἀγχίγυος	
ἀγχίμολος	coming near
ἀγχίροος	
ἀγχίρροος	
ἀγχόθι	near
ἀγχοῦ	near, nigh
ἄγχω	to compress, press tight
ἄγω	to lead or carry, to convey, bring
ἀγών	a number of people brought together, a gathering, assembly
ἀδαίετος	
ἀδάμας	
ἀδελφός	sons of the same mother
ἀδευκής	not sweet, bitter, cruel
ἀδέψητος	untanned
ἀδήιος	unassailed, unravaged
ἀδήλητος	
ἅδην	to eat their fill
ᾍδης	Hades or Pluto
ἀδινός	close-packed
ἀδμής	untamed
ἀδμῆτις	
Ἄδμητος	
ἄδμητος	unbroken
ἅδος	satiety, loathing
ἀδρανία	
Ἀδράστεια	the Inevitable
ἀέθλιος	
ἀεί	always, for ever
ἀείδω	to sing
ἀεικέλιος	
ἀεικής	unseemly, shameful
ἄειρος	
ἀείρω	to lift, heave, raise up
ἀέκητι	against one's will
ἀέκων	against one's will, unwilling
ἄελλα	a stormy wind, whirlwind, eddy
ἀελλόπος	storm-footed, storm-swift
ἀέναος	ever-flowing
ἀενάων	
ἀέξω	to increase, enlarge, foster, strengthen
ἀεργηλός	
ἀέριος	in the mist or thick air of morning
ἀερσίλοφος	
ἀερτάζω	to lift up
ἀετός	an eagle
ἀζαλέα	
ἀζαλέος	dry, parched
ἀζηχής	unceasing, excessive
ἅζομαι	to stand in awe of, dread
ἀήθεια	unaccustomedness
ἀήθεον	
ἀηθέσσω	to be unaccustomed to
ἄημι	to breathe hard, blow
ἀήρ	the lower air, the air
ἀήσυρος	light as air, small, little
ἀήτη	
ἀήτης	a blast, gale
ἄητος	stormy, furious
Ἀθαμαντίδος	
Ἀθαμάντιος	
Ἀθάμας	
ἀθάνατος	undying, immortal
ἀθερίζω	to slight, make light of
ἀθέσφατος	beyond even a god's power to express: ineffable, aweful
Ἀθῆναι	the city of Athens
Ἀθηναῖος	Athenian, of or from Athens
Ἀθήνευς	
Ἀθήνη	Athena
ἀθλεύω	to contend for a prize, combat, wrestle
ἀθλέω	having contended with
ἄθλιος	gaining the prize
ἆθλον	the prize of contest
ἆθλος	a contest for a prize
ἀθρέω	to look at, gaze at, observe, perceive
ἀθρόος	in crowds or masses, crowded together
ἄθυρμα	a plaything, toy: a delight, joy
ἀθύρω	to play, sport
Ἄθως	mount Athos
αἴ	ha!
αἶα	
Αἶα	
Αἰαίη	
Αἰακίδης	son of Aeacus
Αἰακός	
Αἶανδε	
Αἴας	Ajax
Αιβύην	
αἵγ'	
Αἰγαῖος	Aegaean
αἰγανέη	a hunting-spear, javelin
ἀίγδην	
αἵγε	
αἴγειος	of a goat or goats
αἴγειρος	the poplar
αἰγιαλός	the sea-shore, beach, strand
Αἰγιαλός	
Αἴγινα	Aegina
αἰγίνη	
Αἰγίνηθεν	
Αἴγλη	
αἴγλη	the light of the sun, radiance
αἰγλήεις	dazzling, radiant, lustrous
αἰγλήτης	
Αἴγυπτος	the river Nile
αἰδέομαι	to be ashamed to do
αἰδέσσασθε	
ἀίδηλος	making unseen, annihilating, destroying
Αἵδης	
ἀιδνός	unseen, dark
αἰδοῖος	regarded with reverence, august, venerable
ἀιδρείη	want of knowledge, ignorance
ἄιδρις	unknowing, ignorant
αἰδώ	
αἰδώς	a sense of shame, shame, modesty, self-respect
fαιετάουσι	
αἰζηός	strong, lusty, vigorous
Αἰήτης	
αἰθαλέοι	
Αἰθαλίδεω	
Αἰθαλίδην	
Αἰθαλίδης	
Αἰθαλίην	
αἰθαλόεις	smoky, sooty
αἴθε	would that
αἰθέριος	of or in the upper air, high in air, on high
Αἴθη	
αἰθήρ	ether, the brighter purer air, the sky
Αἰθίοψ	burnt-face
αἰθος	
αἶθος	a burning heat, fire
αἴθουσα	the corridor
αἰθρηγενής	born in ether, sprung from ether
αἴθυια	a gull or diver
αἴθω	to light up, kindle
αἷμα	blood
αἱματόεις	blood-red or of blood
Αἱμονίῃ	
Αἱμονιῆες	
Αἱμονίην	
Αἱμονίηνδε	
Αἱμονίης	
αἱμύλιος	
αἱμύλος	flattering, wheedling, wily
αἰνέω	to tell or speak of
αἴνη	praise, fame
Αἰνήιον	
Αἰνήτη	
αἰνοπαθής	suffering dire ills
αἶνος	a tale, story
αἰνός	dread, dire, grim
αἴνυμαι	to take, take off, take hold of
αἴξ	a goat
ἄιξ	
Αἰολίδης	
αἰόλος	quick-moving
Αἴολος	
αἰπεινός	high, lofty
αἰπήεις	
αἰπός	high, lofty
αἶπος	a height, a steep
αἰπος	
αἰπύς	high and steep, lofty
αἰπυτέρην	
αἰπύτεροι	
αἱρέω	to take with the hand, grasp
αἴρω	to take up, raise, lift up
Αἶσα	the goddess of destiny
αισα	
Αἴσηπος	
αἴσιμος	fatal
αἴσιος	boding well, auspicious
αἶσις	
Αἰσονίδαο	
Αἰσονίδεω	
Αἰσονίδη	
Αἰσονίδῃ	
Αἰσονίδην	
Αἰσονίδης	
ἀίσσω	to move with a quick shooting motion, to shoot, dart, glance
ἄιστος	not to be seen, unseen
αἶσχος	shame, disgrace
αἰσχρός	causing shame, abusive
αἰσχύνω	to make ugly, disfigure, mar
Αἴσων	
Αἰσωνίδα	
αἰτέω	to ask, beg
Αἰτωλίς	
Αἰτωλοί	
Αἰτωλός	
αἶψα	quick, with speed, on a sudden
ἀίω	
αἰών	a period of existence
αἰωρέω	to lift up, raise
ἄκαινα	a thorn, goad
Ἀκακαλλίς	
ἀκάματος	without sense of toil
ἄκαμπτος	unbent, that will not bend, rigid
ἄκανθα	a thorn, prickle
Ἄκαστος	
ἄκαστος	
ἀκέοις	
ἀκέομαι	to heal, cure
ά̓κεστοριην	
ἀκέων	softly, silently
ἀκή	a point
ἀκήδεια	
ἀκήδεστος	uncared for, unburied
ἀκηδής	uncared for, unburied
ἀκήν	softly, silently
ἀκηράσιος	unmixed
ἀκήρατος	unmixed, uncontaminated, undefiled
ἀκήριος	unharmed by the Κῆρες, unharmed
ἀκίνητος	unmoved, motionless
ἀκλεής	without fame, inglorious, unsung
ἀκλειής	
ἄκμηνος	fasting
ἀκμόνιον	
ἄκμων	a thunderbolt
ἄκνηστις	the spine or backbone
ἀκοή	a hearing, the sound heard
ἀκοίτης	a bedfellow, spouse, husband.
ἄκοιτις	a spouse, wife
ἀκοντοβόλος	
ἀκόρητος	insatiate, unsated in or with
ἄκος	a cure, relief, remedy for
ἀκουάζομαι	to hearken
ἀκουή	
ἀκούω	to hear
ἄκρα	a headland, foreland, cape
ἀκράαντος	unfulfilled, fruitless
ἀκραής	blowing strongly, fresh-blowing
ἄκρατος	unmixed, sheer
ἀκρέμων	a branch, twig, spray
ἄκρις	a hill-top
ἄκριτος	undistinguishable, unarranged, disorderly
ἄκρον	the highest or furthest point
ἄκρος	at the furthest point
ἀκροχάλιξ	
ἄκρων	
ἀκταῖος	on the coast
ἀκτέα	the elder-tree
ἀκτή	a headland, foreland, promontory, shore
ἄκτιον	
Ἄκτιον	
ἄκτιος	haunting the shore
ἀκτίς	a ray, beam
Ἀκτορίδης	
ἄκτωρ	a leader
Ἄκτωρ	
ἀκωκή	a point
ἄκων	a javelin, dart
ἅλαδε	to or into the sea
ἀλάλημαι	to wander
ἀλαλητός	the shout of victory
ἄλαλκε	to ward
ἀλαλκήσουσιν	
ἀλάομαι	to wander, stray or roam about
ἀλαός	not seeing, blind
ἀλγινόεις	painful, grievous
ἄλγος	pain
ἀλεγεινός	hard
ἀλεγίζω	to trouble oneself about
ἀλεγύνω	to care for, furnish
ἀλέγω	to trouble oneself, have a care
ἀλεείνω	to avoid, shun
ἀλείτης	one who flees from punishment, a culprit, a sinner
ἀλεξητήρ	one who keeps off
ἀλέξω	to ward or keep off, turn away or aside
ἀλέομαι	to avoid, shun
ἀλεός	
Ἀλεός	
ἀλετρεύω	to grind
ἀλέω	to grind, bruise, pound
ἀλεωρή	avoidance, escape
ἁλία	an assembly of the people
ἀλίαστος	unshrinking, unabating
ἁλίβροχος	
ἀλίγκιαι	
ἁλίη	
ἁλιμυρήεις	flowing into the sea
ἁλιμυρής	sea-flowing
ἅλιος	
ἁλιόω	to make fruitless, frustrate, disappoint
ἁλίπλαγκτος	roaming the sea
ἁλίπλοος	covered with water
ἁλίς	
ἅλις	in heaps, crowds, swarms, in abundance, in plenty
ἁλίσκομαι	to be taken, conquered
ἀλιταίνω	to sin or offend against
ἀλιτήμων	
ἀλιτήριος	sinning or offending against
ἀλιτρία	sinfulness, mischief
ἀλιτρός	sinful, sinning
ἀλιτροσύνη	
ἄλκαρ	a safeguard, defence
ἀλκή	strength
ἀλκήεις	valiant, warlike
Ἀλκιμέδῃ	
Ἀλκιμέδη	
Ἀλκιμέδην	
Ἀλκίνοος	
ἀλκυονίς	
ἀλκυών	the kingfisher
Ἄλκων	
ἀλλά	otherwise, but
ἄλλῃ	in another place, elsewhere
ἄλληκτος	unceasing, ceaseless
ἀλλήλων	of one another, to one another, one another
ἀλλοδαπός	belonging to another people or land, foreign, strange
ἄλλοθεν	from another place
ἄλλοθι	elsewhere, in another place, in a strange
ἀλλοῖος	of another sort or kind, different
ἅλλομαι	to spring, leap, bound
ἄλλος	alius, another, one besides
ἄλλοτε	at another time, at other times
ἄλλυδις	elsewhither
ἄλλως	in another way or manner
ἅλμη	sea-water, brine
ἁλμυρός	salt, briny
ἀλοιφή	anything used for anointing, hog's-lard, grease, unguent
Ἀλόπη	
Ἁλοσύδνη	Sea-born
ἄλοχος	a bedfellow, spouse, wife
ἅλς	a lump of salt
ἀλσηίδες	
ἄλσις	
ἄλσος	a glade or grove
ἀλυκτοπέδαι	galling bonds
ἄλυξις	an escape
Ἅλυς	
ἄλυς	listlessness, ennui
ἀλύσκω	to flee from, shun, avoid, forsake
ἀλύσσω	to be uneasy, be in distress
ἀλύω	to wander in mind
ἀλωεύς	
ἀλωή	a threshing-floor
Ἀλωιάδας	
Ἀλωιάδῃσι	
ἁλώιος	
ἁλώνης	
ἅμα	at once, at the same time
ἁμαδρυάδος	
Ἀμαζονίδες	
Ἀμαζόνιος	
Ἀμαζονίς	
Ἀμαζών	the Amazons
ἄμαθος	sandy soil
ἀμαθύνω	to level with the sand, utterly destroy
ἀμαιμάκετος	irresistible
ἀμαλδύνω	to soften
ἄμαξα	a wagon, wain
ἁμαξιτός	
ἆμαρ	
ἀμάρα	a trench, conduit, channel
Ἀμαραντίου	
Ἀμαραντῶν	
ἁμαρτάνω	to miss, miss the mark
ἀμαρυγή	a sparkling, glancing
ἀμάρυγμα	a sparkle, twinkle
ἀμαρύσσω	to sparkle, glance
ἀμάω	
ἀμβολίη	
ἀμβροσία	
ἀμβροσίη	ambrosia
ἀμβρόσιος	immortal
ἄμβροτος	immortal, divine
ἀμέγαρτος	unenviable
ἀμείβω	to change, exchange
ἀμείδητος	
ἀμείλικτος	unsoftened, cruel
ἀμείνων	better, abler, stronger, braver
ἄμεμπτος	not to be blamed, blameless
ἀμεμφής	
ἀμενηνός	powerless, fleeting, feeble
ἀμέργω	to pluck or pull
ἀμέρδω	to deprive of, bereave of
ἀμεύσιμος	
ἀμήρυτος	
ἄμητος	a reaping, harvesting
ἀμηχανέω	to be at a loss for
ἀμηχανής	
ἀμηχανία	want of means, helplessness, impotence
ἀμήχανος	without means
ἄμμιγα	
ἄμμος	sand
ἀμνήμων	unmindful, forgetful
Ἀμνισίδος	
Ἀμνισός	
ἀμοιβαδίς	by turns, alternately
ἀμοιβαδόν	
ἀμοιβαῖος	giving like for like, retributive
ἀμοιβή	a requital, recompense, compensation, return, payment
ἀμοιβήδην	
ἀμοιβηδίς	alternately, in succession
ἀμορβάς	
ἁμός	
ἄμοτον	
ἄμοτος	raging, savage
ἄμπελος	a vine
ἀμπέχω	to surround, cover
ἀμπλάκημα	an error, fault, offence
ἀμπλακία	
ἄμπν	
Ἀμπυκίδεω	
Ἀμπυκίδην	
Ἀμπυκίδης	
ἀμσίβων	
ἄμυδις	together, at the same time
Ἀμύκλαι	a sort of shoes
Ἀμύκλης	
Ἄμυκος	
ἀμύμων	blameless, noble, excellent
Ἀμυμώνη	
ἀμύνω	to keep off, ward off
ἄμυρον	
ἄμυρος	
ἀμφαγαπάζω	to embrace warmly, treat kindly, greet warmly
ἀμφαγείρομαι	to gather round
ἀμφάδιος	public
ἀμφαδόν	publicly, openly, without disguise
ἀμφαδός	
ἀμφασίη	speechlessness
ἀμφαφάω	to touch or feel all round, to handle
ἀμφήριστονπαρθεσθαι	
ἀμφήριστος	contested on both sides
ἄμφθ	
ἀμφί	on both sides
ἀμφίαλος	sea-girt
ἀμφιβάλλω	to throw or put round
ἀμφιγύεις	he that halts in both feet, the lame one
ἀμφίγυος	pointed at each end, double-pointed
ἀμφί-δαίω	
Ἀμφιδάμας	
ἀμφί-δεῖ	
ἀμφί-δέω	
ἀμφίδυμος	two-fold, double
ἀμφιέπω	to go about, be all round, encompass
Ἀμφίθεμις	
ἀμφί-θρῴσκω	
ἀμφικαλύπτω	to cover all round, enwrap, enfold
ἀμφιλαφής	taking in on all sides, widespreading
ἀμφιλύκη	the morning-twilight, gray of morning
ἀμφί-μάρπτω	
ἀμφινέμομαι	to feed around
Ἄμφιος	
ἀμφί-παλύνω	
ἀμφιπένομαι	to be busied about, take charge of
ἀμφιπίπτω	to fall around
ἀμφιπολέω	to attend constantly, to attend on, watch, guard
ἀμφίπολος	busied about, busy
ἀμφιπονέομαι	to attend to
ἀμφιρρῶγας	
ἀμφίρυτος	flowed around, sea-girt
ἀμφίς	on or at both sides
ἀμφίτομος	
Ἀμφιτρίτη	
ἀμφιφορεύς	a large jar with two handles
Ἄμφιων	
ἀμφότερος	each or both of two
ἀμφοτέρωθεν	from or on both sides, utrinque
Ἀμφρυσσοῖο	
ἄμφω	
ἄν	
ἄνα	
ἀνά	up, upon
ἀνά-ἀλδήσκω	
ἀναβλύεσκε	
ἀναβλύζω	to spout up
ἀναβράσσω	to boil well, seethe
ἀνά-βρόχω	
ἀναγκαίη	
ἀναγκαῖος	with or by force
ἀνάγκη	force, constraint, necessity
ἀνάγω	to lead up
ἀναδαίω	to light up
ἀναδείκνυμι	to lift up and shew
ἀναδέρκομαι	to look up
ἀναδέχομαι	to take up, catch, receive
ἀναδέω	to bind or tie up
ἀναδύνω	to come to the top of water
ἀνάεδνος	without bridal gifts
ἀνά-ἕζομαι	
ἀναείρω	to lift up
ἀνά-ἕννυμι	
ἀνά-ἐράω	
ἀνά-ἐρέπτομαι	
ἀνά-ἐρεύγομαι	
ἀνά-ἐρέφω	
ἀνά-ἐφάλλομαι	
ἀνά-ἐφύω	
ἀναζείουσα	
ἀνά-θρῴσκω	
ἀναιδής	shameless
ἀναίδητος	
ἀναιμωτί	without shedding blood
ἀναίνομαι	to reject with contempt, turn one's back on, spurn
ἀναίσσω	
ἀνά-ἴσχω	
ἀνακαλέω	to call up the dead
ἀνάκειμαι	to be laid up
ἀνακηκίω	to spout up, gush forth
ἀνακλίνω	to lean
ἀνά-κλύζω	
ἀνακρούω	to push back, stop short, check
ἀνακτορία	management
ἀνακτόριος	belonging to a lord or king, royal
ἀνάλκεια	want of strength, feebleness
ἄναλκις	without strength, impotent, feeble
ἀναλύω	to unloose, undo
ἀνά-μαρμαίρω	
ἀνάμιγα	promiscuously
ἄναξ	a lord, master
ἀνά-ὀχλίζω	
ἀναπάλλω	to swing to and fro
ἀναπαύω	to make to cease, to stop or hinder from
ἀναπεπταμένος	
ἀναπετάννυμι	to spread out, unfold, unfurl
ἀναπέτομαι	to fly up, fly away
ἀναπίμπλημι	to fill up
ἀναπλέω	to sail up, to go up stream
ἀνάπνευσις	recovery of breath, respite from
ἀναπνέω	to breathe again, take breath
ἀναπτύω	to spit up, sputter
ἀνάπτω	to make fast on or to
ἀνά-ῥέπω	
ἀναρπάγδην	
ἀναρπάζω	to snatch up
ἀναρρήγνυμι	to break up
ἀνάρσιος	not fitting, incongruous
ἀναρτάω	to hang to
ἀνασειράζω	to draw back with a rein, to hold in check
ἄνασσα	a queen, lady, mistress
ἀνάσσω	to be lord, master, owner, to rule, in
ἀνασταχύεσκον	
ἀνασταχύουσιν	
ἀνασταχύωσι	
ἀναστένω	to groan aloud
ἀνά-σχέθω%	
ἀνατέλλω	to make to rise up or to grow up
ἀνά-τεταγών	
ἀνατίθημι	to lay upon
ἀνατλῆναι	to bear up against, endure
ἀνατολή	a rising, rise
ἄναυδος	speechless, silent
ἄναυρος	
Ἄναυρος	a torrent
ἀναφαίνω	to make to give light, make to blaze up
ἀναφανδά	visibly, openly
ἀναφέρω	to bring or carry up
Ἀνάφη	
ἀνά-φυσιάω	
ἀνά-φυσιόω	
ἀνά-φύω	
ἀναχάζω	to make to recoil, force back
ἀνά-χαλάω	
ἀναχέω	to pour forth
ἀναχώννυμι	to heap up into a mound
ἀναψύχω	to cool, to revive by fresh air, to refresh
ἁνδάνω	to please, delight, gratify
ἄνδιχα	asunder, in twain
ἀνδραχθής	loading a man, as much as a man can carry
ἀνδρόμεος	of man or men, human
ἀνδροφόνος	man-slaying
ἀνδρόω	to rear up into manhood
ἀνέβραχε	clashed or rung loudly
ἀνεγείρω	to wake up, rouse
ἄνειμι	to go up
ἀνείρω	to fasten on or to, to string
ἀνέλκω	to draw up
ἄνεμος	wind
ἀνεμόω	to expose to the wind:—
ἀνέραμαι	to love again, love anew
ἀνέρομαι	to enquire of, question
ἀνερύω	to draw up, haul up
ἀνέρχομαι	to go up
ἄνευθε	without
ἀνευρίσκω	to find out, make out, discover
ἀνέχω	to hold up
ἄνεω	without a sound, in silence
ἄνη	fulfilment
ἀνηλέες	
ἀνήνυστος	ineffectual
ἀνήνυτος	endless
ἀνηπύω	to cry aloud, roar
ἀνήρ	a man
ἀνηρεφής	
ἀνήυσεν	
ἀνθεμόεις	flowery
Ἀνθεμοεισίδα	
ἄνθος	a blossom, flower
ἄνθρωπος	man
ἀνία	grief, sorrow, distress, trouble
ἀνιάζω	to grieve, distress
ἀνῖαι	
ἀνιάομαι	to cure again, repair
ἀνιαρός	grievous, troublesome, annoying
ἀνιάχω	to cry aloud
ἀνιάω	to grieve, distress
ἀνίημι	to send up or forth
ἀνίστημι	to make to stand up, raise up
ἀνιώνδη	
ἄνοιστος	referred
ἄνοος	without understanding, foolish, silly
ἀνόρνυμι	to rouse, stir up
ἀνορούω	to start up, leap up
ἀνούτατος	unwounded
ἄντα	over against, face to face
ἀνταῖος	set over against, right opposite
ἀντάξιος	worth just as much as
ἀντάω	to come opposite to, meet face to face, meet with
ἄντη	
ἄντην	against, over against
ἀντηχέω	to sound or sing in answer
ἀντί	over against, opposite. c. gen.
ἀντιάζω	to meet face to face
ἀντιάνειρα	a match for men
ἀντί-ἀντιβολέω	
ἀντιάω	to go for the purpose of meeting
ἀντιβίην	against, face to face
ἀντίβιος	opposing force to force
ἀντιβολέω	to meet by chance
ἀντιβόλησις	
ἀντιβολία	entreaty, prayer
ἀντί-ἰάχω	
ἀντικρύ	over against, right opposite
ἀντίξοος	opposed, adverse
ἀντίον	
Ἀντιόπη	
ἀντίος	set against
ἀντιπέρα	the opposite coast
ἀντιπέραιαν	
ἀντιπέρας	over against, on the other side
ἀντιπέρηθεν	from the opposite side
ἀντισπάω	to draw the contrary way, hold back
ἀντιφέρω	to set against
ἄντομαι	to meet
ἄντρον	
ἀντώπιος	
ἄνυσις	accomplishment
ἀνυστός	to be accomplished, practicable
ἀνύω	to effect, achieve, accomplish, complete
ἄνω	
ἄνωγα	to command, order
ἀνωγή	
ἄνωθεν	from above, from on high
ἀνώιστος	unlooked for, unexpected
Ἄξεινος	the Axine
ἄξεινος	
ἄξενος	inhospitable
ἄξιος	weighing as much, of like value, worth as much as
ἄξων	an axle
ἀοιδή	song, a singing
ἀοίδιμος	sung of, famous in song
ἀοιδός	a singer, minstrel, bard
ἀολλής	all together, in throngs, shoals or crowds
ἀολλίζω	to gather together
Ἀονίοιο	
Ἀονίοισιν	
ἀοσσητήρ	an assistant, helper, aider
ἁπαλός	soft to the touch, tender
ἀπαμείρω	to deprive one of share in
ἀπαναίνομαι	to disown, reject
ἀπάνευθε	afar off, far away
ἀπαρνέομαι	to deny utterly, deny
ἅπας	quite all, the whole
ἄπαστος	not having eaten, fasting
ἀπατάω	to cheat, trick, outwit, beguile
ἀπαυράω	to take away or wrest from, rob of
ἄπαυστος	unceasing, never-ending
ἀπειλέω	
ἄπειμι	
ἀπειρέσιος	boundless, immense, countless
ἀπείριτος	
ἀπείρων	
ἀπελαύνω	to drive away, expel from
ἀπερείσιος	countless
ἀπερύκω	to keep off or away
ἀπέρχομαι	to go away, depart from
ἀπηλεγέοντες	
ἀπηλεγέως	without caring for anything, reckless of consequences, bluntly
ἀπήμων	unharmed, unhurt
ἀπήνεια	
ἀπήνη	a four-wheeled wagon
ἀπηνής	ungentle, harsh, rough, hard
ἀπηρής	
Ἀπιδανῆες	
Ἀπιδανός	
ἀπιθέω	he disobeyed
ἄπιος	
Ἀπίς	
ἄπλατος	unapproachable, terrible
ἄπλετος	boundless, immense
ἄπλητος	
ἄπλοος	not sailing, unfit for sea, not sea-worthy
ἄπνοος	without breath, lifeless
ἀπό	from, away from. c. gen.
ἀπό-ἀπαφίσκω	
ἀπό-βλώσκω	
ἀποδείκνυμι	to point away from
ἀποδέχομαι	to accept from
ἀπό-ἕζομαι	
ἀπό-ἐργέω	
ἀπό-ἔργνυμι	
ἀπό-ἐρητύω	
ἀπό-ἥδομαι	
ἀποfηλόθι	
ἄποινα	a ransom or price paid
ἄποινος	
ἀποίχομαι	to be gone away, to be far from
ἀποκαίνυμαι	to surpass or vanquish
ἀπό-κατατίθημι	
ἀπό-κίδναμαι	
ἀπό-κίδνημι	
ἀποκλύζω	to wash away
ἀποκριδόν	
ἀποκρίνω	to separate, set apart
ἀπολάμπω	to shine or beam from
ἀπολείπω	to leave over or behind
ἀπολείχω	to lick clean
ἀπολήγω	to leave off, desist from
Ἀπόλλων	Apollo
ἀπολυμαίνομαι	to wash dirt off oneself, cleanse oneself by bathing
ἀπολύω	to loose from
ἀπομόργνυμι	to wipe off or away from
ἀποναίω	to remove, to send away
ἀπονίζω	wash off
ἀπονίναμαι	to have the use or enjoyment of
ἀπονίσσομαι	to go away
ἀπονόσφι	far apart or aloof
ἀπονοσφίζω	to put asunder, keep aloof from
ἀπό-ὄρνυμι	
ἀποπλάζω	to lead astray from
ἀποπνέω	to breathe forth
ἀπό-προβάλλω	
ἀπόπροθε	from afar, afar off, far away
ἀπόπροθεν	
ἀπόπροθι	far away
ἀπό-προλείπω	
ἀποπτύω	to spit out
ἀπόρθητος	not sacked, unravaged
ἀπορούω	to dart away
ἀπορρίπτω	to throw away, put away
ἀπορρώξ	broken off, abrupt, sheer, precipitous
ἀποσκεδάννυμι	to scatter abroad, disperse
ἀποστείχω	to go away, to go home
ἀποστρέφω	to turn
ἀποστυγέω	to hate violently, abhor, loathe
ἀπό-τεκμαίρομαι	
ἀποτέμνω	to cut off, sever
ἀποτηλόθι	
ἀποτηλοῦ	far away
ἀποτίθημι	to put away, stow away
ἀποτίνω	to pay back, repay, return
ἀποτμηγέντες	
ἀποτμῆγι	
ἀποτμήγω	to cut off from
ἀποτρέπω	to turn
ἀποτροπία	
ἀποτρωπάω	
ἀπό-ὕω	
ἀποφέρω	to carry off or away
ἀποφθινύθω	to perish
ἀποφθίνω	to perish utterly, die away
ἀποφλύξωσιν	
ἄπρακτος	doing nothing, ineffectual, unprofitable
ἀπρόφατος	
ἀπτερέως	
ἀπτήν	unfledged, callow
ἅπτω	to fasten, bind fast
ἀπύργωτος	not girt with towers
ἄπωθεν	from afar
ἄῤ	
ἀρά	a prayer
ἄρα	
ἀραβέω	to rattle, ring, clash
Ἀραιθυρέηθεν	
ἀραιός	thin, narrow, slight, slender
Ἀράξεω	
ἀράομαι	to pray to
ἀραρίσκω	to join, join together, fasten
ἀράσσω	to strike hard, smite
ἀργαλέος	painful, troublous, grievous
Ἀργανθώνειον	
ἀργεστής	clearing, brightening
ἀργέω	to lie idle, be unemployed, do nothing
ἀργινόεις	white
ἀργιόδων	
Ἀργόθεν	from Argos
Ἀργός	
ἀργός	
Ἄργος	
ἀργύρεος	silver, of silver
ἀργύφεος	silver-white
Ἀργώ	the Argo or swift
Ἁργῴης	
Ἀργῷος	of the Argo
ἀρδμός	a watering-place
ἄρδω	to water
ἄρειος	devoted to Ares, warlike, martial
ἀρείων	better, stouter, stronger, braver, more excellent
ἀρέμ	
Ἄρεος	
ἀρέσκω	to make good, make up
ἄρεσσαν	
Ἀρεστορίδης	
ἀρετάω	to be fit or proper, to thrive, prosper
ἀρετή	goodness, excellence
ἀρή	
ἀρήγω	to help, aid, succour
ἀρηίθοος	swift as Ares, swift in battle
Ἀρήιος	
ἀρηίφιλος	dear to Ares, favoured of the god of war
Ἀρηίφιλος	
Ἀρήνηθεν	
ἀρηότα	
ἀρηρεμένας	
ἀρηρέμενον	
ἀρηρεμένους	
Ἄρης	Ares
ἀρήτειρα	
ἀρήτειρακαι	
Ἀρήτη	
Ἀρητιάδης	
Ἀρητιάδι	
Ἀρητιάδος	
Ἀρητιάς	
Ἄρητος	
ἀρθμέω	to be united
ἄρθμιος	united
ἀρθμός	a bond, league, friendship
Ἀριάδνη	
ἀρίγνωτος	easy to be known
ἀρίδηλος	very distinct, far seen
ἀρίζηλος	conspicuous, very distinct
ἀριήκοος	
ἀριθμέω	to number, count or reckon up
ἀριπρεπής	very distinguished, stately
Ἄρις	
Ἀρισταῖος	
ἀριστάω	to take breakfast or luncheon
ἀριστερός	left, on the left
ἀριστεύς	the best man
ἄριστον	the morning meal, breakfast
ἄριστος	best
ἀριφραδής	easy to be known, very distinct, manifest
Ἀρκαδία	
Ἀρκαδίη	
Ἀρκαδίηθεν	
Ἀρκαδίηνδε	
Ἀρκάς	
ἀρκέσσαι	
ἄρκευθος	
ἄρκιος	sufficient, sure, certain
ἄρκος	
Ἄρκτος	
ἄρκτος	a bear
Ἀρκτοῦρος	the time of his rising
Ἅρμα	
ἅρμα	a chariot
ἁρμαλιά	
ἄρμενα	the tackling or rigging
ἁρμόζω	to fit together, join
ἁρμονία	a fastening
Ἁρμονίη	
ἀρνειός	a young ram or wether
ἄρον	
ἄρος	
ἄροσις	arable land, corn-land
ἀρόσσαι	
ἀρόσσῃς	
ἀροτήρ	a plougher, husbandman
ἀρότης	
ἄροτος	a corn-field
ἀροτρεύς	a ploughman
ἄροτρον	a plough
ἄρουρα	tilled or arable land, seed-land, cornland
ἀροὔρας	
ἀρόω	to plough
ἁρπάγδην	
ἁρπάζω	to snatch away, carry off
ἁρπαλέος	greedy
ἅρπη	a kite
Ἅρπυια	
Ἅρπυιαι	the snatchers
Ἄρπυιαι	
ἄρρηκτος	unbroken, not to be broken
ἄρρητος	unspoken, unsaid
ἄρσην	male
Ἀρτακέα	
Ἀρτακίη	
ἀρτεμής	safe and sound
Ἄρτεμις	Artemis
ἄρτι	just, exactly
ἀρτίτομος	
ἀρτύνω	to arrange, prepare, devise
ἀρύω	to draw
ἀρχεύω	to command
ἄρχω	to be first
ἀρωγή	help, aid, succour, protection
ἀρωγός	aiding, succouring, propitious, serviceable
ἆσθμα	a breath, breathing
ἄσθμα	
Ἀσία	Asia
Ἄσιας	
Ἀσίης	
ἄσιος	
Ἄσιος	Asian
ἀσκέω	to work curiously, form by art, fashion
ἀσκηθής	unhurt, unharmed, unscathed
ἀσπάσιος	welcome, gladly welcomed
ἀσπαστός	welcome
ἀσπερχές	hastily, hotly, vehemently
ἄσπετος	unspeakable, unutterable, unspeakably great
ἀσπίς	a round shield
ἆσσον	nearer, very near
Ἀσσυρία	Assyria, the country of the Assyrians
Ἀσσύρια	
Ἀσσύριος	
ἀσταγής	
ἀστεμφής	unmoved, unshaken
ἀστέριος	
Ἀστέριος	
ἀστερίων	
Ἀστερίων	
Ἀστερόδεια	
ἀστερόεις	starred, starry
ἀστεροπή	lightning
ἀστήρ	a star
ἀστός	a townsman, citizen
ἀστράγαλος	one of the neck-vertebrae
ἀστράπτω	to lighten, hurl lightnings
ἄστρον	the stars
ἄστυ	a city, town
Ἀστυπαλαία	
ἀσχαλάω	to be distressed, grieved
ἄσχετος	not to beheld in or checked, irrepressible, ungovernable
Ἀσωπίς	
Ἀσωπός	
Ἀταλάντη	
ἀτάλαντος	equal in weight, equivalent
ἀτάλλω	to skip in childish glee, gambol
ἀταλός	tender, delicate
ἀτάρ	but, yet
ἀταρβής	unfearing, fearless
ἀτασθαλία	presumptuous sin, recklessness, arrogance
ἀτάσθαλος	presumptuous, reckless, arrogant
ἀτειρής	not to be worn away, indestructible
ἀτέμβω	to maltreat, to afflict, perplex
ἄτερ	without
ἄτη	bewilderment, infatuation, reckless impulse
ἀτημελής	neglected
ἀτημελίη	
Ἀτθίς	Attic
ἀτίζω	not to honour, to hold in no honour
ἀτιμάζω	to hold in no honour, to esteem lightly, dishonour, slight
ἀτιτάλλω	to rear up
Ἀτλαντίς	the Atlantic ocean
Ἄτλας	Atlas
ἄτλητος	not to be borne, insufferable
ἄτμητος	not cut up, unravaged
ἀτμός	steam, vapour
ἀτραπός	a path with no turnings
ἀτρεκής	real, genuine
ἀτρέμας	without trembling, without motion
ἄτρεπτος	unmoved, immutable
ἄτρομος	intrepid, dauntless
ἀτροπία	inflexibility
ἀτυζηλός	
ἀτυζομενη	
ἀτύζω	to be distraught from fear, mazed, bewildered
αὖ	
αὐαλέος	dry, parched
αὐγάζω	to view in the clearest light, see distinctly, discern
Αὐγείας	
αὐγή	the light of the sun, sunlight
αὐδάζομαι	to cry out, speak
αὐδάω	to utter sounds, speak
αὐδή	the human voice, speech
αὐδήεις	speaking with human voice
αὐδήεσσαι	
αὐθέντης	one who does
αὖθι	on the spot, here, there
αὖθις	back, back again
Αυκίην	
Αύκοιο	
αὖλαξ	a furrow
αὔλειος	of or belonging to the αὐλή or court
αὐλέω	to play on the flute
αὐλίζομαι	to lie in the court-yard
αὔλιον	a country house, cottage
αὔλιος	of or for farm-yards, rustic
αὖλις	a place for passing the night in, a tent, roosting-place
Αὐλίς	
αὐλίτης	
αὖος	dry
ἄυπνος	sleepless, wakeful
αὔρα	air in motion, a breeze
Αὐσονίη	
Αὐσόνιος	
αὐσταλέος	sunburnt, squalid
αὐτάγρετος	self-chosen, left to one's choice
αὔτανδρος	together with the men, men and all
αὖτε	again
Αὐτεσίων	
ἀυτέω	to cry, shout
ἀυτή	a cry, shout
αὐτῆμαρ	on the self-same day
αὐτίκα	forthwith, straightway, at once
αῦτις	
ἀυτμή	breath
αὐτόγυος	having the share-beam of one piece with the pole
αὐτόθεν	from the very spot
αὐτόθι	on the spot
αὐτοκασιγνήτη	an own sister
αὐτοκασιγνήτηνδε	
αὐτοκασίγνητος	an own brother
Αὐτόλυκος	
αὐτόματος	acting of one's own will, of oneself
αὐτόντ'	
αὐτονυχί	that very night
αὐτός	self
αὐτοσχεδόν	near at hand, hand to hand
αὐτοῦ	at the very place, just here, just there
αὐτους	
αὐτόχθονος	country and all
αὐτόχθων	sprung from the land itself
αὔτως	in this very manner, even so, just so, as it is
αὐχήν	the neck, throat
αὔω	
ἄφαντος	made invisible, blotted out, forgotten
ἄφαρ	straightway, forthwith, at once, quickly, presently
Ἀφαρήιος	
Ἀφαρητιάδαι	
ἀφαρπάζω	to tear off or from
ἀφάσσω	to handle, feel
ἄφατος	not uttered, nameless
ἀφαυρός	feeble, powerless
Ἀφειδάντειον	
ἀφειδείως	
ἀφειδέω	to be unsparing or lavish of
ἀφειδής	unsparing or lavish of
Ἀφεταί	
ἀφέτης	
ἄφθιτος	not liable to perish, imperishable
ἄφθογγος	voiceless, speechless
ἀφίημι	to send forth, discharge
ἀφικάνω	to arrive at, to have come to
ἀφικνέομαι	to come to
ἄφλαστον	
ἄφλεκτος	unburnt, unconsumed by fire
ἀφνειός	rich, wealthy
ἄφνω	unawares, of a sudden
ἀφορμάω	to make to start from
ἀφραδής	insensate, reckless
ἀφραδία	folly, thoughtlessness
ἄφραστος	unutterable, inexpressible
ἀφρέω	to befoam, cover with foam
ἀφρός	foam
ἀφύσσω	to draw
Ἀχαιιάς	
ἀχαιινέην	
Ἀχαιίς	the Achaian land
Ἀχελωίδες	islands at the mouth of the Achelous
Ἀχελώιος	
Ἀχελῷος	Achelous
Ἀχερουσιάς	
Ἀχερουσίδος	
ἀχερωίς	the white poplar
Ἀχέρων	Acheron, river of woe
ἀχεύω	grieving, sorrowing, mourning
ἀχέω	
ἄχθομαι	to be loaded
Ἀχιλλεύς	Achilles
ἀχλυόεις	gloomy
ἀχλύς	a mist
ἀχλύω	to be or grow dark
ἄχνη	anything that comes off the surface
ἄχος	pain, distress
ἄχραντος	undefiled, immaculate
ἄχρι	to the uttermost, utterly
ἄψ	backwards, back, back again
ἄψαυστος	untouched, not to be touched, sacred
ἀψεγής	unblamed, blameless
ἄψηκτος	
ἅψις	
ἁψίς	a juncture, loop, mesh
ἄψορρος	going back, backwards
ἅψος	a joint
Ἀψυρτεῦσιν	
Ἄψυρτος	
ἄψυχος	lifeless, inanimate
ἄω	
ἄωτον	fine wool, flock
ἄωτος	
βάζω	to speak, say
βαθυλήιος	with deep crop, very fruitful
βαθυπλόκαμος	
βαθυρρείοντα	
βαθυρρείοντος	
βαθύρριζος	deep-rooted
βαθύς	deep or high
βαία	
βαίνω	to walk, step
βαιός	little, small, scanty
βάκτρον	
Βακχιάδαι	
βαλβίς	the rope drawn across the race-course
βάλλις	
βάλλω	to throw
βάξις	a saying
βάπτω	to dip in water
βάραθρον	a gulf, pit
βαρέω	to weigh down, depress
βαρύθω	to be weighed down
βαρύνω	to weigh down, oppress by weight, depress
βαρύς	heavy
βαρύφρων	weighty of purpose, grave-minded
βασίλεια	a queen, princess
βασίλειον	a kingly dwelling, palace
βασίλειος	of the king, kingly, royal
βασιλεύς	a king, chief
βασιλεύω	to be king, to rule, reign
βασιληίς	royal
Βασιλίς	
βάσκω	speed thee! away!
βεβόλημαι	to be stricken
βέβρυκε	
Βέβρυκες	
Βεβρυκίης	
βέλος	a missile
βέλοσαὐταρ	
βέλτερος	better, more excellent
βένθος	the depth
Βεχείρων	
βῆ	baa
βῆσσα	a wooded comb or glen
βήσσω	to cough
βηταρμός	
βία	bodily strength, force, power, might
βιάζω	to constrain
Βιαντιάδαο	
Βιαντιάδης	
Βίας	
βιάω	to constrain
βιβρώσκω	to eat, eat up
Βιθυνίς	
Βιθυνῶν	
Βιλλαίοιο	
βίος	life
βιός	a bow
βιοτήσιος	
βίοτος	life
βιόω	to live, pass one's life
Βιστονίῃ	
Βιστονίην	
Βιστωνίδι	
βλαστάνω	to bud, sprout, grow
βλάστεον	
βλέφαρον	mostly in pl. the eyelids
βληχή	a bleating
βληχρός	weak, faint, slight
βλοσυρός	grim, fierce
βλύζω	gush forth
βλωθρός	tall, stately
βλώσκω	to go or come
βόα	
βόαυλον	
βοάω	to cry aloud, to shout
βοείη	an ox-hide, ox-hide shield
βόειος	of an ox or oxen
βοεύς	a rope of ox-hide
βοή	a loud cry, shout
βόησις	
βόθρος	any hole or pit dug in the ground
Βοιωτός	a Boeotian
βολή	a throw, the stroke or wound
βομβέω	to make a booming, humming noise, to sound deep or hollow
βομβηδόν	
βοοκτασία	
βορέαο	
Βορέας	the North wind
Βορέης	
βόρειος	from the quarter of the North wind, northern
βόσκω	to feed, tend
Βόσπορος	ox-ford
βοτήρ	a herdsman, herd
βοτρυόεις	clustering
βουκόλιαι	
βουκόλος	a cowherd, herdsman
βουλεύς	
βουλεύω	to take counsel, deliberate, concert measures
βουλή	will, determination
βούλομαι	to will, wish, be willing
βουλυτός	the time for unyoking oxen, evening
βούπαις	a big boy
βουπελάτης	
βοῦς	cow
Βούτης	
βουτύπος	
βράσσω	to shake violently, throw up
βραχεῖν	to rattle, clash, ring
βρέμω	to roar
βρέτας	a wooden image of a god
βριαρός	strong, stout
βρίζω	to be sleepy, to slumber, nod
βριθοσύνη	weight, heaviness
βριθύς	weighty, heavy
βρίθω	to be heavy or weighed down with
βρίμη	strength, bulk
Βριμώ	
βρομέω	to buzz
βρόμος	crackling
βροντάω	to thunder
βροντή	thunder
βρότειος	mortal, human, of mortal mould
βρότεος	
βροτός	a mortal man
βρόχος	a noose or slip-knot, for hanging or strangling
Βρυγηίδας	
Βρυγοί	
βρυχάομαι	to roar, bellow
βρυχή	
βρυχηδόν	with gnashing of teeth
βρύχιος	from the depths of the sea
βρώμη	food
βρῶσις	meat
Βύζηρας	
Βύζηρες	
βυθός	the depth
βύκτης	swelling, blustering
βῶλα	
βῶλαξ	
βῶλος	a lump of earth, a clod
βωμός	any raised platform, a stand
Γαῖα	
γαῖα	a land, country
γαιηγενής	
Γαῖον	
Γαῖος	
γάλα	milk
γαληναίη	
γαληναῖος	
γαλήνη	stillness of the sea, calm
γάμος	a wedding, wedding-feast
γαμφηλαί	the jaws
γάνυμαι	to brighten up
Γανυμήδης	
γάρ	for
Γαράμαντα	
γάρον	
γάρος	
γαστήρ	the paunch, belly
γατομέοντες	
γαυλός	a milk-pail
γαῦρος	exulting in
γε	at least, at any rate
γείνομαι	to be born
γειομόροι	
γειομόρος	
γειοτόμον	
γελάω	to laugh
γέλως	laughter
γενεά	race, stock, family
γενέθλη	race, tock, family
Γενέθλιος	
γενειάς	a beard
γενέτης	the begetter, father, ancestor
Γενηταίην	
Γενηταίου	
γένος	race, stock, family
γέντο	he grasped
γένυς	the under jaw
γεραιός	old
Γεραιστός	
γεράνδρυον	
γεραρός	of reverend bearing, majestic
γέρας	a gift of honour
γέρων	an old man
γετό	
Γέφυρον	
γῆ	earth
γηγενής	earthborn
γηθέω	to rejoice
γῆθος	
γηθοσύνη	joy, delight
γηθόσυνος	joyful, glad at
γημόρος	one who has a share of land, a landowner
γηραιός	aged, in old age
γῆρας	old age
γηράσκω	to grow old, become old
γῆρυς	voice, speech
γηρύω	to sing or say, speak, cry
γι	
Γίγας	
γίγνομαι	to come into being
γιγνώσκω	to learn to know, to perceive, mark, learn
Γλαῦκος	
γλαυκός	gleaming, silvery
γλαύξ	the owl
γλαφυρός	hollow, hollowed
γλήνη	the pupil
γλῆνος	things to stare at, shows, wonders
γλυκερός	
γλύκιος	
γλυκύς	sweet
γλυφίς	the notched end
γλῶσσα	the tongue
γναθμός	the jaw
γνάμπτω	to bend
γνήσιος	of or belonging to the race
γνύξ	with bent knee
γνωτός	perceived, understood, known
γοάω	to wail, groan, weep
γοερός	mournful, lamentable
γόμφος	a bolt
γομφόω	to fasten with bolts
γόνος	that which is begotten, offspring, a child
γόνυ	the knee
γόος	weeping, wailing, groaning, howling, mourning, lamentation
γουνάζομαι	to clasp
γουνόομαι	
γουνός	a hill
γραπτύς	a scratching, tearing
Γραυκένιοι	
γραῦς	an old woman
γύης	
γυῖον	a limb
γυιόω	to lame
γυμνός	naked, unclad
γυμνόω	to strip naked
γυνή	a woman
Γυρτῶνα	
δαεῖεν	
δαείη	
δαείην	
δαημοσύνη	
δαήμων	knowing, experienced in
δαί	what? how
δαιδάλεος	cunningly or curiously wrought
δαιδάλλω	to work cunningly, deck or inlay with curious arts, to embellish
δαίδαλος	cunningly or curiously wrought
δαίζω	to cleave asunder, cleave
δαιμόνιος	of or belonging to a δαίμων
δαίμων	a god, goddess
δαίνυμι	to divide
δάιος	hostile, destructive, dreadful
δαίς	
δαίτη	a feast, banquet
δαίτης	
δαιτρεύω	to cut up
δαίφρων	battle
δαίω	
δάκνω	to bite
δακρυόειν	
δακρυόεις	tearful, much-weeping
δάκρυον	a tear
δακρυχέων	shedding tears
δακρύω	to weep, shed tears
δάκτυλος	a finger
δαλός	a fire-brand, piece of blazing wood
δαμάζω	to overpower
δάμαρ	a wife, spouse
δαμνάω	
δάμνημι	
Δανάη	
Δαναΐς	
Δαναοί	the Danaans
Δαναός	
δάπεδον	any level surface: the floor of a chamber
δάπτω	to devour
Δαρδανία	
Δαρδάνιος	Trojan
δάσκιος	thick-shaded, bushy
Δάσκυλος	
δατέομαι	to divide among themselves
δάφνη	the laurel
δάω	to learn
δέ	but
δε	
δεδοκημένος	waiting, lying in wait
δεῖ	it is binding on
δειδίσκομαι	to meet with outstretched hand, to greet, welcome
δειδίσσομαι	to frighten, alarm
δειδυῖαν	
δείδω	to fear
δειελινός	at evening
δείελος	of or belonging to evening
δεικανάω	to point out, shew
δείκηλον	a representation, exhibition
δείκνυμι	to bring to light, display, exhibit
δείλαιος	wretched, sorry, paltry
δείλη	afternoon
δειλός	cowardly, craven
δεῖμα	fear, affright
δειμαίνω	to be afraid, in a fright
δεινός	fearful, terrible, dread, dire
δεινόω	to make terrible: to exaggerate
δειράς	the ridge of a chain of hills
δειρή	the neck, throat
δεῖσα	
δελφίς	the dolphin
Δελφύνη	
δέμας	the frame
δέμνιον	the bedstead or matrass
δέμω	to build
δενδίλλω	to turn the eyes or glance quickly
δένδρεον	a tree
δενδρήεις	woody
δένδρον	a tree
δεξιά	the right hand
δεξιόομαι	to greet with the right hand, welcome, greet
δεξιός	on the right hand or side
δεξιτερός	right, the right
δέος	fear, alarm, affright
δέπας	a beaker, goblet, chalice
δέρκομαι	to see clearly, see
δέρμα	the skin, hide
δέρος	
δέρω	to skin, flay
δεσμεύω	to fetter, put in chains
δέσμη	
δέσμιος	binding
δεσμός	anything for binding, a band, bond
δέσποινα	the mistress, lady of the house
Δευκαλίδη	
Δευκαλίδης	
Δευκαλίων	
δευουένοισιν	
δεῦρο	hither
δεύτερος	second
δεύω	
Δέχθε	
δέχομαι	to take, accept, receive
δέω	
δή	exactness
δηθά	for a long time
δῆθεν	really, in very truth
δηθύνω	to tarry, be long, delay
δηιάασκον	
Δηιλέων	
Δηίμαχος	
δηιοτής	battle-strife, battle, death
δηιόω	to cut down, slay
δηλέομαι	to hurt, do a mischief to
Δῆλος	Delos
δημόθεν	at the public cost
δημός	fat
δῆμος	a country-district, country, land
δημότερος	common, vulgar
δήν	long, for a long while
δηναιός	long-lived
δήνεα	counsels, plans, arts
δῆνος	
δήποτε	at some time, once upon a time
δηριάομαι	to contend, wrangle
δῆρις	a fight, battle, contest
δηρίσασθαι	
δηρός	long, too long
δῆτα	certainly, to be sure, of course
δήω	to find, meet with
Δηώ	Demeter
διά	through c. gen. through, by means of c. acc.
διαβαίνω	to make a stride, walk or stand with the legs apart
διά-γλαύσσω	
διαδηλέομαι	to do great harm to, tear to pieces
διά-εἴδομαι	
διαείδω	
διά-εἰλύω	
διά-ἐξερέω	
διά-ἐξέρομαι	
διά-ζώω	
διά-ἰσχάνω	
διακείρω	to cut in pieces
διακριδόν	eminently, above all
διακρίνω	to separate one from another
διάκρισις	separation, dissolution
διαμμοιρηδά	
διαμοιράω	to divide, rend asunder
διαμπερές	through and through, right through, clean through
διαμπερής	
διάνδιχα	two ways
διανύω	to bring quite to an end, accomplish, finish
διαπλέω	to sail across
διαπρό	right through
διαπρύσιος	going through, piercing
διαπτοέω	to scare away, startle and strike with panic, fear
διαρραίω	to dash in pieces, destroy
διά-σκαίρω	
διασταδόν	
διατεκμαίρομαι	to mark out
διατμήγω	to cut in twain
διατρίβω	to rub between, rub hard, rub away, consume, waste
διάτριχα	in three divisions, three ways
διαυγής	transparent
διαφαίνω	to shew through, let
διαφράζω	to speak distinctly, tell plainly
διαχέω	to pour different ways, to disperse
διδάσκω	to teach
δίδυμος	double, twofold, twain
δίδωμι	to give
διείρομαι	to question closely
διειρύω	to draw across
διείρω	to pass or draw through
διέκ	through and out of
διεκπεράω	to pass out through, pass quite through
δίεμαι	to flee, speed
διεξελαύνω	to drive, ride, march through
διερός	fresh, active, nimble
διερῶ	to say fully, distinctly, expressly
διέχω	to keep apart or separate
δίζημαι	to seek out, look for
δίζω	to be in doubt, at a loss
Δίη	
διηέριος	
διήλυσις	
διηνεκής	continuous, unbroken
διίημι	to drive or thrust through
διικνέομαι	to go through, penetrate
δικάζω	to judge, to give judgment on
δίκαιος	observant of custom and social rule, well-ordered, civilised
δικασπόλος	one who administers law, a judge
δικεῖν	to throw, cast
δίκη	custom, usage
δικλίς	double-folding
δίκραιρος	
Δικταίην	
Δικταίης	
Δικταῖος	
Δινδυμίην	
Δίνδυμον	
Δινδύμου	
δινεύω	to whirl or twirl round
δίνη	a whirlpool, eddy
δινήεις	whirling, eddying
δίνω	to thresh out on the
δινωτός	turned, rounded
διό	wherefore, on which account
Διόθεν	sent from Zeus, by his will or favour
Διόνυσος	Dionysus
δῖος	god-like, divine
δίπλαξ	twofold, double, in double folds
διπλόη	
διπλόος	twofold, double
δίπτυχος	double-folded, doubled
δίς	twice, doubly
δίφρος	the chariot-board
δίχα	in two, asunder
διχῆ	in two, asunder
διχθάδιος	twofold, double, divided
διχόμηνις	
διχοστασία	a standing apart, dissension
διχόωντο	
δίψα	thirst
Διψακός	
διψαλέος	thirsty
διψάς	
διψάω	to thirst
δίψος	
δίω	to run away, take to flight, flee
διωλύγιος	far-sounding, enormous, immense
δμωή	a female slave taken in war
δμωίς	
δμώς	a slave taken in war
δνοφερός	dark, dusk, murky
δοάσσαι	
δοάσσατο	it seemed
δοιάζεσκεν	
δοιάζοντο	
Δοιάντιον	
Δοίαντος	
δοιάς	
δοιή	doubt, perplexity
δοιοί	two, both
δοιώ	
δοκεύς	
δοκεύω	to keep an eye upon, watch narrowly
δοκέω	videor mihi, to think, suppose, imagine, expect
δολία	
Δολιονίην	
Δολιονίῃσι	
Δολιονίῳ	
δόλιος	crafty, deceitful, treacherous
δολιχός	long
Δολίων	
δολόεις	subtle, wily
δολοκτασία	
Δολοπηίδα	
Δολοπήιος	
δόλος	a bait
δολοφροσύνη	craft, subtlety, wiliness
δολόω	to beguile, ensnare, take by craft
δομαῖος	for building
δομή	a building.
δόμος	a house
δονακώδης	
δόναξ	a reed
δονέω	to shake
δορίκτητος	won by the spear
δόρπον	the evening meal
δόρπος	
δόρυ	a stem, tree
δοτήρ	a giver, dispenser
δούλιος	slavish, servile
δουπέω	to sound heavy or dead
δοῦπος	any dead, heavy sound, a thud
δουράτεος	of planks or beams of wood
δόχμιος	across, athwart, aslant
δράκων	a dragon
δράσσομαι	to grasp
δρεπάνη	a sickle, reaping-hook
δρέπανον	a scythe
δρηστήρ	a labourer, working man
δρίος	a copse, wood, thicket
δροσερός	dewy, watery
δροσόεις	
δρύινος	oaken
δρυμός	an oak-coppice;
δρύοχοι	the props or trestles
Δρύοψ	
δρύπτω	to tear, strip
δρῦς	a tree
δυάω	to plunge in misery
δύη	woe, misery, anguish, pain
δυηπαθής	
δύναμαι	to be able, capable, strong enough
δύο	two
δυοκαίδεκα	twelve
δύπτοντες	
δυσάμμορος	most miserable
δυσάσχετος	
δυσαυχής	
δύσζηλος	exceeding jealous
δυσήνεμον	
δυσηχής	ill-sounding, hateful
δυσίμερος	
δύσις	a setting of the sun or stars
δυσκέλαδος	ill-sounding, shrieking, discordant
δυσμενέων	bearing ill-will, hostile
δυσμενής	full of ill-will, hostile
δύσμορος	ill-fated, ill-starred
δυσπαλής	hard to wrestle with
δύστηνος	wretched, unhappy, unfortunate, disastrous
δύσφημος	of ill omen, boding
δυσχείμερος	suffering from hard winters, very wintry, freezing
δυσχείμων	
δυσώνυμος	bearing an ill name, ill-omened
δύψας	
δύω	to strip off
δυώδεκα	twelve
δωδέκατος	the twelfth
Δωδωνίς	
δῶμα	a house
δωμάω	to build
δῶρον	a gift, present
δωτίνη	a gift, present
ἕ	sui.
ἔα	ha! oho!
ἐάν	if haply
ἑανός	fit for wearing
ἔαρ	spring
ἐαρινός	spring-
ἐάω	to let, suffer, allow, permit
ἑβδόματος	the seventh
ἐγγελάω	to laugh at, mock
ἐγγενέτης	
ἐγγίγνομαι	to be born or bred in
ἐγγυαλίζω	to put into the palm of the hand, put into one's hand
ἐγγυάω	to give or hand over as a pledge
ἐγγύθεν	from nigh at hand
ἐγγύθι	hard by, near
ἐγείρω	to awaken, wake up, rouse
ἐγκαταπίπτω	to fall in or upon
ἐγκατατίθεμαι	put
ἐγκατελεκτο	
ἐγκλείω	to shut in, close
ἐγκλιδόν	leaning, bent down
ἐγκλίνω	to bend in or inwards
ἐγκονέω	to be quick and active, make haste, hasten
ἐγκρίνω	to reckon in or among
ἐγκρύπτω	to hide or conceal in
ἐγρήσσω	to be awake or watchful
ἔγρω	
ἐγχείη	a spear, lance
ἔγχελυς	an eel
ἐγχέω	to pour in
ἔγχος	a spear, lance
ἐγχρίμπτω	to bring near to
ἐγώ	ego
ἐγώγε	
ἐδέθλιον	
ἔδεθλον	a seat, abode
ἐδήιον	
ἐδητύς	meat, food
ἕδνον	a wedding-gift
ἕδος	a sitting-place
ἕδρα	a sitting-place
ἑδριάω	to seat or set
ἔδω	to eat
ἐδωδή	food, meat, victuals
ἕζομαι	to seat oneself, sit
ἔθειρα	hair
ἐθελημός	willing, voluntary
ἐθέλω	to will, wish, purpose
ἔθνος	a number of people accustomed to live together, a company, body of men
ἔθω	to be accustomed
εἰ	whether.
εἱαμενή	a river-side pasture, meadow
εἴβω	to drop, let fall in drops
εἶδαρ	food
εἰδοί	Idus
εἴδομαι	are visible, appear
εἶδον	to see, perceive, behold
εἶδος	that which is seen, form, shape, figure
εἴδωλον	an image, a phantom
εἶεν	well!
εἶθαρ	at once, forthwith
εἴθε	would that!
εἴκελος	like
εἴκω	to yield, give way, draw back, retire
εἰλαπίνη	a feast or banquet
Εἰλατίδην	
Εἰλατίδης	
Εἰλείθυια	Ilithyia
Εἰλείθυιον	
εἰλίγγοισιν	
εἴλυμα	a wrapper
εἰλυός	a lurking place, den
εἰλύω	to enfold, enwrap
εἴλω	to roll up, pack
εἷμα	a garment
εἰμί	to be, to exist
εἶμι	to go
εἰνάλιος	
εἴπερ	strengthd. for
εἶπον	to speak, say
εἶπος	
εἰρεσία	rowing
εἴρω	
εἰς	into, to c. acc.
εἷς	
εἰσαγείρω	to collect into
εἰσάγω	to lead in or into, to introduce
εἰσαιέν	
εἰσαίω	to listen or hearken to
εἰσακούω	to hearken or give ear to one
εἰσάλλομαι	to spring or rush into
εἰσαναβαίνω	to go up to or into
εἰσ-ἀναχέω	
εἰσ-ἀνδρόω	
εἰσάνειμι	to go up into
εἰσ-ἀνέχω	
εἰσ-ἀντάω	
εἰσ-ἀποβαίνω	
εἰσαῦθις	hereafter, afterwards
εἰσαφικάνω	to come to
εἰσαφικνέομαι	to come into or to, reach or arrive at
εἰσ-ἀφύσσω	
εἰσβαίνω	to go into
εἰσβάλλω	to throw into, put into
εἰσδέρκομαι	to look at or upon
εἰσ-εἶδον	
εἴσειμι	to go into
εἰσελαύνω	to drive in
εἰσέρχομαι	to go in or into, enter
εἰσέτι	still yet
εἰσνοέω	to perceive, remark
εἰσόκε	until
εἰσοράω	to look into, look upon, view, behold
εἰσότε	against the time when
εἰσ-σείω	
εἰσ-σεύω	
εἰσφορέω	
εἴσω	to within, into
εἰσωπός	in sight of
εἴτε	
ἐκ	from out of
ἕκαθεν	from afar
ἐκ-ἀλέω	
ἐκ-ἀλύσσω	
ἑκάς	far, afar, far off
ἐκάς	
ἕκαστος	every, every one, each, each one
ἑκάτερθε	on each side, on either hand
Ἑκάτη	Hecate, the far-darter
ἑκάτη	
ἑκατόμβη	an offering of a hundred oxen, —
ἑκατόν	a hundred
ἕκατος	far-shooting
ἐκβάλλω	to throw or cast out of
ἐκβάσιος	
ἔκβασις	a way out, egress
ἐκβλύοντα	
ἐκγίγνομαι	to be born of
ἐκ-δάω	
ἐκδίδωμι	to give up, surrender
ἐκεῖθεν	from that place, thence
ἐκεῖνος	the person there, that person or thing
ἐκεῖσε	thither, to that place
ἐκ-ἐνέπω	
ἐκέσασσαν	
ἑκηβόλος	far-darting, far-shooting
ἕκηλος	at rest, at one's ease
ἕκητι	by means of, by virtue of, by the aid of
ἐκ-θρῴσκω	
ἔκκριτος	picked out, select
ἐκκυλίνδω	to roll out
ἐκλανθάνω	to escape notice utterly: —
ἐκ-λαχαίνω	
ἐκλύω	to loose, release, set free, from
ἐκμολεῖν	to go out, go forth
ἐκ-νέομαι	
ἐκ-νέω	
ἐκ-ὄρνυμι	
ἔκπαγλος	terrible, fearful
ἐκπέμπω	to send out or forth from
ἐκπίμπλημι	to fill up
ἐκπίνω	to drink out or off, quaff
ἐκπλέω	to sail out, sail away, weigh anchor
ἔκποθεν	
ἐκ-προβλώσκω	
ἐκπροκαλέομαι	to call to oneself or summon out of
ἐκρέω	to flow out or forth
ἐκσεύομαι	to rush out or burst forth from
ἐκσῴζω	
ἐκτείνω	to stretch out
ἐκτελέω	to bring quite to an end, to accomplish, achieve
ἐκτέμνω	to cut out
ἐκτερέιξαν	
ἔκτοθεν	from without, outside
ἔκτοθι	out of, outside
ἐκτός	outside
ἔκτοσθε	outside
ἔκτυπος	worked in high relief
ἑκυρά	a mother-in-law, step-mother
ἐκφαίνω	to shew forth, bring to light, disclose, reveal, make manifest
ἐκφέρω	to carry out of
ἐκφεύγω	to flee out or away, escape
ἔκφημι	to speak out or forth, speak loudly
ἐκφλύξαι	
ἐκφύω	to generate from
ἐκχέω	to pour out
ἑκών	willing, of free will, readily
ἔλαεν	
ἐλαία	the olive-tree
ἐλαιηρός	oily, of oil
Ἐλάρη	
ἐλάτη	the silver fir, pinus picea
ἐλάτης	
ἐλαύνω	to drive, drive on, set in motion
ἔλαφος	a deer
ἐλαφρός	lightly, buoyantly
ἔλδομαι	to wish, long
ἔλδωρ	a wish, longing, desire
ἐλεαίρω	to take pity on
ἔλεγος	a song of mourning, a lament
ἐλεγχείη	reproach, disgrace
ἔλεγχος	a cross-examining, testing
ἐλεεινός	finding pity, pitied or moving pity, pitiable, piteous
ἐλέηραν	
ἑλειονόμος	
ἔλειπτο	
ἐλελίζω	
ἔλεος	pity, mercy, compassion
ἑλεσπίς	
ἐληλάμενον	
Ἑλίκη	
ἑλίκη	
ἐλινύω	to keep holiday, to take rest, be at rest, keep quiet, stand idle
ἕλιξ	anything which assumes a spiral shape
ἑλίσσω	to turn round, to turn
ἕλκος	a wound
ἑλκόω	to wound sorely, lacerate
ἕλκω	to draw, drag
ἑλλά	
Ἑλλάς	Hellas
ἐλλείπω	to leave in, leave behind
Ἕλλη	
Ἑλλήσποντος	the Hellespont or sea of Helle
ἔλλιπος	
ἔλον	
ἕλος	low ground by rivers, a marsh-meadow
ἐλπίς	hope, expectation
ἔλπω	to make to hope
ἐλπωρή	
έλυσθεις	
ἐλύω	to roll round
ἕλωρ	booty, spoil, prey
ἑλώριον	
ἑλώριος	
ἐμβαίνω	to step in
ἐμβάλλω	to throw in, put in
ἐμβασιλεύω	to be king in or among
Ἐμβάσιος	
ἐμελοντο	
ἐμέω	to vomit, throw up
ἐμμελής	sounding in unison, in tune or time, harmonious
ἐμμεμαώς	in eager haste, eager
ἔμμορες	
ἔμμορος	partaking in, endued with
ἐμός	mine
fέμουσιν	
ἔμπαλιν	backwards, back
ἔμπας	notwithstanding, nevertheless
ἔμπεδα	
ἔμπεδος	in the ground, firm-set, steadfast
ἐμπίπλημι	to fill quite full
ἐμπίπτω	to fall in or upon or into
ἔμπλεος	quite full of
ἐμπλέω	to sail in
ἐμπλήσσω	to strike against, fall upon or into
ἐμπνέω	to blow or breathe upon
ἔμπνοος	
ἔμπνους	with the breath in one, breathing, alive
ἔμπροσθεν	before, in front
ἔμπυρος	in the fire
ἐμφέρω	to bear or bring in
ἐμφορέω	to be borne about in or on
ἐμφύλιος	kinsfolk
ἔμφυλος	of the same tribe or race
ἐν	in, among. c. dat.
ἐν-ἀγείρω	
ἐν-ἀείρω	
ἐναίρω	to slay
ἐναίσιμος	ominous, boding, fateful
ἐναλίγκιαι	
ἐναλιγκίη	
ἐναλίγκιος	like, resembling
ἐνάλιος	in, on, of the sea
ἐναμοιβαδίς	
ἐν-ἀντιάω	
ἐναντίβιος	set against, hostile
ἐναντίον	
ἐναντίος	opposite
ἐναρίζω	to strip a slain foe of his arms
ἐναριθμέω	to reckon in or among: to reckon, account
ἐναρίθμιος	in the number, to make up the number
ἔναυλος	
ἐνδ'	
ἐνδαίω	
ἐνδέω	
ἐνδίδωμι	to give in
ἔνδιον	
ἔνδιος	at midday, at noon
ἔνδοθεν	from within
ἔνδοθι	within, at home
ἔνδον	in, within, in the house, at home
ἐνδυκές	
ἐνδυκέως	thoughtfully, carefully, sedulously
Ἐνδυμίων	
ἔνειμι	to be in
ἕνεκα	on account of, for the sake of, because of, for
ἐνεκτερέιξαν	
ἐν-ἐλλείπω	
ἐνεοστασία	
ἐν-ἕπομαι	
ἐν-ἔπω	
ἐνέπω	to tell, tell of, relate, describe
ἐνερείδω	to thrust in, fix in
ἔνερθε	from beneath, up from below
ἔνεροι	
ἐνεσία	a suggestion
Ἐνετήιος	
ἐνευδιόων	
ἐνέχω	to hold within
ἐνζεύγνυμι	to yoke in, bind, involve in
ἐνηής	kind, gentle
ἔνθα	there
ἐνθάδε	thither, hither
ἔνθεν	on the one side
ἐνθένδε	hence, from this quarter
ἔνθορος	
ἐνιβᾴλλομαι	
ἐνίημι	to send in or into
ἐνικλάω	to break in, break off
Ἐνιπεύς	
ἐνιπή	a rebuke, reprof;
ἐνιπτάζων	
ἐνίπτω	to reprove, upbraid
ἐνίστημι	to put, set, place in
ἐνίσχω	to keep in one's
ἐν-καταβάλλω	
ἐν-καταθνήσκω	
ἐν-καταναίω	
ἐν-κατανάσσω	
ἐν-λήγω	
ἐνναετής	nine years old
ἐνναέτης	an inhabitant
ἐνναέτις	
ἐνναίω	to dwell in
ἐν-νάσσω	
ἐννέα	nine
ἐννεσία	
ἕννυμι	to put clothes on
ἐννύχιος	in the night, by night, nightly
ἐνοπή	a crying, screaming
ἐνόπλιος	a war-tune, march
ἕνος	belonging to the former of two periods, last year's
ἐν-πάλλω	
ἐν-ῥιγέω	
ἐνσκίμπτω	to let fall upon
ἐν-σκλῆναι	
ἐν-σπειράομαι	
ἐν-σπείρω	
ἐνστηρίζω	to fix in
ἐνσχερώ	
ἔντεα	fighting gear, arms, armour
ἐντενής	
ἐντίθημι	to put in or into
ἔντομος	cut in pieces, cut up
ἐντός	within, inside
ἔντοσθε	from within
ἐντρέφω	to bring up in
ἐντροπαλίζομαι	to keep turning round
ἔντροφος	living in or acquainted with
ἐντυπάς	as to shew his limbs
ἐντυπή	
Ἐνυάλιος	the Warlike
ἐνωθέω	to thrust in or upon
ἐνωπαδίς	
ἕξ	six
ἐξάγνυμι	to break and tear away, to rend
ἐξάγω	to lead out
ἐξαείρω	to lift up, lift off the earth
ἐξαιρέω	to take out of
ἔξαιτος	much asked for, much desired, choice, excellent
ἐξαλεύομαι	
ἐξάλλομαι	to leap out of or forth from
ἐξαναιρέω	to take out of
ἐξανατέλλω	to spring up from
ἐξάνειμι	to rise from the
ἐξανέχω	to hold up from
ἐξανίημι	to send forth, let loose
ἐξάνυσις	
ἐξανύω	to accomplish, fulfil, make effectual
ἐξαπαφίσκω	
ἐξαποβαίνω	to step out of
ἐξάπτω	to fasten from
ἐξάργματα	
ἐξαρπάζω	to snatch away from
ἐξάρχω	to begin with, make a beginning of
ἐξαῦτις	over again, once more, anew
ἐξεγείρω	to awaken
ἑξείης	
ἐξείλλω	to disentangle
ἔξειμι	to go out, come out
ἑξείνς	
ἐξεῖπον	to speak out, tell out, declare
ἐξείρω	to put forth
ἐξελαύνω	to drive out from
ἐξεναρίζω	to strip or spoil
ἐξερεείνω	to inquire into
ἐξερέω	
ἐξέρομαι	
ἐξερύω	to draw out of
ἐξέρχομαι	to go or come out of
ἐξέτι	even from
ἑξῆς	one after another, in order, in a row
ἐξιθύνω	to make straight
ἐξικνέομαι	to reach, arrive at
ἔξοιδα	to know thoroughly, know well
ἐξόπιθεν	behind, in rear
ἐξότε	from the time when
ἔξοχος	standing out
ἔοικα	to be like
ἐοντα	
ἑός	his, her own
έοῦσαν	
ἐπάγω	to bring on
ἐπαείδω	to sing to or in accompaniment
ἐπαινέω	to approve, applaud, commend
ἐπαίρω	to lift up and set on
ἐπαίσσω	to rush at or upon
ἐπαϊστόν	
ἐπαίτιος	blamed for
ἐπακτήρ	a hunter
ἐπάκτιος	on the shore
ἐπαλάομαι	to wander about or over
ἐπαλαστέω	to be full of wrath at
ἐπαμοιβαδίς	interchangeably
ἐπαμοιβός	
ἐπαμύνω	to come to aid, defend, assist
ἐπανθιόωντας	
ἐπανίστημι	to set up again
ἐπάξιος	worthy, deserving of
ἐπαπειλέω	to hold out as a threat to
ἐπαρηγόνες	
ἐπαρηγόνι	
ἐπαρήγω	to come to aid, help
ἐπαρκέσσαι	
ἐπαρκέσσειν	
ἐπαρτής	ready for work, equipt
ἐπαρωγή	help, aid
ἐπαρωγός	a helper, aider
ἐπασσύτερος	one upon another, one after another
ἐπαυλίζομαι	to encamp on the field
ἔπαυλος	a fold for
ἐπαύρεσθαι	
ἐπαυρέω	to partake of, share
ἐπαύω	to shout over
ἐπεδοίασα	
ἐπεί	after that, after (postquam), since, when (quum)
ἐπειγόμἰοι	
ἐπείγω	to press down, weigh down
ἔπειμι	to be upon
ἔπειτα	thereupon
ἐπείυ	
ἐπεκλονέεσκον	
ἐπελαύνω	to drive upon
ἐπέλπομαι	to have hopes of, to hope that . .
ἐπεμβαίνω	to step or tread upon
ἐπεντύνω	to set right, get ready
ἐπεξυνώσατο	
ἐπέοικε	to be like, to suit
ἐπερείδω	to drive against, drive home
ἐπερύω	to pull to
ἐπέρχομαι	to come upon, come near, come suddenly upon
ἐπεσβόλος	throwing words about, rash-talking, abusive, scurrilous
ἐπεστοβέεσκον	
ἐπέτειος	annual, yearly
ἑπέτις	
ἐπευφημέω	to shout assent
ἐπεχήρατο	
ἐπέχω	to have or hold upon
ἐπήβολος	having achieved or gained
ἐπηετανός	abundant, ample, sufficient
ἔπηλυς	one who comes to
ἐπημάτιος	
ἐπήν	
ἐπήορος	
ἐπήρατος	lovely, charming
ἐπηρεφής	overhanging, beetling
ἐπήτεια	
ἐπήτιδες	
ἐπήτριμος	woven upon, closely woven
ἐπι	
ἐπί	on, upon with gen., dat., and acc.
ἐπί-ἀγαίομαι	
ἐπί-ἀείρω	
ἐπί-ἀθρέω	
ἐπί-ἀλετρεύω	
ἐπί-ἀλινδέω	
ἐπί-ἀρτίζω	
ἐπί-ἀχλύω	
ἐπιάχω	to shout out, to shout applause
ἐπίβαθρον	a passenger's fare
ἐπιβαίνω	to go upon
ἐπιβάλλω	to throw or cast upon
ἐπιβλήδην	
ἐπιβλύει	
ἐπιβρίθω	to fall heavy upon, fall heavily
ἐπί-βρομέω	
ἐπιβώμιος	on or at the altar
ἐπιγνάμπτω	to bend towards
ἐπιγουνίς	the part above the knee, the great muscle of the thigh
ἐπιδέρκομαι	to look upon, behold
ἐπιδευής	in need or want of
ἐπιδεύομαι	to be in want of, to lack
ἐπιδεύω	to moisten
ἐπιδέω	
ἐπιδήμιος	among the people
ἐπιδρομία	
ἐπί-ἔλδομαι	
ἐπί-ἐνήνοθε	
ἐπιέννυμι	to put on besides or over
ἐπί-ἐπιλλίζω	
ἐπί-ἐρεύγομαι	
ἐπιζάφελος	vehement, violent
ἐπίηρα	acceptable gifts
ἐπί-θρῴσκω	
ἐπιθύνω	to guide straight, direct
ἐπιθύω	
ἐπιίστωρ	privy to
ἐπί-καχλάζω	
ἐπίκειμαι	to be laid upon
ἐπικέλλω	to bring to shore
ἐπικέλομαι	to call upon
ἐπικεύθω	to conceal, hide
ἐπικίδνημι	to spread over
ἐπικλεής	
ἐπικλείω	
ἐπίκλησις	a surname or additional name;
ἐπικλίνω	to put
ἐπί-κλονέω	
ἐπίκλοπος	thievish, wily
ἐπικλύζω	to overflow
ἐπικλυτός	
ἐπικλύω	
ἐπικουρέω	to act as an ally
ἐπίκουρος	an assister, ally
ἐπικραδάοντας	
ἐπικρατής	master of
ἐπικρεμάννυμι	to hang over
ἐπικριδόν	
ἐπίκριον	the yard-arm
ἐπικτυπέω	to make a noise after, re-echo
ἐπί-κυδιάω	
ἐπικύρω	to light upon, fall in with
ἐπιλάμπω	to shine after or thereupon
ἐπιλείβω	to pour
ἐπιλήθω	to cause to forget
ἐπιμαίομαι	to strive after, seek to obtain, aim at
ἐπιμάρτυς	
ἐπιμάστιος	
ἐπιμειδιάω	to smile upon
ἐπιμελέομαι	to take care of, have charge of, have the management of
ἐπί-μητιάω	
ἐπιμιμνήσκομαι	to bethink oneself of, to remember, think of
ἐπιμίσγω	
ἐπί-μύρω	
ἐπινάστιος	
ἐπινειόθι	
ἐπινίσσομαι	to go over
ἐπιξενόομαι	to have hospitable relations with, be intimate with
ἐπίορκος	sworn falsely
ἐπίουρος	an over-keeper, a guardian, watcher, ward
ἐπιπαμφαλόωντες	
ἐπιπέλομαι	to come to or upon
ἐπιπλάζομαι	to wander about over
ἐπιπλέω	to sail upon or over
ἐπιπνέω	to breathe upon, to blow freshly upon
ἐπιποοσέβαλλον	
ἐπιπρηνής	
ἐπιπρό	
ἐπί-προβλώσκω	
ἐπί-προθέω	
ἐπιπροίημι	to send forth
ἐπί-προπίπτω	
ἐπιπροτέρωσε	
ἐπιπρούχοντο	
ἐπί-προφαίνω	
ἐπί-προφέρω	
ἐπιρρήδην	
ἐπιρροή	afflux, influx
ἐπίρροθος	hasting to the rescue, a helper
ἐπιρρώννυμι	to add strength to, strengthen or encourage for
ἐπιρρώομαι	to flow or stream upon
ἐπισεύω	to put in motion against, set upon
ἐπί-σκάζω	
ἐπισμυγερός	gloomy
ἐπισπέρχω	to urge on
ἐπισπεύδω	to urge on, further or promote
ἐπισταδόν	standing over each in turn
ἐπίσταμαι	to know
ἐπισταχύεσκον	
ἐπιστοβέωσι	
ἐπίστροφος	having dealings with, conversant with
ἐπί-συνωθέω	
ἐπισχεδόν	near at hand, hard by
ἐπισχεθεῖν	to hold in, check
ἐπισχερώ	in a row, one after another
ἐπί-σχίζω	
ἐπίσχω	to hold or direct towards
ἐπιτέλλω	to lay upon, enjoin, prescribe, ordain, command
ἐπιτίθημι	to lay, put or place upon
ἐπί-τμήγω	
ἐπιτρέπω	to turn towards
ἐπιτρέχω	to run upon or at
ἐπί-τροχάζω	
ἐπί-τροχάω	
ἐπιτροχάων	
ἐπί-τρωπάω	
ἐπί-φαιδρύνω	
ἐπί-φλύω	
ἐπιφραδέως	
ἐπιφράζω	to say besides
ἐπιφροσύνη	thoughtfulness
ἐπιχέω	to pour water over
ἐπιχθόνιος	upon the earth, earthly
ἐπί-χνοάζω	
ἐπί-χνοάω	
ἐπί-χόω	
ἐπιχράω	
ἐπιχρεμέθων	
ἐπί-χρίμπτω	
ἐπί-χώομαι	
ἐπιψεύδομαι	to lie still more
ἐπιψύχω	to cool
ἐπιωγήν	
ἐποίχομαι	to go towards, approach
ἐποιχόμενονμυχατῃ	
ἕπομαι	
ἐπόμνυμι	to swear after, swear accordingly
ἐπορέγω	to hold out to, give yet more
ἐπορούω	to rush violently at or upon
ἔπος	a word
ἔποσᾧ	
ἐποτρύνω	to stir up, excite, urge on
ἐπόψιος	full in view, conspicuous
ἔποψις	a view over
ἑπτά	seven
ἑπτάκις	seven times
ἑπτάς	
ἐπωλένιος	upon the arm
ἐπωμαδόν	on the shoulder
ἐπωνυμία	a surname, name given after
ἐπωνύμιος	called by the name of
ἐπώνυμος	given as a name
ἔραζε	to earth, to the ground
ἐρασσάμενος	
ἐρατός	lovely, charming
Ἐρατώ	Erato, the lovely
ἐράω	
ἐργαθεῖν	to sever, cut off
ἐργατίνης	a husbandman
Ἐργῖνος	
ἔργνυμι	to confine
ἔργον	work
ἔργω	
ἔρδω	to do
ἔρεβος	
ἐρεείνω	to ask
ἐρ́εθω	
ἐρείδω	
ἐρέικω	to rend
ἐρείπω	
ἐρεμνός	black, swart, dark
ἐρέπτομαι	to feed on
ἐρέσσω	to row
ἐρέτης	a rower
έρετμα	
ἐρετμόν	
ἐρετμός	
ἐρετμόω	to furnish with oars, set to row
ἐρεύγομαι	to spit or spew out, to disgorge
ἐρευθήεις	
ἔρευθος	
ἐρεύθω	to make red, stain red
ἐρέφω	to cover with a roof
Ἐρεχθεῖδαι	
Ἐρεχθείδης	
Ἐρεχθηίς	
ἐρημαῖος	desolate, solitary
ἐρημόνομος	haunting the wilds
ἐρημονόμος	
ἐρῆμος	desolate, lone, lonely, lonesome, solitary
ἐρημόω	to strip bare, to desolate, lay waste
ἐρήρεινται	
ἐρητύω	to keep back, restrain, check
ἐριδαίνω	to wrangle, quarrel, dispute
ἐρίδηνανοὐ	
ἐριδμαίνωυ	
ἐριθηλής	very flourishing, luxuriant
Ἐρινύς	the Erinys or Fury
ἐρινύω	
ἐρίπνη	a broken cliff, crag, scaur
ἔρις	strife, quarrel, debate, contention
ἐρισθενής	very mighty
ἐριώλη	a hurricane
ἑρκίον	a fence, inclosure
ἕρκος	a fence, hedge, wall
Ἑρκυνίου	
Ἑρμῆς	Hermes
ἔρνεἀ	
ἔρνος	a young sprout, shoot, scion
ἔρομαι	to ask, enquire
ἔρος	
ἑρπετόν	a walking animal, quadruped
ἑρπύζω	to creep, crawl
ἔρρω	to go slowly, wander about
ἔρσα	dew
ἔρσε	
ἑρσήεις	dewy, dew-besprent
Ἐρυβώτης	
Ἐρυθηίς	
ἐρύθηνε	
ἐρύθηνεν	
Ἐρυθῖνοι	
ἐρυθῖνος	
ἐρύκω	to keep in, hold back, keep in check, curb, restrain
Ἐρυμάνθιος	
ἐρυμνός	fenced, fortified
Ἔρυξ	
ἔρυται	
Ἔρυτος	
ἐρύω	to drag along the ground, drag, draw
ἔρχομαι	to come or go
ἐρῶ	I will say or speak
ἐρωέω	to rush, rush forth
ἐρωή	any quick motion, rush, force
ἔρως	love
ἐσαιεί	
ἐσάχρι	
ἐσθλός	good
ἐσκληῶτες	
ἑσπέρα	evening, eventide, eve
ἑσπέριος	at even, at eventide
ἑσπερίς	the Hesperides
Ἑσπερίς	
ἕσπερος	of or at evening
ἕσπεται	
ἐσσύμενος	hurrying, vehement, eager, impetuous
ἔστε	up to the time that, until
ἑστηυῖα	
ἑστία	the hearth of a house, fireside
ἑστιάω	to receive at one's hearth or in one's house: to entertain, feast, regale
ἕστιος	
ἐσφορέω	
ἐσχάρα	the hearth, fire-place
ἐσχατιά	the furthest part, edge, border, verge
ἔσχατος	outermost
ἔσω	to the interior
ἔται	
ἑταῖρος	a comrade, companion, mate
ἔταροι	
ἐτελεσσαν	
ἐτεός	true, real, genuine
ἕτερος	one of the
ἑτέρωθεν	from the other side
ἑτέρωσε	to the other side
ἐτέτλαμεν	
ἔτης	clansmen
ἐτήσιαι	
ἐτήσιος	lasting a year, a year long
ἐτήτυμος	TRUE
ἔτι	yet, as yet, still
ἑτοῖμος	at hand, ready, prepared
ἔτος	a year
ἐτώσιος	fruitless, useless, unprofitable
εὖ	well
εὐα	
εὐαγής	
εὐαντέα	
Εὔβοια	Euboea
εὔβοτος	with good pasture
εὔγναμπτος	well-bent
εὐδικία	righteous dealing
εὔδιος	calm, fine, clear
εὐδιόωντες	
εὐδιόωντι	
εὔδμητος	well-built
εὐειδής	well-shaped, goodly, beautiful, beauteous
εὐεργεσία	well-doing
εὐεργής	well-wrought, well-made
εὔζυγος	well-benched
εὐήκης	well-pointed
εὐθήμων	setting in order
εὔθρονος	with beautiful throne
εὐθύς	
εὐκαμπής	well-curved, curved
εὔκηλος	free from care, at one's ease
εὐκλεής	of good report, famous, glorious
εὔκλεια	good repute, glory
εὐκλείζω	to praise, laud
εὔκομος	fair-haired
εὔκοσμος	behaving well, orderly, decorous
ἐυκραής	
ἐυκρέκτου	
ἐυκτίμενος	well-built
εὐμαρής	easy, convenient, without trouble
εὐμειδής	
εὐμενέω	to be gracious
εὐμενής	well-disposed, favourable, gracious, kindly
ἐυμμελίης	armed with good ashen spear
εὐνάζω	to lay or place in ambush
εὐναῖος	in one's bed
εὐνάω	to lay or place in ambush
εὐνέτις	
εὐνή	a bed
εὐνηθεῖσαεἰ	
εὐνῆθεν	from or out of bed
εὐνήτειρα	
εὖνις	
εὐνομία	good order, order
Ἐυξείνοιο	
ἐυξείνοισι	
ἐυξείνως	
εὔξεστος	well-planed, well-polished
εὔξοος	with polished haft
εὔορμος	with good mooring-places
εὐπαλής	
εὐπατέρεια	daughter of a noble sire
εὐπειθής	ready to obey, obedient
εὐπηγής	well-built, stout
ἐυπλόκαμος	
εὐπλόκαμος	with goodly locks, fairhaired
εὐποίητος	well-made, well-wrought
εὐπολέμειον	
εὐρέιος	
εὑρίσκω	to find
εὖρος	breadth, width
ἐυρρήνεσσιν	
ἐύρρηνος	of a good sheep
ἐύρρινοι	
ἐυρρίνων	
εὐρυβίας	
Εὐρυδάμας	
Εὐρυμέδωνκαι	
Εὐρυμενάς	
Εὐρυνόμη	
Εὐρύπυλος	
εὐρύς	wide, broad
Εὐρυσθεύς	
Εὐρυτίδης	
Εὐρυτίων	
Εὔρυτος	
εὐρύχορος	with broad places, spacious
Εὐρώπη	Europa, Europe
Εὐρώπης	
ἐύς	good, brave, noble
εὔσκοπος	sharp-seeing, keen-sighted, watchful
εὐσταθής	well-based, well-built
ἐυστείρης	
ἐύστιπτον	
ἐύστολος	
ἐυστρεφής	well-twisted
Εὔσωρος	
εὖτε	when, at the time when
εὐτρόχαλος	running well, quick-moving
εὔτροχος	well-wheeled
εὔτυκτος	well-made, well-wrought
εὐφεγγής	bright, brilliant
Εὔφημος	
εὐφρονέων	well-meaning, well-judging
εὐφροσύνη	mirth, merriment
εὔφρων	cheerful, gladsome, merry
εὔφυλλος	well-leafed
εὐχετάομαι	to pray
εὔχομαι	to pray, offer prayers, pay one's vows, make a vow
εὐχωλή	a prayer, vow
εὐώδης	sweet-smelling, fragrant
εὐῶπις	fair to look on
ἐφανδάνω	to please, be grateful to
ἐφάπτω	to bind on or to
ἐφέζομαι	to sit upon
ἐφέλκω	to draw on, drag or trail after
ἐφέπω	to go after, follow, pursue
ἐφέστιος	at one's own fireside, at home
ἐφετμή	a command, behest
ἐφευρίσκω	to light upon, discover
ἐφήδομαι	to exult over
ἐφήκω	to have arrived
ἐφημοσύνη	
ἐφιζάνω	to sit at or in
ἐφίζω	to set upon
ἐφίημι	to send to
ἐφικάνω	
ἐφίμερος	longed for, desired, charming
ἐφίστημι	to set or place upon
ἐφομαρτέω	to follow close after
ἐφοπλίζω	to equip, get ready, prepare
ἐφοράω	to oversee, observe, survey
ἐφορμάω	to stir up, rouse against
ἐφορμέω	to lie moored at or over against
ἐφορμή	a way of attack
ἐφυδάτιος	
ἐφυμνέω	to sing or chant after or over
ἐφύμνιον	
ἐφύπερθε	above, atop, above
ἐχέτλη	a plough-handle
Ἔχετος	
ἐχθαίρω	to hate, detest
ἐχθοδοπέω	in hostility with
ἐχθοδοπός	hateful, detestable
Ἐχινάδες	
Ἐχῖναι	the islands in the Ionian sea
ἔχιον	
Ἐχίος	
ἔχις	an adder, viper
Ἐχίων	
ἔχμα	that which holds;
ἔχω	to have or to hold
ἑψιάομαι	to play with pebbles
ἕωθεν	from morn
ἑώιος	
ἕως	until, till
ἑῶυ	
ζάθεος	very divine, sacred
ζαμενής	very strong, mighty, raging
ζαχρηεσιν	
ζαχρηής	attacking violently, furious, raging
ζάω	to live
ζείουσαν	
Ζέλυν	
ζεῦγλα	
ζεύγλη	the strap or loop of the yoke
ζεύγληθεν	
ζεύγνυμι	to yoke, put to
Ζεύς	Zeus
Ζέφυρος	Zephyrus, the west wind
ζέω	to boil, seethe
Ζῆθος	
ζῆλος	eager rivalry, zealous imitation, emulation
ζῆνος	
ζητέω	to seek, seek for
Ζήτης	
ζοφερός	dusky, gloomy
ζόφος	the gloom of the world below, nether darkness
ζυγή	
ζυγία	
ζύγιος	of or for the yoke
ζυγόν	anything which joins two
ζυγός	
ζυγόω	to yoke together
ζωή	a living
ζώνη	a belt, girdle
ζώννυμι	to gird
ζωός	alive, living
ζωρός	pure, sheer
ζωστήρ	a girdle
ζώω	
ἤ	
Η	
ἦ	in truth, truly, verily, of a surety
ᾔ	
ἧ	
ᾗ	which way, where, whither, in or at what place
̂Ἠ	
ᾖα	
ἠβαιός	little, small, poor, slight
ἡβάω	to be at man's estate, to be in the prime of youth
ἠγάθεος	very divine, most holy
ἥγε	
ἡγεμονεύς	
ἡγεμονεύω	to be or act as
ἠγερέθομαι	to gather together, assemble
ἡγηλάζω	to guide, lead
ἡγός	
ἠδέ	and
ᾐδέ	
ἤδη	by this time, before this, already
ἥδομαι	to enjoy oneself, take delight, take one's pleasure
ἦδος	delight, enjoyment, pleasure
ἥδυμος	sweet, pleasant
ἡδύς	sweet
ήε	
ἠέ	
ἠέλιος	
ἦενἀγχιμολον	
ἠερέθομαι	to hang floating or waving in the air
ἠέριος	early, with early morn
ἠεροειδής	of dark and cloudy look, cloud-streaked
ἠερόεις	hazy, murky
ἠθεῖος	trusty, honoured
ἠθέω	to sift, strain
ἦθος	an accustomed place
ἤια	provisions for a journey
ἠίθεος	a youth just
ἤιος	
ἠιών	a sea-bank, shore, beach
ἦκα	slightly, a little, softly, gently
ἥκω	to have come, be present, be here
ἠλακάτη	a distaff
Ἠλεῖος	
Ἠλέκτρη	
ἠλεκτρίς	
ἤλεκτρον	electron
Ἠλεκτρύων	
ἠλέματος	idle, vain, trifling
ἡλιάς	of the sun
ἠλίβατος	high, steep, precipitous
ἤλιθα	enough, sufficiently
ἧλιξ	of the same age
ἥλιος	the sun
Ἥλιος	
Ἠλύσιον	the Elysian fields
Ἠλύσιος	Elysian
ἠμαθόεις	sandy
ἧμαι	to be seated, sit
ἦμαρ	day
ἠμάτιος	by day
ἠμέν	as well .. , as also . .
ἡμερίς	the cultivated vine
ἡμέτερος	our
ἠμί	I say
ἡμιδαής	half-divided, half-mangled
ἡμίθεος	a half-god, demigod
ἡμιπλῆγα	
ἥμισυς	half
ἡμός	
ἦμος	at which time, when
̂Ἠμος	
ἠμύω	to bow down, sink, drop
ἤν	see! see there! lo!
ἡνία	
ἡνίκα	at which time, when
ἡνίον	
ἦνις	a year old, yearling
ἠνορέα	manhood
ἠνορέη	
ἧπαρ	the liver
ἠπεδανός	weakly, infirm, halting
ἤπειρόνδε	to the mainland
ἤπειρος	terra-firma, the land
ἠπειρόω	to make into mainland
ηπεοανοισιν	
ᾗπερ	in the same way as
ἠπεροπεύς	a cheat, deceiver, cozener
ἠπεροπεύω	to cheat, cajole, deceive, cozen
ἤπιος	gentle, mild, kind
ἠπύω	to call to, call on, call
ἤρα	acceptable gifts, kindnesses
Ἥρα	Hera
Ἡράκλεα	
Ἡρακλέην	
Ἡρακλέης	Heracles
Ἡρακλῆα	
Ἡρακλῆι	
Ἡρακλῆιβλημενος	
Ἡρακλῆος	
ἤρανος	
ἠρέμα	stilly, quietly, gently, softly
ἠρέμας	
ἠρεμέω	to keep quiet, be at rest
ἠρήρειντο	
ἦρι	early
ἠριγενής	
Ἠριδανός	Eridanus
ἠρίον	a mound, barrow, tomb
ἡρωίς	
ἥρως	warriors
ἡρῷσσα	
ἧσις	
ἤτοι	now surely, truly, verily
ἦτορ	the heart
ἠύρροος	
ἠύτε	as, like as
Ἥφαιστος	Hephaestus
ἠχέω	to sound, ring, peal
ἠχή	a sound or noise
ἠχήεις	sounding, ringing, roaring
ἠώ	
ἠῶθεν	from morn
ἠῷος	at morn, at break of day
ἠώς	the morning red, daybreak, dawn
Ἠώς	
θαάσσω	to sit
θᾶκος	a seat, chair
θαλαμήιος	of or for a
θάλαμόνδε	to the bed-chamber
θάλαμος	an inner room or chamber
θάλασσα	the sea
θαλέθω	to bloom, flourish
θαλερός	blooming, fresh
θαλλός	a young shoot, young branch
θάλλω	to bloom, abound, to be luxuriant
θάλπος	warmth, heat
θάλπω	to heat, soften by heat
θαμά	often, oft-times
θαμβέω	to be astounded, amazed
θάμβος	astonishment, amazement
θαμέες	crowded, close-set, thick
θαμίζω	to come often
θαμινός	frequent
θάμνος	a bush, shrub
θάνατος	death
θαρσαλέος	bold, of good courage, ready, daring, undaunted
θαρσέω	to be of good courage, take courage
θάρσος	courage, boldness
θάρσυνος	relying on
θαρσύνω	to encourage, cheer
θαῦμα	whatever one regards with wonder, a wonder, marvel
θαυμάζω	to wonder, marvel, be astonied
θέα	a seeing, looking at, view
θεά	a goddess
θεάομαι	to look on, gaze at, view, behold
θεήλατος	driven or hunted by a god
θεία	
θείνω	to strike, wound
Θειοδάμας	
θειοδάμη	
θεῖος	
θειόω	to smoke with brimstone, fumigate and purify thereby
θέλγω	to stroke or touch with magic power
θελήμων	
θελκτήριον	a charm, spell, enchantment
θελκτήριος	charming, enchanting, soothing
θέλκτρον	
θέμεθλα	the foundations, lowest part, bottom
θέμις	that which is laid down or established by custom
Θέμις	
Θεμισκύρειαι	
Θεμισκύρειον	
θεμιστεύω	to declare law and right
θεμιστοῦχος	
θεόθεν	from the gods, at the hands of the gods
θεομορία	destiny
θεον	
θεοπροπέω	to prophesy
θεοπροπία	a prophecy, oracle
θεοπρόπιον	a prophecy, oracle
θεός	God
θεούδεια	
θεουδής	fearing God
Θεραπναῖον	
θεράπνη	a handmaid
θεράπων	a waiting-man, attendant
θέραψ	
θερμός	hot, warm
θέρμω	to heat, make hot
Θερμώδων	
θέρος	summer, summertime
θέρω	to heat, make hot
θέσαν	
θέσκελος	marvellous, wondrous
θέσμιος	according to law, lawful
θεσμός	that which is laid down and established, a law, ordinance
θεσπεσιην	
θεσπέσιος	divinely sounding, divinely sweet
Θεσπίευς	
Θεσπιεύς	
θεσπίζω	to declare by oracle, prophesy, divine
Θεσπίη	
Θεσπίης	
Θεσπιός	
θέσσασθαι	to pray
Θεστιάδης	
θέσφατος	spoken by God, decreed, ordained, appointed
Θέτις	Thetis
θευμορίη	
θέω	to run
Θῆβαι	Thebes
Θήβη	
θήγω	to sharpen, whet
θηλέω	to be full of
θῆλυς	female
θήν	surely now
θήρ	a wild beast, beast of prey
Θήρα	
θήρα	a hunting of wild beasts, the chase
θηράω	to hunt or chase
θηρεία	
θήρειος	of wild beasts
θηρευτής	a hunter, huntsman
θηρευτός	
Θήρη	
Θήρης	
θηρότροφος	feeding on beasts
θηροτρόφος	feeding wild beasts
Θησεύς	Theseus
θῆσσα	
θιγγάνω	to touch, handle
θίς	a heap
θνήσκω	to die, be dying
θνητός	liable to death, mortal
θοάζω	to move quickly, ply rapidly
Θοαντιάς	
Θόας	
θοάς	
Θόη	
θόοις	
θοός	swift
θοόω	to make sharp or pointed
θοῦρος	rushing, raging, impetuous, furious
Θρᾴκη	Thrace
Θράκιος	Thracian
Θρᾷξ	a Thracian;
θράσις	
θράσος	courage, boldness
θρασύς	bold, spirited, courageous, confident
θρεπτήριος	able to feed or rear, feeding, nourishing
Θρήιξ	
Θρῄκιος	
θριγκός	the topmost course of stones in a wall
Θρινακίη	three
Θρινάκιος	
θρόνον	flowers embroidered on cloth, patterns
θρόνος	a seat, chair
θρόος	a noise
θρῴσκω	to leap, spring
θρωσμός	ground rising
θρῳσμοῦ	
θύα	
θυγάτηρ	a daughter
θύελλα	a furious storm, hurricane
θυηλή	the part of the victim that was burnt, the primal offering
θυηπολία	
θυία	an African tree with scented wood
θυιάς	a mad or inspired woman, a Bacchante
θυίω	to be inspired
θυμαίνω	to be wroth, angry
θυμαλγής	heart-grieving
θυμαρής	suiting the heart
θυμηδής	well-pleasing
θυμοβόρος	eating the heart
θυμός	the soul
θυμοφθόρος	destroying the soul, life-destroying
θυμόω	to make angry
Θυνηίδος	
Θυνιάδος	
Θυνίδι	
Θυνοί	
θύνω	to rush or dart along
θύος	a sacrifice, offering
θύρα	a door
θύραζε	out to the door, out of the door
θύσανος	a tassel
θυώδης	smelling of incense, sweet-smelling
θώραξ	a breastplate, cuirass, corslet
θωρήσσω	to arm with breastplate
ἰά	a voice, cry
ἰαίνοντυ	
ἰαίνω	to heat
ἰάλεμος	a wail, lament, dirge
ἰάλλω	to send forth
ἰάομαι	to heal, cure
Ἰάονες	the Ionians
Ἰαπετιονίδης	
Ἰαπετός	
ἰάπτω	to send on, put forth
ἴασις	healing, a mode of healing, cure, remedy
ἰαύω	to sleep, to pass the night
ἰαχέω	to cry, shout, shriek
ἰάχω	to cry, shout, shriek
Ἰαωλκός	
Ἰάων	
Ἰδαῖος	of Ida
ἰδέ	and
ἴδη	a timber-tree
Ἴδη	Ida
Ἴδης	
ἴδμων	skilled, skilful
Ἴδμων	
ἰδρεία	skill
ἴδρις	experienced, knowing, skilful
ἱδρόω	to sweat, perspire
ἱδρύω	to make to sit down, to seat
ἱδρώς	sweat
ἴδωντοι	
ἱερά	
ἱερεύς	a priest, sacrificer
ἱερεύω	to slaughter
Ἱερή	
ἱερή	
ἱερόν	
ἱερός	super-human, mighty, divine, wonderful
ἱερόω	to hallow, consecrate, dedicate
ἱζάνω	to make to sit
ἵζω	to make to sit, seat, place
ἰήιος	invoked with the cry
ἵημι	to set a going, put in motion
Ἰηπαιήων	a hymn
Ἰησονίη	
Ἰησονίην	
Ἰησονίης	
Ἰήσων	
ἰθείη	
ἰθυντήρ	a guide, pilot
ἰθύνω	to make straight, straighten
ἰθύς	
ἰθύω	to go straight, press right on
ἱκανόω	to make sufficient, qualify
ἱκάνω	to come, arrive
ἴκελος	like, resembling
ἱκεσία	the prayer of a suppliant
ἱκέσιος	of or consisting of suppliants
Ἱκέσιος	
ἱκέτης	one who comes to seek protection, a suppliant or fugitive
ἱκέτις	
ἵκετις	
ἰκμαίνοιτο	
ἰκμαίνοντο	
ἰκμαῖος	
ἰκμάς	moisture, juice
ἱκνέομαι	to come
ἴκρια	the half-decks
ἵκω	to come to
ἰλαδόν	in troops
ἱλάξασθαι	
ἱλάξονται	
ἱλάομαι	
ἱλάσκομαι	to appease
ἱλήκω	to be gracious
ἵλημι	be gracious!
Ἰλισσός	
Ἰλλυρικός	
ἰλυόεις	muddy, impure
ἰλύς	mud, slime, dirt
ἱμάς	a leathern strap or thong
ἱμάσθλη	the thong
Ἰμβρασίης	
Ἰμβρασίοισι	
Ἴμβρος	
ἱμείρω	to long for, yearn after, desire
ἱμερόεις	exciting love or desire, lovely, delightsome, charming
ἵμερος	a longing or yearning after
ἱμερτός	longed for, lovely
ἵνα	in that place, there
ἰνδάλλομαι	to appear like, look like
Ἰνδή	
Ἰνδός	an Indian
ἰνίον	the muscle at the back of the neck, the nape of the neck
Ἰξίων	Ixion
ἰξύα	
ἰξύς	the waist
ἰοβολέω	to shoot arrows, dart
ἰοδόκη	
Ἰόνιος	of or called after Io
ἰός	
ἰότης	will, desire
ἴουλος	the young hair at the side of the face, the whiskers
ἱπόειξαν	
ἱππεύς	a horseman
Ἱπποδάμεια	
Ἱπποδάμειον	
Ἱππολύτη	
ἵππος	a horse, mare
Ἱπποτάδης	
ἱππότης	a driver or rider of horses, a horseman, knight
Ἱππότης	
Ἱππουρίδος	
̂Ἰρι	
̂Ἰριν	
̂Ἰρις	
ἱρός	
Ἶρος	
ἴς	a muscle
ἰσάζω	to make equal, to balance
ἴσθμιον	anything on the neck, a necklace
Ἴσθμιος	
ἴσθμιος	Isthmian
ἰσθμός	any narrow passage
ἴσκε	he said, he spake
ἴσκω	to make like
Ἰσμηνός	
ἰσόθεος	equal to the gods, godlike
ἴσος	equal to, the same as
ἰσοφαρίζω	to match oneself with, be a match for, cope with
ἰσόω	to make equal
Ἴσσα	
fίσσετ'	
ἱστάω	
ἵστημι	to make to stand
ἱστίον	any web, a sail
ἱστοβοεύς	the plough-tree or pole
ἱστοδόκη	the mast-crutch
ἱστός	anything set upright
Ἴστρος	
ἵστωρ	a wise man, one who knows right, a judge
ἰσχανάω	to hold back, check
ἰσχάνω	to check, hinder
ἴσχω	to hold, check, curb, keep back, restrain
ἰτέα	a willow
ἰτείη	
ἰτέον	
ἴτης	
ἴτον	
Ἰτυμονεύς	
Ἰτωνίδος	
ἴφθιμος	stout, strong, stalwart
Ἰφιάς	
Ἴφικλος	
Ἰφινόη	
Ἴφιτος	
ἰχθύς	a fish
ἰχνεύω	to track out, hunt after, seek out
ἴχνιον	a track, trace, footstep
ἴχνος	a track, footstep
ἰχώρ	ichor, the etherial juice
ἰωή	any loud sound: the shout or cry
Ἰωλκίδα	
Ἰωλκός	
ἴωσις	
κάγκανον	
κάγκανος	fit for burning, dry
καγχαλάω	to laugh aloud
Καδμεῖος	Cadmean
Κάδμος	Cadmus
καθά	according as, just as
καθαρός	clear of dirt, clean, spotless, unsoiled
καθάρσιος	cleansing
καθέννυμι	to clothe
κάθημαι	to be seated
καθίζω	to make to sit down, seat
καθίημι	to send down, let fall
καθικνέομαι	to come down to
καθό	in so far as, according as
καθύπερθε	from above, down from above
καί	and
Καινεί̈δης	
Καινεύς	
καίνυμαι	to surpass, excel
καιρός	due measure, proportion, fitness
καίω	to light, kindle
κάκη	wickedness, vice
κακόμαντις	prophet of ill or evil
κακορρέκτης	
κακός	bad
κακότης	badness
κακοφραδής	bad in counsel
κακόω	to treat ill, maltreat, afflict, distress
κάλαις	a precious stone of a greenish blue
Κάλαις	
καλαμητόμος	
Καλαυρεία	
Καλαύρεια	
καλαῦροψ	a shepherd's staff
καλέω	to call, summon
κάλη	
καλιά	a wooden dwelling, hut, barn
κάλινος	
καλλίναος	beautiful-flowing
Καλλιόπη	Calliope, the beautiful-voiced
Καλλίστη	
Καλλίχορον	
καλλίχορος	with beautiful places
κάλλος	beauty
καλός	beautiful, beauteous, fair
κάλπη	
κάλπις	a vessel for drawing water, a pitcher or ewer
καλύβη	a hut, cabin, cell
Καλυδών	
κάλυπτρα	
καλύπτρα	a woman's veil
καλύπτω	to cover with
κάλυψις	
Καλυψώ	
κάλωας	
κάλωες	
καματηρός	toilsome, troublesome, wearisome
κάματος	toil, trouble, labour
κάμμορος	subject to destiny
κάμνω	to work
κάμπτω	to bend, curve
καμπύλη	
καμπύλος	bent, crooked, curved
Κανάστραιος	
καναχέω	to ring, clash, clang
καναχηδά	with a sharp loud noise
Κάνηθος	
Κάνθε	
Κάνθον	
Κάνθος	
κανών	any straight rod or bar
καπνιόωσιν	
καπνόομαι	to be turned into smoke, burnt to ashes
καπνός	smoke
καπράω	to be lewd or lecherous
κάπριος	a wild boar
κάρα	the head
Κάραμβιν	
καρδία	the heart
κάρηνον	the head
κάρος	
Κάρπαθος	Carpathus
καρπάλιμος	swift
καρπός	
καρπόω	to bear fruit or bear as fruit
καρτερός	strong, staunch, stout, sturdy;
κάρτος	strength, vigour, courage
καρτύνω	
κάρφος	a dry stalk
κάρφω	to dry up, wither
καρχαλέος	rough
κασιγνήτη	a sister
κασίγνητος	a brother
Κάσπιος	
Κάστωρ	Castor
κατά	down, downwards, with gen. or acc.
κατά-ἀίσσω	
καταβάλλω	to throw down, overthrow
καταβλώσκω	to go down through
κατά-βρόχω	
κατάγω	to lead down
καταδαρθάνω	to fall asleep
κατᾴδω	to sing to
κατά-ἕζομαι	
καταειμένος	
κατά-ἠμύω	
καταθνήσκω	to die away, be dying
καταιβάτις	
καταίγδην	
κατάιξ	
κατά-καθέζομαι	
κατακλίνω	to lay down
κατά-κνώσσω	
κατά-κτεατίζω	
κατακτείνω	to kill, slay, murder
καταλαμβάνω	to seize upon, lay hold of
καταλέγω	to lay down
καταλείπω	to leave behind
καταλωφάω	to rest from
καταναίω	to make to dwell, settle
κατά-νίζω	
κατά-νίσσομαι	
κατάντης	down-hill, downward, steep
καταντικρύ	straight down from
κατά-παρευκηλέω	
καταπίπτω	to fall or drop down
κατά-προλείπω	
κατά-προχέω	
κατά-ῥιγέω	
καταρρέζω	to pat with the hand, to stroke, caress
καταρτύω	to prepare, dress
κατασπέρχω	to urge on
καταστάζω	to let fall in drops upon, pour upon, shed over
καταστεφής	crowned
κατατίθημι	to place, put
καταυγάζω	to shine upon
καταῦθι	
καταυτόθι	
καταφαίνω	to declare, make known
καταφέρω	to bring down
καταφθίω	
καταφλέγω	to burn down, burn up, consume
καταχείριος	
καταχεύω	
καταχθονίαις	
καταψήχω	to rub down, pound in a mortar
κατείβω	to let flow down, shed
κατειλύσαντε	
κάτειμι	to go or come down
κατελεξεν	
κατεναντίον	over against, opposite, before
κατέπεφνον	to kill, slay
κατεπρήυνεν	
κατερείπω	to throw or cast down
κατερέφω	to cover over, roof
κατερητύω	to hold back
κατερύκω	to hold back, detain
κατέρχομαι	to go down from
κατεφάλλομαι	to spring down upon, rush upon
κατέχω	to hold fast
κατηλυσία	
κατήορος	hanging down, hanging on their mother's neck
κατηρεφής	covered over, vaulted, overhanging
κατήφεια	dejection, sorrow, shame
κατηφέω	to be downcast, to be mute
κατηφής	with downcast eyes, downcast, mute
κατηφιάω	
κατίσχω	to hold back
κατολισθάνω	to slip or sink down
κατόπισθεν	behind, after, in the rear
κάτος	
κατουλάς	
κατόψιος	in sight of, opposite
κάτω	down, downwards
κατωμαδόν	from the shoulders, with the arm drawn back to the shoulder
Καυκασία	
Καύκασος	Mt. Caucasus
Καυλιακοῖο	
καυλός	the shaft
Κάφαυρον	
Κάφαυρος	
καχλάζω	to plash
κεάζω	to split, cleave
κεδαιόμενος	
κεδάννυμι	to break asunder, break up, scatter
κεδόωνται	
κεῖμαι	to be laid
κεινός	
κεῖρις	
κείρω	to cut
κεκέδαστο	
κέκλεται	
κέκλομαι	
Κεκροπία	
Κεκροπίηθεν	
Κεκρόπιος	
Κέκροψ	Cecropian, Athenian
κελαδεινός	sounding, noisy
κέλαδος	a noise as of rushing waters: a loud noise, din, clamour
κελάδω	sounding, roaring
κελαινός	black, swart, dark, murky
κέλευθοιτουνεκα	
κέλευθος	a road, way, path, track
κελεύω	to urge or drive on, urge, exhort, bid, command, order
κέλλω	to drive on
κέλομαι	to urge on, exhort, command
Κελτοί	the Kelts or Celts
Κελτός	
κεμάς	a young deer, a pricket
κενός	empty
κενόω	to empty out, drain
Κένταυρος	a Centaur
κέντρον	any sharp point
κεράασι	
κεραία	any thing projecting like a horn; a yard-arm
κέραμος	potter's earth, potter's clay
κεράννυμι	to mix, mingle
κεραός	horned
κέρας	the horn of an animal
κεραυνία	
κεραυνίας	
κεραύνιον	
Κεραύνιος	
κεραυνός	a thunderbolt
κεραυνόω	to strike with thunderbolts
κεράω	
κερδαίνω	to gain, derive profit or advantage
κερδαλέος	having an eye to gain, wily, crafty, cunning
κερδίων	more profitable
κερδοσύνη	cunning, craft
κερεαλκής	
κερκίς	the rod or comb
Κέρκυρα	Corcyra
κερτομέω	to taunt or sneer at
κερτομία	jeering, mockery
κερτόμιος	heart-cutting, stinging, reproachful
Κερωσσόν	
κευθμός	
κευθμών	a hiding place, hole, corner
κεύθω	to cover quite up, to cover, hide
κεφαλή	the head
Κέως	Ceos
κηδεία	connexion by marriage, alliance
κηδεμονεύς	
κηδεμών	one who is in charge
κήδεος	given in charge for burial
κῆδος	care for
κηδοσύνη	
κήδω	to trouble, distress, vex
κηκίω	to gush or ooze
κήλη	a tumor
κηληθμός	enchantment, fascination
κῆρ	the heart
κήρ	the goddess of death
Κήρ	
Κήρινθος	
κηρίς	
κῆρυξ	a herald, pursuivant, marshal, public messenger
κῆτος	any sea-monster or huge fish
Κηφεύς	
Κιανίδος	
Κιανοί	
κίδναμαι	to be spread abroad or over
κιθάρα	guitar)
κίθαρις	
κικλήσκω	to call, summon
κινέω	to set in motion, to move
κίνυμαι	to go, move
κινύρομαι	to utter a plaintive sound, lament, wail
κινυρός	wailing, plaintive
Κίος	
Κιρκαῖον	
Κίρκαιος	
Κίρκη	Circe
κίρκος	hawk or falcon
κιρκόω	to hoop round, secure with rings
κιρνάω	to mix
κιχάνω	to reach, hit
κιχησέμεν	
κίω	to go
κίων	a pillar
κλαγγή	any sharp sound
κλάζω	to make a sharp piercing sound
κλαίω	to weep, lament, wail
Κλάρος	
κλάω	to break, break off
Κλειοπάτρην	
κλείς	that which serves for closing
κλεῖτος	
κλείω	
κλέος	a rumour, report, news
κλέω	to tell of, celebrate
κληδών	an omen or presage contained in a word or sound
κλῄζω	
κλῆρος	a lot;
κληρόω	to appoint
κλίνη	that on which one lies, a couch or bed
κλιντήρ	a couch, sofa
κλίνω	to make to bend, slope
κλισμός	a couch
κλίτος	a clime
κλονέω	to drive in confusion, drive before one
κλύδων	a wave, billow
κλύζω	to dash over
Κλυμένη	
κλύμενος	famous
Κλυτίος	
Κλυτίοσπρο	
Κλυτόνηος	
κλυτός	heard of
κλύω	to hear
κλωπήιος	
κλωστήρ	a spindle
κνέφας	darkness, evening dusk, twilight
κνημός	the projecting limb
κνίζω	to scrape or grate: to tickle
κνῖσα	the savour and steam of burnt sacrifice
κνισήεις	full of the steam of burnt sacrifice, steamy
κνυζηθμός	a whining, whimpering
Κνωσσόθεν	
κνώσσω	to slumber, sleep
κόιλος	
κοῖλος	hollow, hollowed
κοιμάω	to lull or hush to sleep, put to sleep
κοινός	common, shared in common
Κοιογένεια	
κοιρανέω	to be lord or master, to rule, command
κολέα	
κολεόν	a sheath, scabbard
κολεός	
κολούω	to cut short, dock, curtail
κόλπος	the bosom
κολπόω	to form into a swelling fold;
Κολχίς	
Κόλχος	a Colchian
Κολώνη	
κολώνη	a hill, mound
κολωνός	a hill
κολῳός	a brawling, wrangling
κομάω	to let the hair grow long, wear long hair
κομέω	to take care of, attend to, tend
κόμη	the hair, hair of the head
Κομήτης	
κομιδή	attendance, care
κομίζω	to take care of, provide for
κόναβος	a ringing, clashing, din
κονία	dust, a cloud of dust
κόνιος	
κόνις	ashes
κονίω	to make dusty, cover with clouds of dust
κόπτω	to strike, smite, knock down
κορέννυμι	to sate, satiate, satisfy
κορέω	to sweep, sweep out
κόρη	a maiden, maid, damsel
κορθύνω	to lift up, raise
κόρος	
κόρυμβος	high-pointed sterns
κορύνη	a club, mace
κορύπτω	to butt with the head
κόρυς	a helmet, helm, casque
κορύσσω	to furnish with a helmet
κορυφάς	
κορυφή	the head, top, highest point;
κορώνη	sea-crow
Κορωνίς	
Κόρωνος	
κοσμέω	to order, arrange
κοσμήτωρ	one who marshals an army, a commander
κόσμονἐπαρτεα	
κόσμος	order
κοτέω	to bear a grudge against
κότινον	
κότινος	the wild olive-tree
Κουρῆτες	
κούρητες	young men
κουρῆτις	
κουρίδιος	wedded
κουρίζω	to be a youth
κουρίξ	by the hair
κοῦρος	
κουρότερος	younger, more youthful
κουροτρόφος	rearing boys;
κοῦφος	light, nimble
κόχλος	a shell-fish with a spiral shell
κραδίας	
κραίνω	to accomplish, fulfil, bring to pass
κραιπνός	rapid, rushing
κραναός	rocky, rugged
κράς	the head
Κράταιις	
κρατερός	strong, stout, mighty
κρατερόφρων	stout-hearted, dauntless
κρατέω	to be strong, mighty, powerful
κρατήρ	a mixing vessel
κράτος	strength, might
κρατύνω	to strengthen
κρεγμός	
κρεῖον	a meat-tray, dresser
κρείουσα	
κρείων	a ruler, lord, master
κρεμάννυμι	to hang, hang up
Κρηθεΐδαο	
Κρηθεύς	
κρημνός	an overhanging bank
κρηναῖος	of, from a spring or fountain
κρήνη	a well, spring, fountain
κρήνηνδε	to a well or spring
Κρηταιέες	
Κρηταῖος	
Κρήτη	Crete
κρίνω	to pick out, choose
κριός	a ram
κρόκος	the crocus
Κρονίδης	son of Cronus
Κρόνιος	Saturnian, of Cronus or Saturn
Κρόνος	Cronus
κρόταφος	the side of the forehead
κροτέω	to make to rattle
κρούω	to strike, smite: to strike
κρυερός	icy, chilling
κρυόεις	chilling
κρυπτάδιος	secret, clandestine
κρυπτή	
κρυπτός	hidden, secret
κρύπτω	to hide, cover, cloak
κρύσταλλος	clear ice, ice
Κρωβίαλον	
Κρώμναν	
κτέανον	possessions, property
κτέαρ	
κτεατίζω	to get, gain, win
κτείνω	to kill, slay
κτέρας	a possession
κτέρεα	funeral gifts
κτερέιξεν	
Κτιμένη	
Κτίμενος	
κτίμενος	
κτυπέω	to crash
Κυάνεαι	dark rocks
κυάνεος	dark-blue, glossy-blue
κυβερνητήρ	
κυδάζω	to revile
κυδαίνω	to give or do honour to, glorify
κυδάλιμος	glorious, renowned, famous
κυδιάω	to bear oneself proudly, go proudly along, exult
κύδιστος	most glorious, most honoured, noblest
κυδοιμός	the din of battle, uproar, hubbub
κῦδος	glory, renown
κυδρός	glorious, illustrious, noble
Κύζικος	of or from Cyzicus
Κυθέρεια	Cythereia
κυκάω	to stir up
κυκεών	mixed drink, a potion, tankard
κύκλος	a ring, circle, round
Κύκλωψ	a Cyclops
κύκνος	a swan
κύλινδρος	a roller, cylinder
κυλίνδω	to roll, roll along or down
Κύλληνον	
κῦμα	anything swoln
κυμαίνω	to rise in waves or billows, to swell
κυνάω	to play the Cynic
κυνέα	
κυνέη	a dog's skin
κύνεος	shameless, unabashed
κυνέω	to kiss
Κυνός	
κύντατος	
κύντερος	more dog-like
κυνώ	a she-dog
κύπελλον	a big-bellied drinking vessel, a beaker, goblet, cup
Κύπιδος	
Κύπρις	Cypris
κύρβεις	triangular tablets
κυρέω	to hit, light upon
Κυρήνη	Cyrene
κύρμα	that which one meets with or finds
κῦρος	supreme power, authority
κυρτός	curved, arched
κυρτόω	to curve or bend into an arch
Κυταιέος	
Κυταιίδα	
Κυταιίδος	
Κυταίου	
Κυτίσσωρος	
Κύτωρος	
κυφός	bent forwards, bent, stooping, hump-backed
κύω	to conceive
κύων	a dog or bitch
κῶας	a fleece
κῶμα	deep sleep, slumber
κώμη	country town
κῶμος	a village festival: a revel, carousal, merry-making
κώπη	the handle of an oar
κωπήεις	hilted
κωρύκιον	
Κωρύκιος	Corycian
κωφός	blunt, dull, obtuse
λᾶας	
λάβρος	furious, boisterous
λαγχάνω	to obtain by lot, by fate, by the will of the gods
λαγών	the hollow on each side below the ribs, the flank
Λάδων	
λάζομαι	to take, seize, grasp
λαθιφροσύνη	
λάθρῃ	secretly, covertly, by stealth, treacherously
λᾶιγξ	a small stone, pebble
λαιμός	the throat, gullet
λαιμοτόμησαν	
λαιμοτομήσας	
λαίνεος	
λάινος	of stone or marble
λαιός	on the left
λαῖτμα	the depth or gulf
λαίφη	
λαῖφος	a tattered garment, rags
λαιψηρός	light, nimble, swift
Λακερείῃ	
λακέρυζα	one that screams or cries
λαμβάνω	to take
Λαμπείης	
λαμπετάω	to shine
Λαμπετίη	
λαμπρός	bright, brilliant, radiant
λάμπω	to give light, shine, beam, be bright, brilliant, radiant
λανθάνω	to escape notice, to be unknown, unseen, unnoticed
λάξ	with the foot
Λαοκόων	
λαός	the people
λαπάρα	the soft part of the body
Λαπίθαι	
Λαπίθης	
λάπτω	to lap with the tongue
Λάρισα	Larissa
λάρναξ	a coffer, box, chest
λαρός	pleasant to the taste, dainty, sweet
λάσιον	
λάσιος	hairy, rough, shaggy, woolly
Λάτμιος	
Λαύριος	
λαχαίνω	to dig
λάχνη	soft hair, down
λαχνήεις	hairy, shaggy
λάχος	an allotted portion
λάω	
̓Λγκαῖος	
λέβης	a kettle or caldron
λέγω	
λεηλασία	a making of booty, robbery
λείβω	to pour, pour forth
λειμών	any moist, grassy place, a meadow, mead, holm
λειμωνιάς	
λειμώνιον	
λειμώνιος	of a meadow
λεῖος	smooth, plain, not embroidered
λείπω	to leave, quit
λείριον	a lily
λείριος	
λείψανον	a piece left, wreck, remnant, relic
λεκτός	gathered, chosen, picked out
λέκτρον	a couch, bed
λελίημαι	to strive eagerly
λελίητο	
λεπταλέος	fine, delicate
λεπτόν	a very small coin, a mite
λεπτός	peeled, husked, threshed out
Λέρνα	Lerna
Λερναῖος	
Λέρνη	
Λέρνον	
Λέρνου	
λευγαλέος	in sad or sorry plight, wretched, pitiful, dismal
λευκαίνω	to make white, whiten
λευκανίηνδε	
λευκανίης	
λευκόν	white
λευκός	light, bright, brilliant
λευκόω	to make white
λεύσσω	to look or gaze upon, see, behold
λεχαῖος	in bed
λέχος	a couch, bed
λέχρις	crosswise
λεχωίδες	
λεχώιος	of or belonging to child-bed
Λεώδοκος	
λέων	a lion
λήγω	to stay, abate
Λήδη	
λῆδος	a light summer dress
λήθη	a forgetting, forgetfulness
λῆθος	
ληιάς	taken prisoner, captive
ληίζομαι	to seize as booty, to carry off as prey
λήιον	a crop
ληίς	booty, spoil
ληιστήρ	a robber
ληιστής	
ληιστός	to be carried off as booty, to be won by force
ληῖτις	she who makes or dispenses booty
Λημνιάδες	
Λημνιάδεσσιν	
Λημνιάδων	
Λημνιάς	
Λῆμνος	Lemnos
λῆνος	
λῆξις	
λῃστήρ	
λῃστής	a robber, plunderer
Λητοίδης	son of Leto
Λητώ	Leto
Λητῷος	of or born from Leto
̓Λθήνην	
λιάζομαι	to bend, incline
Λἰακίδαο	
λίαν	very, exceedingly
λιαρός	warm
λιβάς	anything that drops or trickles, a spring, stream
λίβος	a drop or fleck
Λιβύη	Libya, the north part of Africa
Λιβυρνικός	Liburnian;
Λιβυρνίς	
Λίβυς	a Libyan
Λιβυστικόν	
Λιβυστικός	
Λιβυστίς	
λίγα	in loud clear tone
λιγαίνω	to cry aloud
Λἰγαίωνος	
λίγειος	
λιγέως	
Λἴγλη	
λιγνυόεις	
λιγνύς	thick smoke mixed with flame, a murky flame
λιγυρός	clear, whistling
λιγύς	clear, whistling
Λίγυς	a Ligurian
Λιγυστίδας	
Λἰήταο	
λίθος	a stone
λιλαίομαι	to long or desire earnestly
Λιλυβηίδα	
λιμενήοχος	
λιμήν	a harbour, haven, creek
λιμνει	
λίμνη	a pool of standing water
λίμνηθεν	
λιμός	hunger, famine
Λἰνήιος	
λίνον	anything made of flax
λίπα	unctuously, richly
λιπαρέω	to persist, persevere, hold out
λιπαρός	oily, shiny with oil
λιπάω	to be fat and sleek
λίπτομαι	to be eager
λίπτοντα	
Λἰσήποιο	
Λἰσονίδαο	
Λἰσονίδης	
λισσάς	smooth, bare
λίσσομαι	to beg, pray, entreat, beseech
λισσός	smooth
λιτή	a prayer, entreaty
λιτός	smooth, plain
λίψ	
̓Λλκίνοος	
̓Λμβρακιήων	
λόγος	the word or that by which the inward thought is expressed
λοιβή	a drink-offering
λοίγιος	pestilent, deadly, fatal
λοιμός	a plague, pestilence
λοιπός	remaining, the rest
λοίσθιος	last
Λοκροί	the Locrians
Λοκρός	Locrian
λοξός	slanting, crosswise, aslant
λουτρόν	a bath, bathing place
λούω	to wash
λόφος	the back of the neck
λοχάζομαι	
λοχάω	to lie in wait for, to watch, waylay, entrap
λοχεύω	to bring forth, bear
λόχιος	of or belonging to childbirth
λόχος	an ambush
̓Λπόλλωνος	
̓Λργώ	
̓Λρήτη	
̓́Λρκτων	
λυγαῖος	shadowy, murky, gloomy
Λυγκεύς	
λυγρός	sore, baneful, mournful
λυκάβας	a year
Λυκάστιαι	
Λυκάων	
Λυκίηθεν	from Lycia
Λύκος	
λύκος	a wolf
Λυκοῦργος	
Λύκων	
Λυκωρείοιο	
Λυκωρεύς	
λῦμα	the water used in washing, washings, off-scourings, filth
λύμη	brutal outrage, maltreatment, maiming
λύρα	
Λυρκήιον	
λυσιμελής	limb-relaxing
λύσις	a loosing, setting free, releasing, ransoming
λυσσαλέος	
λυτήριος	loosing, releasing, delivering
Λὐτίκα	
λύω	to loose
λώβη	despiteful treatment, outrage, dishonour
λωβήεις	
λωβητήρ	one who treats despitefully, a foul slanderer
λωίων	more desirable, more agreeable
λώπη	a covering, robe, mantle
λῶπος	
λωφάω	to rest from toil, take rest
λωφήιος	relieving
Μάγνης	a Magnesian
Μάγνησα	
Μαγνῆτις	
Μαῖα	Maia
μαιμάω	to be very eager, pant or quiver with eagerness
Μαινάλιος	
Μαίναλον	Mount Maenalus
Μαίναλος	
μαίομαι	to seek
Μάιος	of May
μάκαρ	blessed, happy
μάκαρος	
μακέλας	
μακέλη	
μακραίων	lasting long
Μακριάδες	
Μάκριδα	
Μακριδίης	
Μακρίη	
Μάκριν	
Μάκρις	
μακρός	long
Μάκρωνες	
μάλα	very, very much, exceedingly
μαλακός	a fresh-ploughed
μαλερός	mighty, fierce, devouring, ravening
μάλη	the arm-pit
μαλίς	
μάλιστα	
μαλός	white
μανθάνω	to learn
μαντεῖον	an oracle
μάντις	one who divines, a seer, prophet
μαντοσύνη	the art of divination
μαντόσυνος	oracular
μάργος	raging mad
μαργοσύνη	
Μαριανδυνοί	
Μαριανδυνός	a wild, barbaric
μαρμάρεος	flashing, sparkling, glistening, gleaming
μαρμαρυγή	a flashing, sparkling
μάρναμαι	to fight, do battle
μάρπτω	to catch, lay hold of, seize
μαστεύω	to seek, search
μαστήρ	a seeker, searcher, one who looks for
μαστός	one of the breasts
ματάω	to be idle, to dally, loiter, linger
ματέω	
μάτη	a folly, a fault
μάτην	in vain, idly, fruitlessly
ματία	a vain attempt
μάτος	
Μεγαβρόντην	
μεγαίρω	to look on
μεγακήτης	with great hollows, cavernous
Μεγαλοσσάκεα	
μεγαλωστί	far and wide, over a vast space
Μεγαρεύς	a citizen of Megara
μέγαρον	a large room or chamber
μέγας	big, great
μεγασθενής	
μεδέων	a guardian
μεθέπω	to follow after, follow closely
μεθίημι	to let go, let loose, release
μεθό	after that.
μέθυ	wine, mead
μεθύστερος	living after
μειδάω	to smile
μειδιάω	
μείλια	soothing things, pleasing gifts
μείλικτρα	
μείλιον	
μειλίσσω	to make mild, to appease, propitiate
μειλιχία	gentleness, softness
μειλίχιος	gentle, mild, soothing
μείλιχος	gentle, kind
μειότερος	
μείρομαι	to receive as one's portion or due
μείς	a month
μελάγχιμος	black, dark
μέλαθρον	the ceiling of a room
Μελαίνα	
μέλαινα	
μελαίνω	to blacken
μελαμβαθής	darkly deep
Μελάμπους	
μελανέω	
Μελανίππη	
μελάντατον	
Μελάντιος	
Μέλας	
μέλας	black, swart
μέλε	dear!good friend!
μελε	
Μελέαγρος	
μελέδημα	care, anxiety
μελεδών	
μελειστί	limb from limb
μέλεος	idle, useless
μέλη	
μεληδών	
Μέλης	
μέλι	
μελία	the ash
Μελίβοια	
μελίζω	to modulate, sing, warble
Μελίη	
μελιηγενής	
μελιηδής	honey-sweet
μέλισσα	a bee
μελισσεύς	
μελισσοκόμος	
μελισταγής	dropping honey
Μελίτη	
Μελιτηίου	
μελίφρων	sweet to the mind, delicious
μελιχίῃ	
μελιχρός	honey-sweet
μέλλω	to think of doing, intend to do, to be about to do
μέλος	a limb
μέλπω	to sing of, celebrate with song and dance
μέλω	to be an object of care or thought
μέμαα	to wish eagerly, strive, yearn, desire
μεμάαασιν	
μέμβλεσθε	
μέμονα	to wish eagerly, to yearn, strive, be fain
μεμορμένον	
μέν	on the one hand, on the other hand
μἑν	
μενεαίνω	to desire earnestly or eagerly, to be bent on doing
μενεδήιος	standing against the enemy, staunch, steadfast
Μενετηίδος	
μενοεικής	suited to the desires, satisfying, sufficient, plentiful, agreeable to one's taste
μενοινάω	to desire eagerly, to be bent on
μενοινή	eager desire
Μενοίτιος	
μένος	might, force, strength, prowess, courage
Μέντωρ	
μένω	to stay at home, stay where one is, not stir
μέροψ	dividing the voice
Μέροψ	
μέσαυλος	the inner court, behind the
μέση	
μεσηγύ	in the middle, between
μεσηγύς	
μεσημβριάζω	to pass the noon
μεσημβριάω	
μεσημβρινός	belonging to noon, about noon, noontide
μέσης	
μεσόδμη	something built between
μέσος	middle, in the middle
μεσσόθεν	from the middle
μεσσόθι	in the middle
μέσφα	until
μετά	in the midst of, among with gen., dat., and acc.
μετα	
μετά-ἀλδήσκω	
μεταβαίνω	to pass over from one place to another
μετά-βλέπω	
μεταδρομάδην	running after, following close upon
μεταί	
μεταίγδην	
μεταίζω	to seat oneself with or beside
μεταίσσω	to rush after, rush upon
μετακιάθω	to follow after
μετά-κλείω	
μετά-κλέω	
μεταλαγχάνω	to have a share
μεταλήγω	to leave off, cease from
μεταλλάω	to search after other things
μετά-λωφάω	
μεταμώνιος	borne by the wind
μετανίσσομαι	to pass over to the other side
μετά-παιφάσσω	
μεταπρέπω	to distinguish oneself or be distinguished among
μεταρίθμιος	counted among
μετάρσιος	raised form the ground, high in air
μετασεύομαι	to rush towards or after
μεταστείχω	to go in quest of
μεταστρέφω	to turn about, turn round, turn
μετατρέπομαι	to turn oneself round, turn round
μετά-τρέφω	
μετάτροπος	turning about, returning
μετά-τρωπάω	
μεταυδάω	to speak among
μεταῦθις	afterwards
μετάφρενον	the part behind the midriff
μεταφωνέω	to speak among
μετά-χάζω	
μεταχθόνιος	
μεταχρόνιος	happening afterwards
μέτειμι	to be among
μετεῖπον	to speak among
μετεννέπω	to speak among
μετέπειτα	afterwards, thereafter
μετέρχομαι	to come or go among
μετήορος	lifted off the ground, hanging
μετιοῦσανἩρη	
μετοίχομαι	to have gone after, to have gone in quest of
μετόπιν	
μετόπισθε	from behind, backwards, back
μετρέω	to measure in any way
μέτρον	that by which anything is measured
μέτωπον	the space between the eyes, the brow, forehead
μέχρι	to a given point, even so far
μή	not
μηδέ	but not or and not, nor
Μηδεία	
Μήδειος	
Μηδίς	a Median woman
μήδομαι	to be minded, to intend, resolve
μῆδος	
μηκέτι	no more, no longer, no further
μήκιστος	tallest
μῆκος	length
μηκύνω	to lengthen, prolong, extend
μήλειος	of a sheep
μήλη	a probe
μηλίς	
μηλοβοτήρ	a shepherd
μῆλον	
μήν	now verily, full surely
μήνη	the moon
μηνιόωσιν	
μῆνις	wrath, anger
μηνίτις	
μηνίω	to be wroth with
μήποτε	never, on no account
μήπως	lest in any way, lest any how, lest perchance
μῆρα	
μηρία	slices cut from the thighs
μηρός	the thigh
μηρύομαι	to draw up, furl
μής	
μήτε	and not
μήτηρ	a mother
μήτηρΓοργονος	
μητιάω	to meditate, deliberate, debate
μητίομαι	to devise, contrive, plan
μῆτις	the faculty of advising, wisdom, counsel, cunning, craft
μήτις	lest any one, lest anything; that no one, that nothing
μητρίς	
μητρυιά	a step-mother
μήτρως	a maternal uncle
μηχανάομαι	to prepare, make ready
μηχανόωντες	
μῆχος	a means, expedient, remedy
μιαίνω	to stain, dye
μίγα	mixed with
μιγάς	mixed pell-mell
μίγδην	
μίγνυμι	to mix, mix up, mingle, properly of liquids
μικρός	small, little
μικτός	mixed, blended, compound
Μίλητος	Miletus
Μίμας	
μιμνάζω	to wait, stay
μιμνήσκω	to remind, put
μίμνω	to stay, stand fast
μιν	himself
Μινύαι	the Minyans
Μινύειος	Minyan
Μινυηίδος	
Μινύης	
μινύθω	to make smaller or less, lessen, curtail
μίνυνθα	a little, very little
μινυνθάδιος	shortlived
Μίνυος	
Μινωίδας	
Μινωίδος	
Μινώιος	of Minos
Μινωίς	
Μίνως	Minos
μιξοδία	
μισθός	wages, pay, hire
μίτρα	a belt or girdle
μνάομαι	to turn one's mind
μνημεῖον	a monument
μνημήιον	
μνημήιος	
μνηστεύω	to woo, court, seek in marriage
μνῆστις	remembrance, heed
μνηστός	wooed and won, wedded
μνιόεις	
μνώεο	
Μνώεο	
μογερός	toiling, wretched
μογέω	to toil, suffer
μοῖρα	a part, portion
Μοῖρα	
μοιράω	to share, divide, distribute
μοιρηγέται	
Μοῖρις	
μόλιβος	lead
μόλις	not scarcely
μολπάζω	to sing of
μολπή	the song and dance, a chant or song accompanied by measured movements
μονογενής	only-begotten, single
μόνος	alone, left alone, forsaken solitary
μονόω	to make single or solitary
μορέω	to make with pain and toil
μορμύρω	to roar and boil
μόρον	
μόρος	man's appointed doom, fate, destiny
μόρσιμος	appointed by fate, destined
μορφάζω	to use gesticulations
μορφάω	to shape, fashion, mould
μορφή	form, shape
μόσσυν	a wooden house or tower
Μοσσύνοικοι	dwellers-in-wooden-houses
μουνογένειαν	
Μοῦσα	the Muse
μοχθέω	to be weary with toil, to be sore distressed
μοχθίζω	to suffer
Μόψος	
μυδαλέος	wet, dripping
μυδάω	to ooze with damp, be clammy
μυδήνας	
μύζω	to murmur with closed lips, to mutter, moan
μυθέομαι	to say, speak
μυθόομαι	
μῦθος	anything, delivered by word of mouth, word, speech
μυῖα	a fly
μυκή	
μυκηθμός	a lowing, bellowing
μύκημα	a lowing, bellowing, roaring
Μυκηναῖος	Mycenaean
μύλη	the nether millstone
μυλήφατος	bruised in a mill
Μύρινα	
Μυρίνη	
μυρίνης	
μυρίος	numberless, countless, infinite
μύρμηξ	a beast of prey
Μυρμιδόνες	the Myrmidons
Μυρμιδών	
Μυρτίλος	
Μυρτώσιον	
μύρω	to flow, run, trickle
μυσή	
μυσία	
Μυσίδ'	
Μυσίδα	
Μύσιος	a Mysian dirge
μυσόν	
μύσος	uncleanness
Μυσός	a Mysian
μύχατος	
μύχιος	inward, inmost, retired, embayed
μυχόνδε	to the far corner
μυχός	the innermost place, inmost nook or corner
μύω	to close, be shut
μυών	a cluster of muscles, a muscle
μύωψ	contracting the eyes
μῶλος	the toil
μωμάομαι	to find, fault with, blame
νᾶεν	
ναί	yea, verily
Ναιάς	a Naiad, a river nymph
ναιετάω	to dwell
Ναίς	
ναίω	
νάοντος	
ναός	the dwelling of a god, a temple
νάπη	a wooded vale, dell
νάπος	
Νάρηκος	
Νασάμωνα	
νάσσω	to press or squeeze close, stamp down
Ναυβολίδης	
Ναύβολος	
Ναυπλιάδαο	
Ναυπλιεύς	a Nauplian
Ναύπλιος	
ναύπορος	ship-frequented
ναῦς	a ship
Ναυσίθοος	
ναύτης	a mate or companion by sea
ναυτιλία	sailing, seamanship
ναυτίλλομαι	to sail, go by sea
ναυτίλος	a seaman, sailor
νάω	to flow
νέα	
νεᾶνις	a young woman, girl, maiden
νεάτη	the lowest of the three strings
νέατος	the last, uttermost, lowest
νει	
νεικέω	to quarrel or wrangle with
νεῖκος	a quarrel, wrangle, strife
νειόθεν	from the bottom
νειόθι	at the bottom
νεῖος	
νειός	land ploughed up anew
νεκρός	a dead body, corpse
νέκταρ	nectar
νεκτάρεος	nectarous
νέκυς	a dead body, a corpse, corse
νέμεσις	distribution of what is due;
νέμος	a wooded pasture, glade
νέμω	to deal out, distribute, dispense
νέοζυξ	
νεοθηγής	
νεόθρεπτος	
νέομαι	to go or come
νέος	young, youthful
νεοσσός	a young bird, nestling, chick
νεότης	youth
νεότμητος	newly cut
νεόω	to renovate, renew
νέποδες	young ones, children
νέρθε	
Νεσταίους	
Νέστιδος	
νευρά	a string or cord of sinew, a bowstring
νευρή	
νεύω	to nod or beckon
νεφέλη	a cloud
νέφος	a cloud, mass or pile of clouds
νέω	
νεώς	a temple
νηγάτεος	new-made
νήδυια	the bowels, entrails
νηδύς	the stomach
νηέω	to heap, heap or pile up
νηιος	
νήιος	of or for a ship
νῆις	unknowing of, unpractised in
νηίτης	consisting of ships
νηκερδής	unprofitable
νηλεής	
νηλειής	
Νηλεύς	
Νηληίς	
νηλής	pitiless, ruthless
νήλιπος	
νῆμα	that which is spun, a thread, yarn
νημερτής	unerring, infallible
νηνεμία	stillness in the air, a calm
νήνεμος	without wind, breezeless, calm, hushed
νηόνδε	
νηοσσόος	
Νηπήιον	
νηπίαχος	infantine, childish
νηπιάχω	
νήπιος	not yet speaking
νηπυτία	
Νηρεύς	Nereus
Νηρηίς	a daughter of Nereus, a Nereid or Nymph of the sea
νήριτος	countless, immense
νῆσονδε	
νῆσος	an island
Νηῦν	
νηφάλιος	unmixed with wine, wineless
νήχυτος	
νήχω	to swim
νίζω	to wash the hands or feet
νικάω	to conquer, prevail, vanquish
νίκη	victory in battle
Νισαῖος	
νίσσομαι	to go, go away
νιφετός	falling snow, a snowstorm
νιφόεις	snowy, snowclad, snowcapt
νίφω	to snow
νἱωνός	
νοέω	mere sight
νόησις	intelligence, thought
νομεύς	a shepherd, herdsman
νομή	a pasture, pasturage
νόμιος	of shepherds, pastoral
νομός	a feeding-place
νόος	mind, perception
νόσος	sickness, disease, malady
νοστέω	to come or go back, return
νόστιμος	belonging to a return
νόστος	a return home or homeward
νόσφι	aloof, apart, afar, away
νοσφίζομαι	to turn one's back upon
νοτίζω	to wet
νότιος	wet, moist, damp
νοτίς	moisture, wet
νότος	the south or south-west wind
νοῦσος	
Νυκτεύς	
νυκτιπόλος	roaming by night
νύκτωρ	by night
νυμφαία	
νυμφαῖος	of or sacred to the nymphs
νύμφη	a young wife, bride
Νύμφης	
νυμφίδιος	of a bride, bridal
νῦν	now at this very time
Νύξ	
νύξ	the night-season or a night
νυός	a daughter-in-law
Νῦσα	
νύσσα	posts
νύσσω	to touch with a sharp point, to prick, spur, pierce
νύχιος	nightly
νύχος	
νωθής	sluggish, slothful, torpid
νωλεμές	without pause, unceasingly, continually
νωμάω	to deal out, distribute
νώνυμνος	
νῶτον	the back
νῶτος	
ξαίνω	to comb or card
Ξάνθος	
ξανθός	yellow
ξεινήιον	a host's gift
ξένιος	belonging to a friend and guest, hospitable
ξένος	
ξενόω	to make one's friend and guest
ξερόν	
ξερός	dry
ξεστός	smoothed, polished, wrought
ξέω	to smooth or polish by scraping, planing, filing
ξηρά	dry land
ξηρός	dry
ξίφος	a sword
ξόανον	an image carved
ξύλον	wood
ξύλοχος	a thicket, copse
ξυναρέσσατο	
Ξυνιάδος	
ξυνός	common, public, general, concerning or belonging to all in common
ξυστόν	the polished shaft
ξυστός	
ὁ	the, that
ὄαρος	familiar converse, fond discourse, chat, talk
ὄβριμος	strong, mighty
Ὀγχηστόν	
Ὀγχηστός	
ὀδακτάζοντι	
ὀδάξ	by biting with the teeth
ὁδάω	to export and sell;
ὅδε	this
ὁδεύω	to go, travel
ὁδίτης	a wayfarer, traveller
ὀδμάομαι	
ὁδός	
ὀδούς	
ὁδόω	to lead by the right way
ὀδυνάω	to cause
ὀδύνη	pain of body
ὀδύρομαι	to lament, bewail, mourn for
ὀδών	
ὄζος	a bough, branch, twig, shoot
ὄζω	to smell
ὅθι	
ὀθνεῖος	strange, foreign
ὄθομαι	to care for, take heed, regard, reck
ὀθόνη	fine linen
ὁθούνεκεν	
Ὄθρυς	Othrys
Οἴαγρος	
οἴαξ	the handle of the rudder, the tiller
Οἰαξίδος	
οἴγω	to open
οἶδα	to know
οἰδάνω	to make to swell
οἶδμα	a swelling, swell
οἰέανος	
ὀίζυος	sorry, wretched
ὀιζυρός	woful, pitiable, miserable
ὀιζύς	
ὀιζύω	to wail, mourn, lament
οἴη	
οἰήιον	a rudder, helm
οἴκαδε	to one's home, home, homewards
οἰκία	a building, house, dwelling
οἰκίον	
οἶκόνδε	
οἶκος	a house, abode, dwelling
οἰκτειρέω	
οἰκτείρω	to pity, feel pity for, have pity upon
οἴκτιστος	most pitiable, lamentable
Ὀιλεύς	Oi_leus
Ὀϊλεύς	
οἴμη	a song, lay
οἶμος	a way, road, path
οἰμωγή	loud wailing, lamentation
Οἰνεί̈δης	
Οἰνεύς	
Οἰνόμαος	
οἶνον	
οἶνος	wine
οἰνόχοος	
οἰνοχόος	a wine-pourer, cupbearer
οἰνόω	to intoxicate
οἰόθεν	from one only
οἰόθι	
οἴομαι	to suppose, think, deem, imagine
οἰοπέδιλος	
οἰοπόλος	traversed by sheep
οἶος	alone, lone, lonely
οἷος	such as, what sort or manner of nature, kind
οἱοὔτι	
ὄις	ram
ὀισσάμενος	
ὀίσσατο	
ὀιστεύω	to shoot arrows
ὀιστοδόκη	
ὀιστός	an arrow
οἶστρος	the gadfly, breese
οἶτος	fate, doom
Οἰχαλία	
οἴχομαι	to be gone, to have gone
οἰωνός	a large bird, bird of prey
οἵως	
ὀκλαδόν	
ὀκλάξ	
ὀκριόεις	having many points or roughnesses, rugged, jagged
ὀκρυόεις	chilling, horrible
ὁλάω	
ὄλβος	happiness, bliss, weal, wealth
ὄλεθρος	ruin, destruction, death
ὀλέκω	to ruin, destroy, kill
ὀλίγος	few, little, scanty, small
ὀλισθάνω	to slip, slip and fall
ὁλκαία	
ὁλκαῖον	
ὁλκαῖος	
ὁλκάς	a ship which is towed, a ship of burthen, trading vessel, merchantman
ὁλκή	a drawing, dragging, tugging: a drawing on or towards
ὁλκήιον	
ὁλκός	
ὄλλυμι	to destroy, make an end of
ὀλολύζω	to cry to the gods with a loud voice, cry aloud
ὅλοξ	whole, entire, complete
ὀλοός	destroying, destructive, fatal, deadly, murderous
ὀλοόφρων	meaning mischief, baleful
ὅλος	
ὀλοφύρομαι	to lament, wail, moan, weep
ὀλοφώιος	destructive, deadly, pernicious
Ὀλύμπιος	Olympian, of Olympus, dwelling on Olympus
Ὄλυμπόνδε	to Olympus
Ὄλυμπος	Olympus
ὁμαδέω	to make a noise or din
ὅμαδος	a noise, din
ὁμαρτέω	to meet
ὁμαρτῇ	together
ὁμαῦλαξ	with adjoining lands
ὀμβρέω	to rain
ὄμβρος	
ό̓μβρος	heavy rain
ὁμηγερής	assembled
ὁμήθεας	
ὁμήθεες	
ὁμηλικία	sameness of age
ὁμῆλιξ	of the same age
ὁμιλαδόν	in groups or bands, in crowds
ὁμιλέω	to be in company with, consort with
ὅμιλος	any assembled crowd, a throng of people
ὄμμα	the eye
ὄμνυμι	to swear
ὁμόγνιος	of the same race
ὁμόθεν	from the same place
ὁμοῖος	
ὅμοιος	like, resembling
ὁμοκλέω	to call out together
ὁμοκλή	a joint call;
ὁμοκλη	
Ὁμόλη	
ὁμόνοια	oneness of mind or thought, unity, concord
ὀμόργνυμι	to wipe
ὁμορέω	to border upon, march with
ὁμός	one and the same, common, joint
ὁμόστολος	in company with
ὁμοῦ	at the same place, together
ὁμούριοι	
ὁμοφροσύνη	
ὁμόω	to unite
ὄμπνιος	of or relating to corn
ὀμφή	the voice of a god
ὁμῶλαξ	
ὁμῶς	equally, likewise, alike
ὅμως	all the same, nevertheless, nothwithstanding, still
ὄνειαρ	anything that profits or helps
ὄνειδος	reproach, censure, blame
ὄνειρος	a dream
ὀνήιστον	
ὄνησις	use, profit, advantage, good luck
ὀνίνημι	to profit, benefit, help, assist
ὄνομα	by name
ὄνομαι	to blame, find fault with, throw a slur upon, treat scornfully
ὀνομαίνω	to name or call by name
ὀνομαστής	
ὀνομαστός	named, to be named
ὀνοτός	
ὀξύς	sharp, keen
ὀπάζω	to make to follow, send with
ὀπάων	a comrade
ὅπη	by which way
ὀπή	an opening, hole
ὀπηδεύοντα	
ὀπηδεύουσα	
ὀπηδός	
ὀπιδνός	
ὀπίζομαι	to regard with awe and dread
ὀπιπτεύω	to look around after, gaze curiously or anxiously at
ὄπισθεν	behind, at the back
ὀπίσσω	
ὀπίσω	backwards
ὁπλίζω	to make or get ready
ὅπλον	a tool, implement
ὁπλότατος	youngest
ὁπλότερος	the younger
Ὀπόεις	
ὀπόεις	
ὁπόθεν	whence, from what place
ὁπόθι	where
ὁπόσε	
ὁπόσος	as many as
ὁπόταν	whensoever
ὁπότε	when
Ὀπούντιος	
ὀπυίω	to marry, wed, take to wife
ὀπωπή	a sight or view
ὅπως	as, in such manner as
ὁράω	To see
ὄργια	orgies
ὀργιάζω	to celebrate orgies
ὀρέγω	to reach, stretch, stretch out
ὄρειος	of or from the mountains, mountain-haunting
ὀρείχαλκος	copper ore
ὀρεύς	a mule
ὀρεχθέω	to stretch oneself or struggle in the throes of death
ὄρθιος	straight up, going upwards, steep, uphill
ὀρθός	straight
ὀρθοσταδόν	
ὀρθόω	to set straight
ὀρίνω	to stir, raise, agitate
ὀριτρεφέος	
ὅρκιον	an oath
ὅρκιος	belonging to an oath
ὅρκος	the object by which one swears, the witness of an oath
ὁρμαίνω	to turn over or revolve anxiously in the mind, to debate, ponder
ὁρμάω	to set in motion, urge
ὁρμέω	to be moored, lie at anchor
ὁρμή	a violent movement onwards, an assault, attack, onset
ὁρμίζω	to bring to a safe anchorage, bring into harbour, to moor, anchor
ὅρμος	a cord, chain
ὄρνις	a bird
ὄρνυμι	to stir, stir up
Ὀρνυτίδαο	
Ὄρνυτος	
ὀροθύνω	to stir up, rouse, urge on, excite
ὅρος	a boundary, landmark
ὄρος	a mountain, hill
ὀρούω	to rise and rush violently on, to move quickly, rush on, hasten, dart forward
ὄρπηξ	a sapling, young tree
Ὀρτυγία	quail-island
ὀρυμαγδός	a loud noise, din
ὀρύσσω	to dig
ὀρφανός	an orphan
Ὀρφεῖος	
Ὀρφεύς	Orpheus
ὀρφεύς	
ὀρφναῖος	dark, dusky, murky
ὄρφνη	the darkness
ὄρχαμος	the first of a row, a file-leader
ὀρχέομαι	to dance in a row
Ὀρχομενός	
ὅς	this, that;
ὅσγε	who or which at least
ὀσμή	a smell, scent, odour
ὅσος	quantus
ὄσσα	a rumour
Ὄσσα	
ὁσσάτιος	
ὄσσε	the two eyes
ὄσσομαι	to see
ὅστε	who, which
ὀστέον	the
ὅστις	any one who, anything which
ὄστλιγγες	
ὅταν	whenever
ὅτε	when
ὅτι	
ὀτλεύω	to suffer, endure
ὀτλήσειαν	
ὀτλησέμεν	
ὀτλήσω	
ὀτραλέος	quickly, readily.
Ὀτρηρή	
ὀτρηρός	quick, nimble, busy, ready
ὀτρύνω	to stir up, rouse, egg on, spur on, encourage
οὗ	where
οὐ	not
οὖδας	the surface of the earth, the ground, earth
οὐδέ	but not
οὐδείς	and not one
οὐδός	
οὐκέτι	no more, no longer, no further
οὐλόμενον	
οὐλόμενος	destructive, baneful
οὐλοός	
οὖλος	
οὐλοχύται	barley-groats or coarsely-ground barley sprinkled
οὖν	really, at all events
οὕνεκα	on which account, wherefore
οὗπερ	
οὔποτε	not ever, never
οὔπω	not yet
οὐρά	the tail
οὐραῖος	of the tail
Οὐρανίδης	son of Uranus
οὐράνιος	heavenly, of or in heaven, dwelling in heaven
οὐρανόθεν	from heaven, down from heaven
Οὐρανός	
οὐρανός	heaven
οὔρειος	
οὐρεύς	a mule
οὐρέω	to make water
οὐρίαχος	the hindmost part, bottom
οὖρον	
οὖρος	
οὖς	auris, the ear
οὐτάζω	to wound
οὐτάω	to wound, hurt, hit
οὔτε	and not
οὔτι	not, I suppose . . , surely you do not mean that . .
οὔτις	no one or nobody
οὗτος	this
οὕτως	in this way or manner, so, thus
ὀφέ	
ὀφείλω	to owe, have to pay or account for
ὀφέλλω	to increase, enlarge, strengthen
ὀφθαλμός	the eye
ὄφις	a serpent, snake
Ὄφις	
ὀφίων	
ὄφρα	that, in order that, to the end that
ὀφρύς	the brow, eyebrow
ὀχεύς	anything for holding or fastening
ὀχθέω	to be sorely angered, to be vexed in spirit
ὄχθη	a rising ground, a bank, dyke
ὀχλίζω	to move by a lever, to heave up
ὀχμάζω	to grip fast
ὄψ	a voice
ὀψε	
ὀψέ	after a long time, late
ὀψίγονος	late-born, after-born
π̔'	
Παγασαί	
Παγασηίδα	
Παγασηίδας	
Παγασήιος	
πάγη	anything that fixes or fastens, a snare, noose, trap
πάγκαρπος	of all kinds of fruit
πάγος	that which is fixed or firmly set
πᾶγος	
παγχάλκεος	all-brasen, all-brass
παγχρύσεος	all-golden, of solid gold
πάγχυ	quite, wholly, entirely, altogether
Παιάν	Paean or Paeon
Παιήων	
πάιν	
παιπαλόεις	craggy, rugged
παῖς	a child
παιφάσσω	to dart or rush wildly about
Πακτωλός	
πάλα	
πάλαι	long ago, in olden time, in days of yore, in time gone by
παλαιγενής	born long ago, full of years, ancient
Παλαιμόνιος	
παλάμη	the palm of the hand, the hand
παλαμναῖος	one guilty of violence, a blood-guilty man, murderer
παλάσσω	to besprinkle, sully, defile
πάλη	wrestling
παλιμπετής	falling back
παλίμπνοιος	
πάλιν	back, backwards
παλινάγρετος	to be taken back or recalled
παλίνορσος	starting back
παλίντονος	back-stretched, back-bending
παλιντροπάασθαι	
παλιντροπία	
παλιντροπόωντο	
παλιντυπής	
παλιρρόθιος	back-rushing, refluent
παλίσσυτος	rushing hurriedly back
Παλλάς	Pallas
Παλλήναια	
πάλλω	to poise or sway
πάλος	the lot cast from a shaken helmet
πᾶλος	
παλύνω	to strew or sprinkle
παμβασίλεια	queen of all
πάμπαν	quite, wholly, altogether
παμπρώτιστα	
πάμπρωτος	first of all, the very first
παμφαίνω	to shine or beam brightly
παμφανόων	bright-shining, beaming
παναίολος	all-variegated, sparkling
πανατρεκής	all-exact, infallible
Παναχαιίδος	
πανδαμάτωρ	the all-subduer, all-tamer
πάνδημος	of or belonging to all the
Πανέλληνες	all the Hellenes
πανέσχατος	
πανεύκηλος	
πανημέριος	all day long
πανήμερος	
παννύχιος	all night long
πάννυχος	lasting all the night
πάνοπλος	in full armour, full-armed
πανοπλότατος	
πάντῃ	
πάντοθεν	from all quarters, from every side
παντοῖος	of all sorts or kinds, manifold
πάντοσε	every way, in all directions
πανυπέρτατος	highest of all
πανύστατος	last of all
πάομαι	to get, acquire
παπταίνω	to look earnestly, gaze
παρά	from the side of, c. gen., beside, alongside of, c. dat., to the side of, motion alongside of, c. acc.
παρά-ἀλιταίνω	
παρά-ἀνίημι	
παραβαίνω	to go by the side of
παράβασις	a going aside, deviation
παραβάτις	a woman who follows the reapers
παρά-βιόω	
παραβλήδην	thrown in by the way
παραβλώσκω	to go beside
παρά-ἑδριάω	
παρά-ἐκθέω	
παρά-ἐνέπω	
παρά-ἐνήνοθε	
παρά-ἐξαμείβω	
παρά-ἐξερέω	
παρά-ἐξέρομαι	
παρά-ἧμαι	
παρά-θερίζω	
παρά-θρίζω	
παραιβάτις	
Παραίβιος	
παραιθύσσω	to move or stir in passing
παραίσσω	to dart past
παραιφάμενος	exhorting, encouraging
παραιφασίη	
παρακατατίθεμαι	to deposit one's own property with
παρά-κέλομαι	
παρακλιδόν	bending sideways, turning aside, swerving
παρακλίνω	to bend or turn aside
παράκοιτις	a wife, spouse
παραλέγω	to lay beside
παραμείβω	to leave on one side, pass by
παραμετρέω	to measure
παρά-νέομαι	
παρά-νέω	
παρανηνέω	to heap or pile up beside
παρανίσσομαι	to go past
παραπαφίσκω	to mislead, beguile
παρᾶσσον	
παρά-στενάχω	
παρά-στρωφάω	
παρασχεδόν	
παρά-σχέθω%	
παρατίθημι	to place beside
παρατρέπω	to turn aside
παρατρέχω	to run by or past
παρατροπέω	leading
παρατροπή	a turning away, means of averting
παράφασις	an address, encouragement, consolation
παράφημι	to speak gently to, to advise
παρβολάδην	
πάρεδρος	sitting beside
παρέζομαι	to sit beside
παρειά	the cheek
παρειάς	
παρείας	
παρείης	a reddish-brown snake
πάρειμι	to be by or present
παρέξ	outside, before
παρεξελαύνω	to drive out past, to pass
παρέστιος	by or at the hearth
παρέχω	to hold beside, hold in readiness, to furnish, provide, supply
παρηγορέω	to address, exhort
παρηγορία	exhortation, persuasion
παρήγορος	consoling
παρήιον	the cheek, jaw
παρηίς	
παρηορία	side-traces
παρηόριος	
παρθενία	
παρθενίας	
Παρθενίη	
παρθενίης	the son of a concubine
παρθενική	
παρθενικός	of or for a maiden
παρθένιον	
παρθένιος	of a maiden or virgin, maiden, maidenly
Παρθένιος	
παρθένος	a maid, maiden, virgin, girl
παριαύω	to sleep beside
παρίζω	to sit beside
παρίημι	to let drop beside or at the side, let fall
παρίστημι	to make to stand or to place beside
Παρνησσός	
πάροιθε	before, in the presence of
παροίτατος	
παροίτερος	the one before or in front
παροίχομαι	to have passed by
πάρος	beforetime, formerly, erst
παρράλιος	
Παρράσιος	
πᾶς	all, the whole
πᾶσις	
Πασιφάη	
πασσυδίῃ	
πάσσω	to sprinkle
παστάς	a porch
πάσχω	to receive an impression from without, to suffer
πατέομαι	to eat
πατέω	to tread, walk
πατήρ	a father
πάτηρ	
πάτος	a trodden or beaten way, path
πάτρα	fatherland, native land, country, home
πάτρη	
πάτρηθεν	
πάτρηνδε	
πατρίς	of one's fathers
πατροπάτωρ	a father's father
πατρώιος	
πατρῷος	of or from one's father, coming or inherited from him
παῦρος	little, small
παύω	to make to cease
Παφλαγών	a Paphlagonian
πάχνη	hoar-frost, rime
παχνόω	to congeal, make solid
πάχος	thickness
πεδάω	to bind with fetters, to bind fast, make fast
πέδιλον	sandals
πεδίον	a plain or flat
πέδιον	
πεδίονδε	to the plain
πεδόθεν	from the ground
πέδον	the ground, earth
πέζα	bottom or end
πεζός	on foot
πείθω	to prevail upon, win over, persuade
πεῖρα	a trial, attempt, essay, experiment
πειράζω	to make proof or trial of
πεῖραρ	an end
πείρασις	
πειράω	to attempt, endeavour, try
Πειρεσιαί	
Πειρεσιάς	
Πειρίθοος	
πείρινς	a wicker-basket
πείρω	to pierce quite through, fix
πεῖσμα	a ship's cable
πέλαγος	the sea
πέλαγοσδε	
πελάζω	to approach, come near, draw near or nigh
πέλανος	any half-liquid substance
πέλας	near, hard by, close
Πελασγικός	Thessalian
Πελασγίς	
Πελασγιῶται	Pelasgiotes
Πελασγός	a Pelasgian;
πέλεια	the wild-pigeon, rock-pigeon, stock-dove
πελειάς	
πελεκάω	to hew or shape with an axe
πέλεκυς	an axe
πελεμίζω	to shake, to make to quiver or tremble
πελεν	
Πελίης	
Πέλλα	
Πελλήνη	
πέλλος	
Πελοπεία	
Πελοπήια	
Πελοπηίδα	
Πελοπήιοι	
Πέλοψ	Pelops
πέλω	to be in motion
πέλωρ	a portent, prodigy, monster
πελωρίη	
πελώριος	gigantic
πέλωρον	a monster, prodigy
πέλωρος	monstrous, prodigious, huge, gigantic
πεμπάζω	to count on the five fingers
πέμπτος	the fifth, oneself with four others
πέμπω	to send, despatch
πένθος	grief, sadness, sorrow
πένομαι	to work for one's daily bread
πέντε	five
πέπλος	any woven cloth
πεπλος	
πεπτάμενον	
πέπων	cooked by the sun, ripe, mellow
πέρ	all
πέρα	beyond, across or over, further
περαίας	
περαίη	
περαίνω	to bring to an end, finish, accomplish, execute
περαιόθεν	
περαῖος	on the other side
πέραιος	
περαιόω	to carry to the opposite side, carry over or across
περαίτερος	beyond
πέραν	on the other side, across, beyond
πέρας	an end, limit, boundary
περάτη	
περάτηθεν	
πέρατος	on the opposite side
περάω	
πέρθω	to waste, ravage, sack, destroy
περί	around, round about with gen., dat., and acc.
περιάγνυμι	to bend and break all round
περίαλλος	before all others;
περιβάλλω	to throw round
περιβληχρόν	
περιβλύει	
περί-βρομέω	
περιγηθής	
περιγνάμπτω	to double
περί-δαίω	
περιδείδω	to be in great fear about
περίδρομος	
περίειμι	to be around
περιέχω	to encompass, embrace, surround
περιηγής	tied behind one
περιθαμβής	much alarmed
περιθαρσής	
περιθέω	to run round
περικαλλής	very beautiful
περί-καταβάλλω	
περί-καταπίπτω	
περί-κατατίθημι	
περικλαδής	
περικλεής	
Περικλύμενος	
περικτίονες	dwellers around, neighbours
περιμήκης	very tall or long
περιναιετάω	to dwell round about or in the neighbourhood
περιναιέτης	one of those who dwell round, a neighbour
πέριξ	round about, all round
περιπέλομαι	to move round, be round about
περίπλεος	
περιπλέω	to sail or swim round
περιπολλόν	
περιπρό	very much, especially
περιπτύσσω	to enfold, enwrap
περίπυστος	known all round about
περιρρήδην	
περιρρηδής	doubled round or over
περισκοπέω	to look round
περισσός	beyond the regular number or size, prodigious
περισταδόν	standing round about
περισχίζω	to slit and tear off
περί-τίω	
περιτρέπω	to turn and bring round
περιτρέφομαι	forms curds
περιτρέχω	to run round and round, run round
περιτριβής	
περιτροπάδην	
περίτροχος	circular, round
περιφείδομαι	to spare and save
περιφραδής	very thoughtful, very careful
περιωπή	a place commanding a wide view
περιώσιος	immense, countless
Περκώσιος	
Περκώτης	
περονάω	to pierce, pin
περόνη	anything pointed for piercing or pinning, the tongue of a buckle or brooch, the buckle or brooch
Πέρσευς	
Περσεύς	Perseus
Περσηίς	sprung from Perseus
Πέρσης	a Persian, inhabitant of Persis
πέρσις	a sacking, sack
πέσσω	to soften, ripen or change
πέταλον	a leaf
πέταλος	broad, flat
πετάννυμι	to spread out
πέτομαι	to fly
πέτρα	a rock, a ledge or shelf of rock
πετραία	
πετραῖος	of a rock
Πέτρη	
πέτρος	a stone
πεύθομαι	
πεύκη	the pine
πη	in some way, somehow
πῆ	in what way? how?
πηγάζω	to spring or gush forth
Πηγαί	
πηγάς	anything congealed, hoarfrost, rime
πηγή	running waters, streams
πήγνυμι	to make fast
πηγός	well put together, compact, strong
πηγυλίς	frozen, icy-cold
πηδάλιον	a rudder or an oar used for steering
πηδάω	to leap, spring, bound
πηδόν	
πηδός	the blade of an oar
Πηλείδης	
Πηλεύς	Peleus
πήληξ	a helmet, casque
Πηλιακός	Pelian, of or from Mount Pelion
Πηλιάς	
Πήλιον	Pelion
πῆμα	suffering, misery, calamity, woe, bane
πημαίνω	to bring into misery, plunge into ruin, undo
Πηνειός	
πηοσύνη	
πηρός	disabled in a limb, maimed
πῆρος	
Πηρώ	
πήχυιος	
πηχύνουσα	
πῆχυς	the fore-arm
πῖαρ	fat
πῖδαξ	a spring, fountain
πιέζω	to press, squeeze, press tight
πίειρα	fat, rich
Πιερία	Pieria
Πιερίδες	the Pierides
Πιερίηθεν	from Pieria
Πιερίς	
πικρός	pointed, sharp, keen
πιλέω	to compress wool
πιλνάω	to bring near
Πίμπλεια	
πίμπλημι	to fill full of
πίμπρημι	to burn, burn up
πινόεις	
πῖνον	
πίνος	dirt, filth
πινυτή	understanding, wisdom
πινυτός	wise, prudent, discreet, understanding
πίνω	to drink
πίπτω	to fall, fall down
πῖσος	meadows
πίσυνος	trusting on, relying or depending on, confiding in
Πιτύεια	
πιφαύσκω	to make manifest, declare, tell of
πίων	fat, plump
Πλαγκταί	
πλαγκτός	wandering, roaming
πλαδαρός	wet, damp
πλαδόωσαν	
πλάζω	to make to wander or roam
πλατάγην	
πλαταμών	a flat stone
πλατάνιστος	
πλατύς	wide, broad
Πλειάδες	the Pleiads
πλεῖστος	most, largest
Πλεῖστος	
πλείων	more, larger
πλέκω	to plait, twine, twist, weave, braid
πλέος	full.
πλευρά	a rib
πλευρόν	a rib
πλέω	to sail, go by sea
πλέως	full of
πληγάς	
πληθύς	fulness, a throng, a crowd
πλήθω	to be or become full of
πληιάδες	
πλημμυρίς	a rise of the sea
πλήμμυρον	
πλήμνη	the nave of a wheel
πλήσσω	to strike, smite
πλόκαμος	a lock or braid of hair
πλόκος	a lock of hair, a braid, curl
πλόος	a sailing, voyage
πλοχμός	locks, braids of hair
πλυμμυρίσκαι	
πλωίς	
πλωτός	floating
πνέω	to blow
πνοή	a blowing, blast, breeze
πόα	grass, herb
ποδηνεκής	reaching to the feet
ποδίς	
ποδωκηέστατον	
ποθή	fond desire for
πόθι	where?
ποθι	anywhere or somewhere
πόθος	a longing, yearning, fond desire or regret
ποιέω	to make
ποιήεις	grassy, rich in grass
ποικίλος	many-coloured, spotted, mottled, pied, dappled
ποιμαίνω	to be shepherd
ποιμήν	
ποίμνη	a flock
ποίμνηθεν	
ποινή	quit-money for blood spilt
ποῖος	of what nature? of what sort?
ποιπνύω	to be out of breath
πολεμήιος	warlike
πολεμίζω	to wage war, make war, fight
πόλεμόνδε	to the war, into the fight
πόλεμος	battle, fight, war
πολεμόω	to make hostile, make an enemy of
πολέω	to go about, range over
πολιά	grayness of hair
πολίζω	to build a city, to build
πολιήοχος	
πολιῆτις	
πόλινδε	into or to the city
πόλιον	
πολιός	gray, grizzled, grisly
πολιοῦχος	protecting a city
πόλις	a city
πολισσοῦχος	dwelling in the city
πολίτης	a member of a city or state
πολλάκις	many times, often, oft
πόλος	a pivot, hinge, axis
πολυβενθής	very deep
πολυδάκρυος	
Πολυδεύκης	Pollux
πολυηχής	many-toned
πολυθαρσής	much-confident
πολυκερδής	very crafty or wily
πολυκηδής	full of care, grievous
πολυκλαὕτους	
πολύκλυστος	much-dashing
πολύκμητος	much-wrought, wrought with much toil
πολύκνισος	
πολυλήιος	with many cornfields
πολύμητις	of many counsels
Πολυξώ	
πολυπήμων	causing manifold woe, baneful
πολυπῖδαξ	with many springs, many-fountained
πολυπότνια	
πολύπρεμνος	
πολύρρηνος	rich in sheep
πολύρρινος	
πολύς	many
πολύσκιος	
πολύστονος	much-sighing, mournful
πολύτροπος	much-turned
πολυφάρμακος	knowing many drugs or charms
Πολύφημος	
πολυφράδμων	
πομπεύς	one who attends or escorts, a conductor, guide
πομπή	conduct, escort, guidance
πονέω	to work hard, do work, suffer toil
πόνος	work
ποντίζω	to plunge in the sea
πόντιος	of the sea
πόντονδε	into the sea
Πόντος	
πόντος	the sea
πόποι	oh strange! oh shame!
πορθμός	a ferry or a place crossed by a ferry, a strait, firth
πόρfιν	
πόρος	a means of passing a river, a ford, ferry
πορσύνω	to offer, present
πορφύρεος	darkgleaming, dark;
πορφύρω	gleams darkly
πόρω	to furnish, offer, present, give
Ποσειδεών	
Ποσιδήιον	
Ποσιδήιος	sacred to Poseidon
πόσις	
ποταμηίδες	
ποταμόνδε	to or towards a river
ποταμός	a river, stream
ποτάομαι	to fly about
ποτέ	at some time or other, at some time
ποτή	flight
ποτής	a drinking, drink
ποτητός	flying, winged
ποτιδόρπιος	of or serving for supper
ποτιπτύσσω	
πότμος	that which befals one, one's lot, destiny
πότνα	
ποτόν	
ποτός	drunk, fit for drinking
ποῦ	where?
πού	anywhere, somewhere
πούς	a foot
πρᾶος	Mild, soft, gentle, meek
πραπίδες	the midriff, diaphragm
πράσσω	to pass over
πραύνω	to make soft, mild or gentle, to soften, soothe, calm
πρέμνον	the bottom of the trunk of a tree, the stump
πρέμνος	
πρέσβειρα	
πρέσβυς	an old man
πρήθω	to blow up, swell out by blowing
πρηνής	with the face downwards, head-foremost
πρηστήρ	a hurricane
πρίν	comparative
Πριόλαο	
πρίω	to saw
πρό	before
προαλής	springing forward
προβαθής	
προβαίνω	to step on, step forward, advance
προβάλλω	to throw before, throw or toss to
προβλής	forestretching, jutting
προβλῆτις	
προβλώσκω	to go or come forth, to go out of the house
προγενής	born before, primaeval
προγίγνομαι	to come forwards
προδαῆναι	to know beforehand
πρόδομον	
πρόδομος	
προεῖδον	to see beforehand, catch sight of
προέχω	to hold before
προηγήτειρα	
προθέω	
πρό-θρῴσκω	
προιάλλω	to send forth, dismiss
προίημι	to send before, send on or forward
προίσχω	to hold before, hold out
Προῖτος	
πρόκα	forthwith, straightway, suddenly
προκυλίνδομαι	to roll forward
προλείπω	to go forth and leave, to leave behind, forsake, abandon
πρόμαλος	willow
Προμέα	
πρό-μεθίημι	
Προμήθειος	Promethean
Προμηθεύς	Prometheus
προμηθής	forethinking, provident, cautious
προμολή	an approach
πρόμος	the foremost man
πρό-νέομαι	
πρό-νέω	
πρόξ	the roe-deer
πρόπαρ	before, in front of
προπάροιθε	before, in front of
πρόπας	all
πρόπολος	employing oneself before
Προποντίς	the fore-sea
πρό-προβιάζομαι	
προπροκαταίγδην	
προρέω	to flow forward, flow amain
πρός	motion from
προσβάλλω	to strike or dash against
προσδέχομαι	to receive favourably, accept
πρόσειμι	
προσεῖπον	to speak to
προσεννέπω	to address, accost
προσέχω	to hold to, offer
πρόσθεν	before
προσίσχω	
προσκηδής	bringing into alliance or kindred
προσλέγομαι	to lie beside
προσμυθέομαι	to address, accost
προσρέω	to flow towards a point, to stream in, assemble
προσφύω	to make to grow to
προσφωνέω	to call or speak to, address, accost
πρόσω	forwards, onwards, further
προτέμνω	to cut up beforehand
προτενής	
προτερέω	to be before, be in advance
προτερηγενής	
πρότερος	prae.
προτέρω	further, forwards
προτέρωσε	toward the front, forward
προτιόσσομαι	to look at or upon
πρότονοι	ropes from the masthead to the forepart of a ship, the forestays
προτύπτω	to press forwards
προύθεσαν	
πρό-ὑφαίνω	
προφαίνω	to bring forth, bring to light, shew forth, manifest, display
πρόφασις	that which is alleged as the cause, an allegation, plea
προφερής	carried before, placed before, excelling
προφέρω	to bring before
προφεύγω	to flee forwards, flee away
προφθάνω	to outrun, anticipate
προφράζω	to foretell
πρόφρων	with forward mind
προχέω	to pour forth or forward
πρόχνυ	with the knees forward
προχόη	
προχοή	the outpouring
πρόχυσις	a pouring out
προχύται	
προχύτης	an urn
πρύμνα	the hindmost part of a ship, the stern, poop
πρυμναῖος	of a ship-stern
πρύμνηθεν	from the stern
πρυμνήσιος	of or from a ship's stern
πρυμνόθεν	from the bottom
πρωθήβης	in the prime of youth
πρῷρα	the forepart of a ship, a ship's head, prow, bow
πρώτιστος	the very first, first of the first
πρῶτος	
πρωτοφυής	
πτελέα	the elm
πτερόεις	feathered, winged
πτερόεν	
πτερόν	feathers
πτέρυξ	the wing
πτοέω	to terrify, scare
πτολίεθρον	
πτόρθος	a young branch, shoot, sucker, sapling
πτύξ	a fold, leaf, plate
πτύω	to spit out or up
πυγμαχέω	to practise boxing, be a boxer
πυγμαχία	boxing
πυθμήν	the hollow bottom or stand of a cup
Πυθοῖ	at Pytho or Delphi
Πυθώ	Pytho
πύθω	to make rot, to rot
Πυθώδε	to Pytho
πύκα	
πυκινός	
πυκνός	close, compact
πυλαωρός	keeping the gate, a gate-keeper
πύλη	one wing of a pair of double gates
Πύλος	Pylos
πύματος	hindmost, last
πυνθάνομαι	to learn by hearsay or by inquiry
πῦρ	fire
πύργος	a tower
πυργόω	to gird or fence with towers
πυρεῖον	pieces of wood
πυριθαλπής	heated in the fire
πυρκαιά	any place where fire is kindled, a funeral pyre
πυρκαιός	
πυρόεις	fiery
πυρός	wheat
πυρόσ'	
πυροφόρος	wheat-bearing
πυρρός	flame-coloured, yellowish-red
πυρσός	a firebrand, torch
πω	up to this time, yet
πῶς	how? in what way or manner?
πως	in any way, at all, by any means
πωτάομαι	to fly about
πῶυ	a flock
ῥ̓	
ῥ'	
ῥαδινός	slender, taper
ῥᾴδιος	easy, ready, easy to make or do
ῥαίζω	to grow easier, find relief, recover from illness
ῥαίνω	to sprinkle, besprinkle
ῥαιστήρ	a hammer
ῥαιστήριος	
ῥαίω	to break, shiver, shatter, wreck
ῥαφή	a seam
ργώ	
Ῥέα	Rhea
ῥέα	easily, lightly
ῥέζω	to do, act, deal
ῥέθος	a limb
ῥεῖα	easily, lightly
ῥεῖθρον	that which flows, a river, stream
ῥέον	
ῥέος	a stream
ῥέπω	to incline downwards, to sink, fall
ῥέω	to flow, run, stream, gush
Ῥηβαίου	
Ῥήβαν	
ῥηγμίν	the sea breaking on the beach, the line of breakers, surf
ῥήγνυμι	to break, break asunder or in pieces, rend, shiver, shatter
ῥῄδιος	
ῥηκτός	that can be broken or rent, penetrable
ῥήν	
ῥιγεδανός	making one shudder with cold, chilling
ῥιγέω	to shiver or shudder with cold
ῥίγιον	more frosty, colder
ῥίγιστος	coldest: most horrible
ῥίζα	a root
ῥίζηθεν	
ῥιζόω	to make to strike root
ῥικνός	shrivelled with cold
ῥίμφα	lightly, swiftly, fleetly
ῥινός	the skin
ῥίον	any jutting part
Ῥιπαῖος	
ῥιπή	the swing or force with which anything is thrown
ῥίπτω	to throw, cast, hurl
ῥίς	the nose
ῥόα	a pomegranate-tree
ῥοάς	
ῥοδανός	waving, flickering
ῥόδεος	of roses
ῥοδῆ	a rose-tree, rose-bush
ῥοή	a river, stream, flood
ῥοθέω	to make a rushing noise, to dash
ῥόθιος	rushing, roaring, dashing
ῥοιζέω	to whistle
ῥοῖζος	the whistling or whizzing
Ῥοιτειάδος	
ῥόμβος	a spinning-top or wheel
ῥόον	
ῥόος	a stream, flow, current
ῥόπαλον	a club, cudgel
ρότοιο	
ῥοχθέω	to dash with a roaring sound
ῥυμβόνας	
Ῥυνδακίδας	
ῥύομαι	to draw to oneself
ῥύσιον	that which is dragged away
ῥύσιος	delivering, saving
ῥύσις	a flowing, flow
ῥῦσις	
ῥυτήρ	one who draws or stretches
ῥωγάς	ragged
ῥώννυμι	to strengthen, make strong and mighty
ῥώομαι	to move with speed or violence, to dart, rush, rush on
ῥωχμός	a cleft
Σαγγάριος	
σαίνω	to wag the tail, fawn
σάκας	
σάκκος	a coarse hair-cloth, sackcloth
σάκος	a shield
Σαλαγγῶνος	
Σαλμωνίδος	
σάλος	any unsteady, tossing motion
σανίς	a board, plank
Σάπειρας	
Σάπειρες	
σαρδόνιον	the rope sustaining the upper-edge of a hunting-net
σαρδόνιος	
Σαρδώ	Sardinia
σαρκάω	
σαρκίς	
σάρξ	flesh
Σαρπηδονίη	
Σαρπηδόνιος	
Σαυρομάτης	a Sarmatian
σβέννυμι	to quench, put out
σέγε	
σεῖος	
σειρά	a cord, rope, string, band
Σειρήν	a Siren
σείριος	the scorcher
σείω	to shake, move to and fro
σέλας	a bright flame, blaze, light
σεληναίη	
σεληναῖος	lighted by the moon
σέλμα	the deck of a ship
Σερβωνίδος	
σεύω	to put in quick motion: to drive, hunt, chase away
σηκός	a pen, fold
σηκόω	to weigh, balance
σῆμα	a sign, mark, token
σημαίνω	to shew by a sign, indicate, make known, point out
σημαντήρ	
σημάντωρ	one who gives a signal, a leader, commander
Σηπιάς	
Σηπιής	
σής	a moth
σήσαμον	the seed or fruit of the sesame-plant
Σήσαμος	
σθεναρός	strong, mighty
Σθένελος	
σθένος	strength, might
σθένω	to have strength or might, be strong or mighty
σῖγα	silently
σιγάζω	to bid
σιγαλόεις	glossy, glittering, shining, splendid
σιγάω	to be silent or still, to keep silence
σιγή	silence
σῖγος	
Σίγυννοι	
σιγύννους	
σιδηρεία	a working in iron
σιδηρεῖα	iron-works, iron-mines
σιδήρειος	
σιδήρεος	made of iron or steel, iron
σιδηροφόρος	bearing arms or tools
Σίκινον	
Σικίνου	
σιμβλήιος	of or from the hive
σίμβλος	a beehive
Σίνδος	
σίνομαι	to do
Σιντηίδα	
Σινώπη	Sinope
σῖτος	corn, grain
Σιφαέα	
σιφλός	crippled, maimed
σκαιός	side
σκαίρω	to skip, frisk
σκαλμός	the pin or thole
σκάπτω	to dig, delve
σκαρθμός	
σκέπτομαι	to look about, look carefully
σκῆπτρον	a staff or stick to lean upon, a walking-stick
σκήπτω	to prop, stay
σκηρίπτομαι	to support oneself
σκιάζω	to overshadow, shade
Σκίαθος	
σκιάω	to overshadow
σκιερός	shady, giving shade
σκιόειν	
σκιόεις	shady, shadowy
σκλῆναι	
σκληρός	hard
σκολιός	curved, winding, twisted, tangled
σκόπελον	
σκόπελος	a look-out place, a peak, headland or promontory
σκοπιά	a lookout-place, a mountain-peak
σκοπιάζω	to look about one, spy from a high place or watchtower
σκοτία	darkness, gloom
σκότιος	dark
σκοτόεις	dark
Σκύθης	a Scythian
Σκύλλα	Scylla
σμαραγέω	to crash
σμερδαλέος	terrible to look on, fearful, aweful, direful
σμῆνος	a beehive
σμυγερός	with pain, painful
σμύχω	to burn in a mouldering fire
σοίγ'	
σοίγε	
σόλος	a mass or lump of iron
σόος	
σός	thy, thine, of thee
σοωναύτης	
σπαίρω	to gasp
Σπάρτη	Sparta
Σπάρτηθεν	from Sparta
σπάω	to draw
σπεῖρα	coiled
σπειράομαι	to be coiled or folded round.
σπείρω	to sow
σπέος	a cave, cavern, grotto
σπέρχω	to set in rapid motion
σπήλυγγες	
σπιλάς	a rock over which the sea dashes, a ledge of rock
σπινθάρυξ	
σπλάγχνον	the inward parts
σποράς	scattered, dispersed
σπόρος	a sowing
στάγες	
σταδίη	
στάδιον	a stade, =
στάδιος	standing firm
στάζω	to drop, let fall or shed drop by drop
σταθερός	standing fast, steadfast
σταθμάω	to measure by rule
στάθμη	a carpenter's line
σταθμόν	
σταθμός	a standing place
σταθμόω	to form an estimate, to judge or conclude by or from
σταλάω	to drop, let fall
στάχυς	an ear of corn
στείβω	to tread on, tread under foot
στείνω	to straiten
στεῖρα	
στείχω	to walk, march, go or come
στελεά	
στέλλω	to set in order, to arrange, array, equip, make ready
στενάχω	to sigh, groan, wail
στενός	narrow, strait
στένος	
στένω	to moan, sigh, groan
στενωπός	narrow-looking, narrow, strait, confined
στέρνον	the breast, chest
στεροπή	a flash of lightning
στέρφος	
στεῦμαι	to make as if one would, to promise or threaten that one will
στεφάνη	anything that encircles
στέφανος	that which surrounds
στεφανόω	to be put round
στέφω	to put round
στῆθος	the breast
στήλη	a block of stone
στηρίζω	to make fast, prop, fix, set
στία	
στιβαρός	compact, strong, stout, sturdy
στίβος	a trodden way, track, path
στίζω	to mark with a pointed instrument, to tattoo
στίξ	a row, line, rank or file
στιχάομαι	to march in rows or ranks
στίχη	
στοιχάς	in rows:—
στοιχηδόν	
στόλος	an equipment
στόμα	the mouth
στὅματος	
στοναχή	a groaning, wailing
στονόεις	causing groans or sighs
στόνυξ	any sharp point
στόρεννυμι	
στράπτω	to lighten
στρατάω%	
στρατός	an encamped army
στρατόω	to lead to war;
στρεύγομαι	to be squeezed out in drops
στρέφω	to turn about or aside, turn
στρηνής	strong, hard, rough, harsh
Στροφάδες	
στροφάλιγξ	a whirl, eddy
στροφάς	turning round
στρωφάω	to turn constantly
στυγερός	hated, abominated, loathed
στυγέω	
στύγος	hatred
Στυμφαλίς	
Στύξ	the Styx
στύπος	
στυφελίζω	to strike hard, smite
στυφελός	hard, rough
σύ	
συγκρίνω	to compound
συμβαίνω	to stand with the feet together
συμβάλλω	to throw together, dash together
συμμήστωρ	
συμμιγής	commingled, promiscuous
σύμπας	all together, all at once, all in a body
συμφέρω	to bring together, gather, collect
συμφορέω	to bring together, to gather, collect, heap up
συμφράζομαι	to join in considering, to take counsel with
συμφράσσω	to press or pack closely together
σύν	along with, in company with, together with
συναγείρω	to gather together, assemble
συναινέω	to join in praising
σύν-ἀίσσω	
σύν-ἀμάω	
συνάμφω	both together
σύν-ἁνδάνω	
σύν-ἀνέρχομαι	
συναντάω	to meet face to face
συναραρίσκω	to join together.
συναράσσω	to dash together, dash in pieces, shiver, shatter
συναρέσκω	to please or satisfy together
συναρέσσαμεν	
σύν-ἀρθμέω	
σύν-ἀρτύνω	
συνδέομαι	to join in begging
συνδέω	to bind or tie together
σύνδρομος	running together, meeting
σύν-ἑδριάω	
σύνειμι	
συνέπομαι	to follow along with, follow closely
συνέριθος	a helpmate
συνέστιος	sharing one's hearth or house, a fellow-lodger, guest
συνεχής	holding together
συνηβολίη	
συνημοσύνη	agreements, covenants, solemn promises
συνήμων	united.
συνθεσία	a covenant, treaty
συνίημι	to bring or set together
σύν-κτερείζω	
συνναίω	to dwell with
σύννομος	feeding together, gregarious
συνοίμιον	
συνοίμιος	
συνοπηδός	
συνορίνω	to rouse or stir up together
σύν-ὀρούω	
συνοχέομαι	to travel together in a chariot
συνοχή	a being held together
σύν-τεκταίνομαι	
συνωθέω	to force together, compress forcibly
σύριγ	
σύριγξ	
σὖρον	
Σύρτις	the Syrtis
σφάζω	to slay, slaughter
σφαῖρα	a ball, playing-ball
σφάλλω	to make to fall, throw down, overthrow
σφεῖς	they
σφέλαϊ	
σφέτερος	their own, their
σφήν	a wedge
Σφόδριν	
σφός	their, their own, belonging to them
σφριγάω	to be full to bursting
σφῦρα	a hammer
σφυρόν	the ankle
σφωίτερος	of you two
σχεδόθεν	from nigh at hand, nigh at hand, near
σχεδόν	close, near, hard by, nigh
σχέθω%	
σχέτλιος	unwearying
σχίζα	a piece of wood cleft off, a lath, splinter
σχίζω	to split, cleave
σώζω	to save, keep
σῶς	safe and sound, alive and well, in good case
σώω	
τάγε	
ταίγε	
Ταινάριος	
Ταίναρον	
Ταίναρος	Taenarus
ταλαεργός	enduring labour, drudging
Ταλαός	
ταλασήια	
Τάλος	
Τάλως	
ταναός	stretched, outstretched, tall, long, taper
τάντεσσι	
τανύω	to stretch, strain, stretch out
ταράσσω	to stir, stir up, trouble
ταρβέω	to be frightened, alarmed, terrified
τάρβος	fright, alarm, terror
ταρσός	a stand or frame of wicker-work, a crate
τάρφος	a thicket
ταρφύς	thick, close
ταρχύω	to bury solemnly
τάσγε	
τάσσω	to arrange, put in order
ταῦρος	a bull
ταφήιος	of or for a burial
Τάφιοι	
Τάφιος	
τάφος	
τάχα	quickly, presently, forthwith
ταχινός	
τάχιστος	
τάχος	swiftness, speed, fleetness, velocity
ταχύς	quick, swift, fleet
τε	and
τέγγω	to wet, moisten
Τεγέα	Tegea
τέγεος	at or near the roof
τέγη	
τέγος	a roof
τέθηπα	to be astonished, astounded, amazed
τεθνειῶτα	
τείνω	
τεῖρος	the heavenly constellations, signs
τείρω	to rub hard
τείως	
τεκμαίρομαι	to fix by a mark or boundary, to ordain, decree
τέκμαρ	a fixed mark or boundary, goal, end
τέκνον	that which is borne or born, a child
τέκος	the young
τεκταίνομαι	to make, work, frame
τελαμών	a broad strap for bearing
Τελαμών	
τελέθω	to come into being, to be quite or fully
τελεσφορία	
τελεσφόρος	bringing to an end
τελέω	to complete, fulfil, accomplish
Τελέων	
τέλλω	to make to arise, accomplish
τέλος	the fulfilment or completion
τέλσον	a boundary, limit
τέμενος	a piece of land cut off, assigned as a domain
τέμνω	to cut, hew
τέναγος	shoal-water, a shoal, shallow, lagoon
τεναγώδης	covered with shoal-water, standing in pools
τένων	any tight-stretched band, a sinew, tendon
τέος	
τεός	
τέρας	a sign, wonder, marvel
τέρην	rubbed smooth
τέρμα	an end, boundary
τέρος	
τερπνός	delightsome, delightful, pleasant, agreeable, glad
τέρπω	to satisfy, delight, gladden, cheer
τερπωλή	
τερσαίνω	to dry up, wipe up
τέρσομαι	to be or become dry, to dry up
Τερψιχόρη	Terpsichore, dance-enjoying
τερψίχορος	enjoying the dance
τεσσαράκοντα	forty
τέσσαρες	four
τέταρτος	fourth
τετίημαι	to be sorrowful, to sorrow, mourn
τετμηότι	
τέτμον	to overtake, reach, come up to, find
τετράγυος	containing four measures of land
τετράκις	four times
τέτρατος	fourth
τετραφάληρος	with four crests or plumes
τετράφαλος	
τευχηστήρ	an armed man, warrior
τευχηστής	
τεῦχος	a tool, implement
τεύχω	to make ready, make, build, work
τεχνάομαι	to make by art, to execute skilfully
τεχνήεις	cunningly wrought
τέως	so long, meanwhile, the while
τῇ	here, there
τῃ	
τῇδε	here, thus
Τηθύς	Tethys
τηκεδών	a melting away: a wasting away, consumption, decline
τήκω	to melt, melt down
τῆλε	at a distance, far off, far away
τηλεβόας	
Τηλεβόης	
τηλεθάω	luxuriant-growing, blooming, flourishing
Τηλεκλέης	
τηλεκλείτην	
τήλη	
τηλόθεν	from afar, from a foreign land
τηλόθι	
τηλόσε	to a distance, far away
τηλοῦ	afar, far off or away, in a far country
τηλουρός	with distant boundaries;
τηλύγετος	an only child, a darling child
τῆμος	then, thereupon
τήνγ'	
τήνγε	
τηνίκα	at that time, then;
Τῆνος	
τῆσγε	
τηύσιος	idle, vain, undertaken to no purpose
Τιβαρηνίδα	
Τιβαρηνοί	
τίη	why? wherefore?
τίθημι	to set, put, place
τιθήνη	a nurse
τίκτω	to bring into the world
τίλλω	to pluck or pull out
τιμάω	to pay honour to, hold in honour, to honour, revere, reverence
τιμή	that which is paid in token of worth or value
τιμήεις	honoured, esteemed
τιμήορος	
τινάσσω	to shake or brandish
τίνω	to pay a price
τίπτε	
τις	any one, any thing, some one, some thing;
τίς	who? which?
Τισαίην	
τίσις	payment by way of return or recompense, retribution, vengeance
τιταίνω	to stretch
Τιτάν	the Titans
Τιτανίς	
Τιταρήσιος	
Τιτίην	
Τιτυός	Tityus
τιτύσκομαι	to make, make ready, prepare
τῖφος	standing water, a pond, pool, marsh
Τίφυς	
τίω	to pay honour to
τλάω	to take upon oneself, to bear, suffer, undergo
τλητός	suffering, enduring, patient, steadfast
τμήγω	to cut, cleave
τόγ'	
τόγε	
τόθεν	hence, thence
τόθι	there, in that place
τοι	let me tell you, surely, verily
τοίγ'	
τοίγε	
τοῖος	quality, such, such-like
τοιόσδε	such a
τοί̔σιν	
τοῖχος	the wall of a house or court
τοκεύς	one who begets, a father
τόκος	a bringing forth, childbirth, parturition
τόνγ'	
τόνγε	
τόξον	a bow
τόσος	so great, so vast
τοσσάτιος	so great, much
τότ	
τότε	at that time, then
τούνεκ'	
τούνεκα	
τούνεκεν	
τούσγ'	
τούσγε	
τόφρα	up to or during that time, so long
τράπεζα	four-legged a table
τράπεθ̓	
τραῦμα	a wound, hurt
τραφερός	well-fed
Τραχίς	Trachis
τραχύνω	to make rough, rugged, uneven
τραχύς	rugged, rough
τρεῖς	
τρέμω	to tremble or fear to
τρέπω	to turn or direct
τρέφω	to thicken or congeal
τρέχω	to run
τρέω	to flee from fear, flee away
τρηρών	
τρήρων	timorous, shy
τρητός	perforated, with a hole in it
τρηχύνω	
τρία	
τρίβω	to rub: to rub or thresh
τριγλώχιν	
Τρίκκαιος	
Τρινάκριος	
τρίπους	three-footed, of or with three feet
τρίς	thrice, three times
τρισσός	threefold
τρίτατος	
τρίτος	the third
Τρίτων	Triton
Τριτωνίς	Tritonis
τρομερός	trembling
τρομέω	to tremble, quake, quiver
τρόμος	a trembling, quaking, quivering
τρόπιδι	
τρόπις	a ship's keel
τροφός	a feeder, rearer, nurse
τρυφάλεια	a helmet
τρύφος	that which is broken off, a piece, morsel, lump
τρύχω	to wear out, waste, consume
τρύω	to rub down, wear out
τρωχάω	to run fast, gallop
τυγχάνω	to hit
τυκτός	created
τύμβος	a sepulchral mound, cairn, barrow
Τυνδάρεος	Tyndareos or Tyndarus
Τυνδαρίδαιδη	
τύνω	
τύπανον	a drum
τύπανος	
τυπή	a blow, wound
τυπίς	
τύπτω	to beat, strike, smite
Τυρσηνίς	
Τυρσηνός	Tyrrhenian, Etruscan
τυτθός	little, small
Τυφαονίη	
τύφω	to raise a smoke
Τυφωεύς	Typhoeus or Typhos
Τυφῶν	Typhon
τῷ	therefore, in this wise, thereupon
τώγ'	
τώγε	
τῷγε	
τώς	so, in this wise
Ὑάκινθος	Hyacinthus
ὑάκινθος	the hyacinth
Ὑαντίου	
ὕβρις	wantonness, wanton violence or insolence
ὑβριστής	a violent, overbearing person, a wanton, insolent man
ὑγρός	wet, moist, running, fluid
ὑδέονται	
ὕδρα	a hydra, water-serpent
ὑδρεία	a drawing water, fetching water
ὕδωρ	water
ὑετός	rain
υἱέε	
υἱός	A son
Υιτυοῖο	
υἱωνός	a grandson
fύκτα	
ὑλακή	a barking, howling
ὑλάω	to howl, bark, bay
Ὕλη	
ὕλη	forest-trees
ὑλήεις	woody, wooded
ὑληουργός	
ὑλήωροι	
ὗλις	
Ὑλλῆες	
Ὑλληίδα	
Ὑλληίδος	
Ὑλλήων	
Ὑλλικός	
Ὕλλος	
ὕλλος	
ὑλοτόμος	cutting or felling wood
ὑμέναιος	hymenaeus, the wedding or bridal song
ὑμέτερος	your, yours
ὑμήν	
ὔμμος	
ὕμνος	a hymn, festive song or ode, in praise
ὑμός	your
ὕπαιθα	out under, slipping away
ὑπακουός	
ὑπακούω	to listen, hearken, give ear
ὑπάλυξις	a shunning, escape
ὑπαλύσκω	to avoid, shun, flee from, escape
ὑπάτη	the lowest note
ὕπατος	supremus, the highest, uppermost
ὑπείκω	to retire, withdraw, depart
ὕπειμι	
ὑπείρ	
ὑπέκ	out from under, from beneath, away from
ὑπεκλύω	to loosen or weaken gradually
υπεκπρό	
ὑπεκπροθέω	to run forth from under, outstrip
ὑπεκφέρω	to carry out a little
ὑπένερθε	underneath, beneath
ὑπεξερύω	to draw out from under, draw away underhand
ὑπέρ	over, above, w. gen, over, beyond, w. acc.
ὑπέρ-ἀείδω	
ὑπέρ-αἰδέομαι	
Ὑπερασίου	
ὑπερβασία	a transgression of law, trespass
ὑπέρβιος	of overwhelming strength or might
Ὑπερβόρεοι	the Hyperboreans
Ὑπερβόρεος	
ὑπερέχω	to hold
ὑπερηνορέη	
ὑπερήνωρ	overbearing, overweening
ὕπερθεν	from above
ὑπερίσταμαι	to stand over
ὑπερίσχω	to be above, to prevail over
ὑπεροπληέστατον	
ὑπέροπλος	proudly trusting in force of arms, defiant, presumptuous
ὑπέροχος	prominent, eminent, distinguished above
ὑπέρ-πέλω	
ὑπερπέτομαι	to fly over
ὑπέρ-σχέθω%	
ὑπέρτατος	uppermost, highest, supreme
ὑπέρ-τείνω	
ὑπέρτερος	over or above, upper
ὑπερφίαλος	overbearing, overweening, arrogant
ὑπεύδιον	
ὑπεύδιος	
ὑπέχω	to hold or put under
ὑπηέριος	
ὑπηῷοι	
ὑπισχνέομαι	to promise or engage
ὕπνον	
Ὕπνος	
ὕπνος	sleep, slumber
ὑπνόω	to put to sleep
ὑπό	from under, by, c. gen. under, c. dat., towards c. acc.
ὑπό-αὐγάζω	
ὑποβλήδην	throwing in covertly
ὑποβρύχιος	under water
ὑποδείδω	to cower under or before
ὑποδέχομαι	to receive beneath
ὑποδρήσσων	
ὑποδύομαι	
ὑπό-ἐκχέω	
ὑπό-ἐξαλύσκω	
ὑπό-ἐξαφύω	
ὑποεργός	
ὑπό-ἐρεύγομαι	
ὑποζεύγνυμι	to yoke under, put under the yoke
ὑποθημοσύνη	a suggestion, hint, warning
ὑπό-ἰσχάνω	
ὑπό-ἴσχω	
ὑποκλύζω	to wash from below
ὑποκρίνομαι	to reply, make answer, answer
ὑπόκρισις	a reply, answer
ὑπολάμπω	to shine under, shine in under
ὑπολείπω	to leave remaining
ὑπολύω	to loosen beneath or below
ὑποπρό	
ὑποπτήσσω	to crouch or cower beneath
ὑπό-σαίνω	
ὑπό-σκιάζω	
ὑπό-σκιάω	
ὑπό-σμύχω	
ὑποστρέφω	to turn round about, turn back
ὑποσχεσίη	
ὑπόσχεσις	an undertaking, engagement, promise
ὑπό-τέλλω	
ὑποτίθημι	to place under
ὑπό-τμήγω	
ὑποτρέω	to tremble a little, to shrink back, give ground
ὑποτρομέω	to tremble under
ὑποτροπίη	
ὑποτρόπιος	
ὑπότροπος	returning
ὑποφήτης	a suggester, interpreter, a priest who declares an oracle
ὑποφῆτις	
ὑποφήτωρ	
ὑποφθάνω	to haste before, be or get beforehand
ὑπό-φράζω	
ὑποχάζομαι	to give way gradually or a little
ὑποχθόνιος	under the earth, subterranean
ὑπώρεια	the foot of a mountain, the skirts of a mountain range
ὑπωρόφιος	under the roof, in the house
ὗς	the wild swine
ὑσμίνη	a fight, battle, combat
ὑστάτιος	at last
ὕστατος	
ὕστερον	
ὕστερος	latter, last
ὑφή	a web
ὑφίημι	to let down
ὑφίστημι	to place or set under
ὑψηλός	high, lofty, high-raised
ὕψι	on high, aloft
Ὑψιπύλεια	
Ὑψιπυλείῃ	
Ὑψιπυλείης	
Ὑψιπύλη	
Υψιπύλην	
ὕψιστος	highest, loftiest
ὑψόθεν	from on high, from aloft, from above
ὑψόθι	aloft, on high
ὑψόροφος	high-roofed, high-ceiled
ὑψόσε	aloft, on high, up high
ὑψοῦ	aloft, on high
ὑψόω	to lift high, raise up
ὕω	to send rain, to rain
Φαέθουσα	
φαέθω	to shine
φαεινός	shining, beaming, radiant
φαεσφόρος	light-bringing
Φαίαξ	a Phaeacian
φαιδρός	bright, beaming
φαιδρύνω	to make bright, to cleanse
Φαιηκίδα	
Φαιηκίδας	
Φαιηκίδες	
φαίνω	to bring to light, make to appear
φάλαγξ	a line of battle, battle-array
Φάληρος	
φαντάζομαι	to become visible, appear, shew oneself
φάος	light, daylight
φάραγξ	a cleft or chasm
φαρέτρα	a quiver
φαρμακίς	a sorceress, witch
φάρμακον	a drug, medicine
φάρμακος	
φαρμακόω	to endue with healing power
φαρμάσσω	to treat by using
φάρος	
φᾶρος	a large piece of cloth, a web
φάσγανον	a sword
Φάσις	
Φᾶσις	the river Phasis
φάτης	
φατίζω	to say, speak, report
φάτις	a voice from heaven, the voice of an oracle, an oracle
φάτισἱλατε	
φέβομαι	to be put to flight, flee affrighted
φέγγος	light, splendour, lustre
φέγγω	to make bright
Φεραί	
φέρβω	to feed, nourish
φερέσβιος	life-giving
φέριστος	
Φερσέφασσα	
φέρτατος	bravest, best
φέρω	to bear
φεύγω	to flee, take flight, run away
φεύζω	to cry
φηγός	oak
φηλόω	to cheat, deceive
φημί	to declare, make known
φθάνω	to come or do first or before
φθέγγομαι	to utter a sound or voice
φθία	Phthia
φθιάς	
φθινύθω	to waste, consume
Φθῖος	
φθισίμβροτος	destroying men
φθίω	to decay, wane, dwindle
Φθιῶτις	the land of Phthia
φθογγάζομαι	
φθογγή	
φιλέω	to love, regard with affection
Φιλλυρίδης	
φιλοξενία	hospitality
φιλοπόλεμος	fond of war, warlike
φῖλος	
φίλος	loved, beloved, dear
φιλότης	friendship, love, affection
φίλτατος	
φιλύρα	the lime or linden tree
Φίλυρες	
Φιλύρη	
Φιλυρηίδα	
Φιλύρων	
Φινεύς	
φιτρός	a block of wood, log
φιτρους	
φιτύω	to sow, plant, beget, call into being
φλεγέθω	to burn, scorch, burn up
φλέγος	
Φλεγραῖος	
φλέγω	to burn, burn up
φλιά	the doorposts, jambs
Φλίης	
Φλιουντίδος	
φλογερός	flaming, fiery-red
φλογίον	
Φλογίος	
φλογίς	
φλογμός	flame, blaze
φλόξ	a flame
φοβέω	to put to flight
φόβη	a lock or curl of hair
φόβος	flight
φοιβάω	to cleanse, purify
Φοῖβος	
φοινίκεος	purple-red, purple or crimson
φοῖνιξ	a purple-red, purple or crimson
φοίνιος	of or like blood, blood-red, red
φοινίσσω	to redden, make red
φοιταλέος	roaming wildly about
φοιτάω	to go to and fro, up and down, to stalk
φοίτης	
φοιτίζουσαι	
φολίς	
φονάω	to be athirst for blood, to be murderous
φονεύς	a murderer, slayer, homicide
φονή	slaughter, murder
φόνιος	of blood, bloody
φόνος	murder, homicide, slaughter
φορά	a carrying
φορβάς	giving pasture or food, feeding
φορβή	pasture, food, fodder, forage
φορεύς	a bearer, carrier
φορέω	to bear or carry constantly, to be used to carry
Φόρκυς	Phorcys
φόρμιγξ	the phorminx
φορμίζω	to play the
φόως	light
φραδμοσύνη	understanding, shrewdness, cunning
φράζω	to point out, shew, indicate
φρασσαμενοι	
φράσσασθαιἀπηλεγεως	
φράσσω	to fence in, hedge round
φράτρα	a brotherhood
φρήν	the midriff or muscle which parts
φρῖξος	
Φρίξος	
φρίσσω	to be rough or uneven on the surface, to bristle
φρονέω	to think, to have understanding, to be sage, wise, prudent
φρόντιν	
Φρόντις	
φρουρός	a watcher, guard
φρυγία	
Φρύγιος	Phrygian, of, from Phrygia
φρύγω	to roast or fry
Φρύξ	a Phrygian
φύγαδε	to flight, to flee
φυγή	flight
φύε	
φῦζα	
φύζα	headlong flight, rout
φυή	growth, stature
φυκτός	to be shunned or escaped, avoidable
φυλάζω	to divide into tribes
Φυλάκη	
Φυλακηίδα	
φυλακός	
φυλακτήρ	
φύλαξ	a watcher, guard, sentinel
φυλάσσω	to keep watch and ward, keep guard
φυλλάς	a heap of leaves, bed or litter of leaves
Φυλληίδας	
Φυλληίου	
φύλλον	a leaf;
φυλλοχόος	shedding the leaves.
φῦλον	a race, tribe, class
φύξιον	a place of refuge
φύξιος	
φύξις	
φύος	
φυράω	to mix
φύρω	to mix
φῦσα	a pair of bellows, bellows
φύσας	a father;
φυσάω	to puff or blow up, distend
φυσιάω	to blow, puff, breathe hard, pant
φυσιόω	to puff up
φυταλιά	
φυταλία	a planted place, an orchard or vineyard
φυτοσκάφος	digging round plants
φυτοτρόφον	
φύω	to bring forth, produce, put forth
Φωκεύς	a Phocian
Φῶκος	
φωνέω	to produce a sound or tone
φωνή	a sound, tone
φώρ	a thief
φωριαμός	a chest, trunk, coffer
φώς	a man
Χαδήσιαι	
χάζω	to cause to retire
χαῖον	
χαῖος	
χαίρω	to rejoice, be glad, be delighted
χαίτη	long, flowing hair
χαιτήεις	with long flowing hair
χάλαζα	hail
χαλάω	to slacken, loosen
χαλεπός	hard to bear, painful, sore, grievous
χαλέπτω	to oppress, depress, crush
χαλίκρητος	unmixed
χαλινά	
χαλκεία	smith's work
χαλκεῖον	a smith's shop, forge, smithy
χάλκειος	of copper or bronze, brasen
χάλκεος	of copper or bronze, brasen
χαλκεύς	a worker in copper, a smith
χαλκεύω	to make of copper
χαλκεών	
χαλκέων	a forge, smithy
Χαλκιόπη	
χαλκοβαρής	heavy or loaded with brass
χαλκόπους	brass-hoofed
χαλκός	copper
χαλκοῦς	a copper coin
χαλκόω	to make in bronze
Χαλκωδονίοιο	
Χάλυβος	
Χάλυψ	one of the nation of the Chalybes
χαμάδις	to the ground, on the ground
χαμᾶζε	to the ground, on the ground
χάμευνα	
χαμεύνη	a bed on the ground, pallet-bed
χαμεύνης	
χάος	chaos
χαράδρα	a mountain stream, a torrent, which cuts itself
χαράσσω	to make sharp or pointed, sharpen, whet
χαρίζομαι	to say or do something agreeable
Χάρις	
χάρις	Grace
χάρμα	a source of joy, a joy, delight
χάρμη	the joy of battle, lust of battle
χάρμης	
χαροπός	glad-eyed, bright-eyed
Χάρυβδις	Charybdis
χατέω	to crave, long
χατίζω	to have need of, crave
χεῖλος	a lip
χεῖμα	winter-weather, cold, frost
χείμαρρος	
χειμάρρους	winter-flowing, swollen by rain and melted snow
χειμέριος	wintry, stormy
χείρ	the hand
χειρίς	a covering for the hand, a glove
χειρόω	to bring into hand, to manage, master, subdue
Χείρων	Cheiron
χέραδος	the mud, sand, gravel, and rubbish, silt
χερείων	meaner, inferior
χερμάς	
χερνήσοιο	
χερνῆτις	a woman that spins for daily hire
χέρνιβον	a vessel for water to wash the hands, a basin
χέρνιψ	water for washing the hands
χερόνησος	
χερσόθεν	from dry land
χέρσονδε	to or on dry land
χερσόνησος	a land-island
χέρσος	dry land, land
χεῦμα	that which is poured, a stream
χέω	to pour
χηλή	a horse's hoof
χήρα	bereft of a husband, a widow
χηραμός	a hole, cleft, hollow
χῆρος	
χηροσύνη	
χῆτις	
χῆτος	want, need
χθαμαλός	near the ground, on the ground, flat
χθιζός	of yesterday
χθόνιος	in, under or beneath the earth
χθών	the earth, ground
χιονώδης	like snow, snowy
χιτών	the garment worn next the skin, a frock
χλεύη	a joke, jest
χλοερός	
χλόος	
χλωρός	greenish-yellow
χνοάοντα	
χνοάοντας	
χόανος	a melting-pot
χολάω	to be full of black bile, to be melancholy mad
χόλος	gall, bile
χολόω	to make angry, provoke, anger
χορεία	a dance
χορεῖος	
χορός	a round dance
χόω	to throw or heap up
χραισμέω	to ward off from one
χραύω	to scrape, graze, wound slightly
χράω	
χρειομένῳ	
χρεῖος	needing, being in want of
χρειω	
χρέος	that which one needs must pay, an obligation, debt
χρεώ	want, need;
χρῆ	need, necessity
χρή	it is fated, necessary
χρήεσσι	
χρησμοσύνη	need, want, poverty
χρίμπτω	to bring near
χρίω	to touch on the surface: to rub or anoint with scented unguents
χροιά	the surface of a body, the skin; the body
χροίζω	to touch on the surface;
χρόνος	time
χρυσάορος	with sword of gold
χρυσεῖον	a goldsmith's shop
χρύσεος	golden, of gold, decked or inlaid with gold
χρυσός	gold
χρυσόω	to make golden, gild
χρώς	the surface of the body, the skin
χύσις	a flood, stream
χύτλον	anything that can be poured: water and oil for the bath.
χυτλόω	to wash
χυτός	poured, shed
χώομαι	to be angry, wroth, indignant
χώρα	the space in which a thing is
χῶρος	a piece of ground, ground, place
ψάμαθος	sand, sea-sand
ψαμαθώδης	sandy
ψαύω	to touch
ψάω	to touch lightly, rub
ψεύδω	to cheat by lies, beguile
ψηφίς	a small pebble
ψήχω	to rub down, curry
ψυχή	breath
ψυχορραγέω	to let the soul break loose
ψύχω	to breathe, blow
ὦ	O! oh!
̂Ὠ	
ᾤ	
Ὠγυγία	Ogygia
Ὠγύγιος	Ogygian, of or from Ogyges
ὧδε	in this wise, so, thus
ὠδίνω	to have the pains or throes of childbirth, to be in travail or labour
ὠδίς	the pangs or throes of labour, travail-pains
ᾤζω	
ὠθέω	to thrust, push, shove, force onwards or away
Ὤι	
ὦκα	quickly, swiftly, fast
Ὠκεανίς	
ὠκεανίς	of or from ocean
Ὠκεανός	Oceanus
ὤκιστα	mostly swiftly
ὠκυπέτης	swift-flying, swift-running
ὠκύπους	swift-footed
ὠκύπτερος	swift-winged
ὠκυρόης	
ὠκύς	quick, swift, fleet
ὠκύτης	quickness, swiftness, fleetness, speed
ὠλένιος	
Ὠλένιος	
ὤλξ	a furrow
ὠμηστής	eating raw flesh
ὠμοβόρος	
ὠμοθετέω	to place the raw slices
ὦμος	ulna
ὠμός	raw, undressed
ὦνος	for
ὠπή	
ὥρα	period
Ὥρα	
ὡραῖος	produced at the right season
Ὠρεΐδης	
Ὠρείθυια	
Ὤρικος	
Ὠρίων	Orion
ὠρύομαι	to howl
̂Ὠς	
ὡς	thus, as, so that, since
ὥστε	as, as being
ὠτειλή	a wound
̂Ὠφιλαι	