Field1	Field2
γῆρας	old age
γηρύω	to sing or say, speak, cry
για	
Γίγας	
γίγνομαι	to come into being
γιγνώσκω	to learn to know, to perceive, mark, learn
γλαυκός	gleaming, silvery
γλύκειος	
γλυκύδωρος	with sweet gifts
γλυκύς	sweet
γλῶσσα	the tongue
γνάμπτω	to bend
γνήσιος	of or belonging to the race
γνώμη	a means of knowing, a mark, token
γνῶσις	a judicial inquiry
γοί	
γοιμεν	
γόνος	that which is begotten, offspring, a child
γύαλον	a hollow
γύαλος	
γυιαλκής	
γυῖον	a limb
γυιόω	to lame
γυνή	a woman
Δαϊανείρᾳ	
Δαϊάνειραν	
δαιδάλεος	cunningly or curiously wrought
δαίζω	to cleave asunder, cleave
δαιμονάω	to be under the power of a δαίμων, to suffer by a divine visitation
δαιμόνιον	the Deity
δαιμόνιος	of or belonging to a δαίμων
δαίμων	a god, goddess
Δαϊπύλου	
δαίφρων	battle
δακρυόεις	tearful, much-weeping
δάκρυον	a tear
δακρύω	to weep, shed tears
Δαλογενής	
δαμάζω	to overpower
δάμαλις	a heifer
δαμασίμβροτος	taming mortals, man-slaying
δαμάσιππος	
δαμασίχθων	
Δάματρα	
δαν	
Δαναοί	the Danaans
Δαναός	
δάπεδον	any level surface: the floor of a chamber
δάπτω	to devour
Δαρδανίδης	a son or descendant of Dardanus
Δαρδανίς	a Trojan woman
δάσκιος	thick-shaded, bushy
δάω	to learn
δέ	but
δείδω	to fear
δείκνυμι	to bring to light, display, exhibit
δειλός	cowardly, craven
Δεινομένης	
δεινός	fearful, terrible, dread, dire
δεινόω	to make terrible: to exaggerate
δείρᾳ	
δέκατος	tenth
δελφίς	the dolphin
Δελφοί	the Delphians
δέμας	the frame
Δεξιθέη	
δεξίστρατος	
δέος	fear, alarm, affright
δέρκομαι	to see clearly, see
δέσποινα	the mistress, lady of the house
δεσω	
δεῦρο	hither
δεύτερος	second
δέχομαι	to take, accept, receive
δή	exactness
Δήλιος	Delian
δῆρις	a fight, battle, contest
δἰ	
διά	through c. gen. through, by means of c. acc.
διάγω	to carry over or across
διαδιδράσκω	to run off, get away, escape
διαίσσω	to rush or dart through or across
διακρίνω	to separate one from another
διατρέχω	to run across or over
δίδυμος	double, twofold, twain
δίδωμι	to give
διέπω	to manage
δίζημαι	to seek out, look for
Δίη	
δικαία	
δίκαιος	observant of custom and social rule, well-ordered, civilised
δικαιόω	to set right
δικεῖν	to throw, cast
Δίκη	
δίκη	custom, usage
δίνασεν	
δινήεις	whirling, eddying
δίνηντο	
διό	wherefore, on which account
Διόνυσος	Dionysus
δῖος	god-like, divine
δίς	twice, doubly
δισκόν	
διχόμηνις	
διχοστασία	a standing apart, dissension
διώξιππος	horse-driving
δν	
δνοφέος	
δνόφος	darkness, dusk, gloom
δοίαξε	
δοκεύς	
δοκέω	videor mihi, to think, suppose, imagine, expect
δόλιος	crafty, deceitful, treacherous
δολιχαύχην	
δολιχός	long
δολόεις	subtle, wily
δόλος	a bait
δόμος	a house
δόναξ	a reed
δονέω	to shake
δόξα	a notion
δορά	a skin, hide
δορεύς	
δόρυ	a stem, tree
δόσις	a giving
δουλοσύνη	slavery, slavish work
δουλόσύνη	
δράκων	a dragon
δράω	to do
δρόμος	a course, running, race
δυάω	to plunge in misery
δύη	woe, misery, anguish, pain
δύναμαι	to be able, capable, strong enough
δύναμις	power, might, strength
δύνασις	
δύο	two
δύσλοφος	hard for the neck, hard to bear
δυσμενέων	bearing ill-will, hostile
δυσμενής	full of ill-will, hostile
δύσμορος	ill-fated, ill-starred
δυσπαίπαλος	
δύστηνος	wretched, unhappy, unfortunate, disastrous
δύω	to strip off
δῶμα	a house
δων	
δῶρον	a gift, present
διτηψραμβς	
ἕ	sui.
ἐάν	if haply
ἔαρ	spring
ἐάω	to let, suffer, allow, permit
ἑβδομήκοντα	seventy
ἔγγονος	a grandson, granddaughter
ἐγγυάω	to give or hand over as a pledge
ἐγγύθεν	from nigh at hand
ἐγχέσπαλος	wielding the spear
ἐγχέω	to pour in
ἔγχος	a spear, lance
ἐγώ	ego
ἕδος	a sitting-place
ἔθειρα	hair
ἐθέλω	to will, wish, purpose
ἔθνος	a number of people accustomed to live together, a company, body of men
εἰ	whether.
εἰδοί	Idus
εἶδον	to see, perceive, behold
εἴδωλον	an image, a phantom
εἴκοσι	twenty
εἰλαπίνη	a feast or banquet
εἱμάρθαι	
εἶμι	to go
εἰμί	to be, to exist
εἴπερ	strengthd. for
εἶπον	to speak, say
εἶπος	
εἰρήνη	peace, time of peace
εἴρω	
εἰς	into, to c. acc.
εἷς	
εἰσ-ἀντάω	
εἰσ-εἶδον	
εἴτε	
ἐκ	from out of
ἕκαστος	every, every one, each, each one
fέκατι	
ἐκβάλλω	to throw or cast out of
ἔκγονος	born of, sprung from
ἐκεῖθεν	from that place, thence
ἐκεῖθι	
ἐκεῖνος	the person there, that person or thing
ἕκητι	by means of, by virtue of, by the aid of
ἑκκαιδέκατος	sixteenth
ἐκλήγω	to cease utterly
ἐκλύω	to loose, release, set free, from
ἐκ-νεάω	
ἐκπίμπλημι	to fill up
Ἑκτόρεος	
ἐκτός	outside
Ἕκτωρ	
ἕκτωρ	
ἑκών	willing, of free will, readily
ἐλαία	the olive-tree
ἔλαιον	olive-oil
ἔλαιος	the wild olive
ἐλαύνω	to drive, drive on, set in motion
ἐλαφρός	lightly, buoyantly
ἑλένη	
Ἑλένη	
ἐλεφαντόκωπος	ivory-hilted
ἑλικοστέφανος	
ἔλλαθι	
Ἑλλάς	Hellas
Ἕλλην	Hellen
ἐλπίς	hope, expectation
ἐλύω	to roll round
ἐμβάλλω	to throw in, put in
ἐμέω	to vomit, throw up
ἐμός	mine
ἔμπεδος	in the ground, firm-set, steadfast
ἐμπίπτω	to fall in or upon or into
ἔμπορος	one who goes on shipboard as a passenger
ἐμπρέπω	to be conspicuous in
ἐν	in, among. c. dat.
ἐναντίος	opposite
ἐναρίζω	to strip a slain foe of his arms
Ἐνδαί̈δα	
ἐνδείκνυμι	to mark, point out
ἐνδίδωμι	to give in
ἔνδοθεν	from within
ἐνδυκέως	thoughtfully, carefully, sedulously
ἕνεκα	on account of, for the sake of, because of, for
ἔνθ	
ἔνθα	there
ἔνθεν	on the one side
ἐννέα	nine
ἕννυμι	to put clothes on
ἕνος	belonging to the former of two periods, last year's
ἐνστάζω	to drop in or into
ἐντυγχάνω	to light upon, fall in with, meet with
ενυφαι	
ἕξ	six
ἐξάγω	to lead out
ἐξᾴδω	to sing out, sing one's last song
ἐξαιρέω	to take out of
ἐξαίσιος	beyond what is ordained
ἐξείλλω	to disentangle
ἐξεναρίζω	to strip or spoil
ἐξικνέομαι	to reach, arrive at
ἐξόπιν	
ἔξοχος	standing out
ἑορτή	a feast or festival, holiday
ἐπαίσσω	to rush at or upon
ἐπ'ἀνδήροις	
Ἔπαφος	
ἐπεί	after that, after (postquam), since, when (quum)
ἔπειμι	to be upon
ἔπειτα	thereupon
ἐπί	on, upon with gen., dat., and acc.
ἐπί-ἀθρέω	
ἐπιβαίνω	to go upon
ἐπιγίγνομαι	to be born after, come into being after
ἐπιδείκνυμι	to exhibit as a specimen
ἐπιδέχομαι	to admit besides or in addition
ἐπίζηλος	enviable, happy
ἐπί-ἱστάω	
ἐπικείρω	to cut off, cut down
ἐπικλώθω	to spin to
ἐπικουρέω	to act as an ally
ἐπικουρία	aid, succour
ἐπιλέγω	to choose, pick out, select
ἐπίμοιρος	
ἐπίμοχθος	
ἐπινίκιος	of victory, triumphal
ἐπισείω	to shake at or against
ἐπισκήπτω	to make to lean upon, make to fall upon
ἐπί-στάζω	
ἐπιτίθημι	to lay, put or place upon
ἐπίφρων	thoughtful, sage
ἐπιχθόνιος	upon the earth, earthly
ἐπιχώριος	in or of the country
ἐποιχνέω	
ἕπομαι	
ἑπτά	seven
ἑπτάπυλος	with seven gates
ἑπτάς	
ερ	
ἐραννός	lovely
ἐρατός	lovely, charming
ἐρατώνυμος	
ἔργμα	a work, deed, business
ἔργνυμι	to confine
ἔργον	work
ἔρδω	to do
ἐρείπω	
ἐρειψιπύλαν	
ἐρειψιτοί	
ἐρεμνός	black, swart, dark
ἐρέπτομαι	to feed on
ἐρεύθω	to make red, stain red
ἐρέφω	to cover with a roof
ἐρητύω	to keep back, restrain, check
Ἐρίβοια	
Ἐριβοίας	
ἐριβρύχης	
ἐρίζω	to strive, wrangle, quarrel
ἐρικυδής	very famous, glorious, splendid
ἐρισφάραγος	loud-roaring
ἔρνος	a young sprout, shoot, scion
ἐρύκω	to keep in, hold back, keep in check, curb, restrain
ἔρχομαι	to come or go
ἔρως	love
ἐρωτάω	to ask
ἐσθλός	good
εσσιν	
Ἐστία	
ἔσχατος	outermost
ἔσω	to the interior
ἑταίρα	a companion
ἕτερος	one of the
ἔτης	clansmen
ἔτι	yet, as yet, still
ἔτος	a year
ἔτυμος	true, real, actual
εὖ	well
εὐαίνετος	
εὔανδρος	abounding in good men
Εὔβοια	Euboea
εὔβουλος	well-advised, prudent
εὔγυιος	
εὐδαίδαλος	beautifully wrought
εὐδαιμονία	prosperity, good fortune, wealth, weal, happiness
εὐδαίμων	blessed with a good genius;
εὔδμητος	well-built
εὔδοξος	of good repute, honoured, famous, glorious
εὐεγχής	
εὐειδής	well-shaped, goodly, beautiful, beauteous
εὐεργεσία	well-doing
εὐθαλής	blooming, flourishing
εὐθηλής	well-nurtured, thriving, goodly
εὔθρονος	with beautiful throne
εὔθροος	loud-sounding
εὐθύδικος	righteous-judging
εὐθυμία	cheerfulness, tranquillity
εὔθυνος	a corrector, chastiser, judge
εὐθύνω	to guide straight, direct
εὐθύς	
εὐκλεής	of good report, famous, glorious
εὔκλεια	good repute, glory
εὐκλέϊξας	
εὐκλείου	
ἐυκτίμενος	well-built
ἐύκτιτος	
εὐμαρεῖν	
εὐμαρής	easy, convenient, without trouble
εὔμοιρος	blest with possessions
εὐναής	
εὐνή	a bed
εὐνομία	good order, order
Εὐνομίη	
Εὐξαντίδα	
Εὐξάντιον	
εὔπεπλος	beautifully robed
εὔπηκτος	well-built
εὐπλόκαμος	with goodly locks, fairhaired
εὐποίητος	well-made, well-wrought
εὐπύμνοις	
εὔπυργος	well-towered
εὐρέιος	
εὕρησις	
εὑρίσκω	to find
εὐρυάνακτος	
εὐρυβίας	
εὐρυδίνης	
εὐρυνεφής	
εὐρύς	wide, broad
εῦρυσθενεος	
εὐρύχορος	with broad places, spacious
Εὐρωπιάδας	
ἆ	ah!
α	
Ἀβαντιάδας	
Ἄβας	
ἁβροβάτης	softly or delicately stepping
ἁβρόβιος	living delicately, effeminate
ἁβροπνόων	
Ἀγαθοκλεαδᾶν	
ἀγακλεής	very glorious, famous
ἀγακλειτός	
ἀγάλλω	to make glorious, glorify, exalt
ἄγαλμα	a glory, delight, honour
Ἀγανορίδας	
ἀγαστός	deserving admiration
ἀγατός	
ἀγγελία	a message, tidings, news
ἄγγελος	a messenger, envoy
Ἀγέλαος	
ἀγέλη	a herd
ἀγέρωχος	high-minded, lordly
Ἀγκαῖος	
ἀγλαία	splendour, beauty, adornment
Ἀγλαία	
ἀγλαίζω	to make bright or splendid
ἀγλαόθρονος	
Ἀγλαός	
ἀγλαός	splendid, shining, bright, beautiful
ἄγναμπτος	unbending, inflexible
ἁγνός	full of religious awe
ἄγνυμι	to break, shiver
αγορ	
ἀγορά	an assembly of the people
ἀγρότερος	wild
ἀγυιά	a street, highway
ἀγχίαλος	near the sea
ἀγχίδομος	
ἄγω	to lead or carry, to convey, bring
ἀγών	a number of people brought together, a gathering, assembly
ἄγωνος	
ἀδεισιβόας	
ἀδελφή	a sister
ἀδελφός	sons of the same mother
ᾍδης	Hades or Pluto
ἀδίαντος	unwetted
ἄδικος	wrong-doing, unrighteous, unjust
ἄδματοι	
ἄδμητος	unbroken
Ἄδραστος	
ἄδραστος	not running away, not inclined to do so
ἀεθλάρχων	
ἀεί	always, for ever
ἀείδω	to sing
ἀεικέλιος	
ἀεικής	unseemly, shameful
ἀείρω	to lift, heave, raise up
ἀέκατι	
ἀέκων	against one's will, unwilling
ἀέλιος	
ἀελιου	
ἄελλα	a stormy wind, whirlwind, eddy
ἀελλοδρόμαν	
ἄελπτος	unexpectedly
ἀέξω	to increase, enlarge, foster, strengthen
ἀερσίμαχος	
ἀετός	an eagle
ἄζυγος	unwedded
ἄζυξ	unyoked, unpaired, unmarried
ἀηδών	the songstress
ἀήτη	
ἀήτης	a blast, gale
ἀθαμβής	fearless
Ἀθαναίων	
ἀθάνατος	undying, immortal
ἄθεος	without God, denying the gods
Ἀθῆναι	the city of Athens
Ἀθήναια	
Ἀθήναιον	the temple of Athena
Ἀθήναιος	
Ἀθηναῖος	Athenian, of or from Athens
ἈθηναίῳΔρομεῖ	
Ἀθήνη	Athena
ἀθλέω	having contended with
ἆθλον	the prize of contest
ἆθλος	a contest for a prize
ἄθυρμα	a plaything, toy: a delight, joy
ἄθυρσις	
αἴ	ha!
αἰαῖ	ah!
Αἰακίδης	son of Aeacus
Αἰακός	
Αἴας	Ajax
Αἴγινα	Aegina
αἰγίνη	
ἈιγινήτῃιΠαλαιστῇ	
ΑιγινήτῃΠαγκρατιαστῇΝεμεα	
αἴγινος	
αἴγλη	the light of the sun, radiance
Αἵδης	
ἀιδής	unseen, annihilated
αἰδοῖος	regarded with reverence, august, venerable
αἰθήρ	ether, the brighter purer air, the sky
αἰθος	
αἶθος	a burning heat, fire
Αἴθρη	
αἴθω	to light up, kindle
αἴθων	fiery, burning, blazing
αἷμα	blood
αἰνέω	to tell or speak of
αἰνός	dread, dire, grim
αἴξ	a goat
αἰολόπρυμνος	
αἰόλος	quick-moving
αἰπεινός	high, lofty
αἰπύς	high and steep, lofty
αἱρέω	to take with the hand, grasp
αἴρω	to take up, raise, lift up
Αἶσα	the goddess of destiny
ἀίσσω	to move with a quick shooting motion, to shoot, dart, glance
αἴτιος	to blame, blameworthy, culpable
Αἰτωλίς	
Αἰτωλοί	
Αἰτωλός	
αἰχμητής	a spearman
αἰχμοφόρος	one who trails a pike, a spearman
αἶψα	quick, with speed, on a sudden
αἰών	a period of existence
ἀκαμαντορόαν	
ἀκάματος	without sense of toil
ἀκίνητος	unmoved, motionless
ἀκοίτης	a bedfellow, spouse, husband.
ἄκοιτις	a spouse, wife
ἄκοιτος	
ἀκόλουθος	following, attending on
ἀκούω	to hear
Ἀκρίσιος	
ἄκριτος	undistinguishable, unarranged, disorderly
ἀκτέα	the elder-tree
ἀκτέον	
ἀκτή	a headland, foreland, promontory, shore
ἄκων	a javelin, dart
ἀλαμπής	out of the sun's light
ἄλαστος	not to be forgotten, insufferable, unceasing
ἄλγος	pain
Ἀλεξίδαμον	
Ἀλεχιδάμῳ	
ἀλήθεια	truth
ἀλήτης	a wanderer, stroller, rover, vagabond
ἀλθαία	
Ἀλθαίη	
ἀλιγκία	
ἁλιναιέτης	
Ἅλιος	
ἅλιος	
ἀλκή	strength
ἄλκιμος	strong, stout
Ἀλκμήνιος	
ἀλλά	otherwise, but
ἀλλάσσω	to make other than it is, to change, alter
ἀλλοδαμίαν	
ἀλλοῖος	of another sort or kind, different
ἄλλος	alius, another, one besides
ἀλλότριος	of or belonging to another
ἄλοχος	a bedfellow, spouse, wife
ἅλς	a lump of salt
ἄλσος	a glade or grove
Ἀλυάττης	
ἀλυκτάζω	to be in distress
Ἀλφειός	
Ἀλφεός	
ἅμα	at once, at the same time
ἀμαιμάκετος	irresistible
ἀμαλδύνω	to soften
ἁμαρτάνω	to miss, miss the mark
ἁμαρτέοιτε	
ἀμάρυγμα	a sparkle, twinkle
ἀμαυρόω	to make dim, faint
ἄμαχος	without battle
ἀμβρόσιος	immortal
ἄμβροτος	immortal, divine
ἀμείβω	to change, exchange
ἄμεμπτος	not to be blamed, blameless
ἀμεμφής	
ἀμέρδω	to deprive of, bereave of
ἀμετρόδικος	
ἄμετρος	without measure, immense, excessive, boundless
ἀμήχανος	without means
ἀμίαντος	undefiled
ἁμός	
ἄμπ	
ἀμπελοτρόφος	
ἀμύσσω	to scratch, tear, wound, lacerate, mangle
ἀμφήκης	two-edged
ἀμφί	on both sides
ἄμφι	
ἀμφιβάλλω	to throw or put round
ἀμφικτίονες	they that dwell round, next neighbours
ἀμφικύμων	
Ἀμφιτρίτη	
Ἀμφιτρύων	
Ἀμφιτρυωνιάδαν	
Ἀμφιτρυωνιάδας	
ἀμφότερος	each or both of two
ἀμώμητος	unblamed, blameless
αν	
ἄν	
ἀνά	up, upon
ἀνάγκη	force, constraint, necessity
ἀναδέω	to bind or tie up
ἀνάδημα	
ἀνά-ἐράω	
ἀναιδομάχας	
ἀνά-ἴσχω	
ἀνακαίω	to light up
ἀνακάμπτω	to bend back
ἀνά-καρύσσω	
ἀνακλαίω	to weep aloud, burst into tears
ἀνακομίζω	to carry up
ἀναμιμνήσκω	to remind
fάναξ	
ἄναξ	a lord, master
ἀναξίαλος	
ἀναξιβρόντας	
ἀναξίμολπος	
ἀναξίππου	
ἀναξιφόρμιγξ	ruled by the lyre
ἀναπάλλω	to swing to and fro
ἀνάπαυσις	repose, rest
ἀναπαύω	to make to cease, to stop or hinder from
ἀναπέμπω	to send up
ἀναπτύσσω	to unfold
ἀνατείνω	to stretch up, hold up
ἀνατέλλω	to make to rise up or to grow up
ἀναφαίνω	to make to give light, make to blaze up
ἀνδρίς	
ἀνδροκτόνος	man-slaying, murdering
ἀνδρόω	to rear up into manhood
ἀνδρων	
ἄνεμος	wind
ἀνήρ	a man
ἀνθεμόεις	flowery
ἀνθεμώδης	flowery, blooming
ἀνθέω	to blossom, bloom
ἄνθη	full bloom
ἄνθος	a blossom, flower
ἄνθρωπος	man
ἀνίκητος	unconquered, unconquerable
ἀντάω	to come opposite to, meet face to face, meet with
Ἀντηνορίδης	
ἀντήνωρ	instead of a man
Ἀντήνωρ	
ἀντί	over against, opposite. c. gen.
ἀντίθεος	equal to the gods, godlike
ἀοιδή	song, a singing
ἀολλίζω	to gather together
άοσιν	
ἀπαίτησις	a demanding back
ἀπάρχω	
ἅπας	quite all, the whole
ἄπειρος	
ἀπείρων	
ἀπενθής	free from grief
ἄπιστος	not to be trusted
ἄπλατος	unapproachable, terrible
ἀπό	from, away from. c. gen.
ἀπόκληρος	without lot or share of
ἀπόλλυμι	to destroy utterly, kill, slay
Ἀπόλλων	Apollo
ἀποπλέω	to sail away, sail off
ἀπόρθητος	not sacked, unravaged
ἀποσεύω	to chase away
ἀποτρέπω	to turn
ἀποφθίνω	to perish utterly, die away
ἅπτω	to fasten, bind fast
ἀπωθέω	to thrust away, push back
ἄρα	
ἀργαλέος	painful, troublous, grievous
Ἀργεῖος	of or from Argos, Argive
ἀργής	bright, glancing
ἀργηστής	
ἀργικέραυνος	wielder of bright lightning
Ἄργος	
ἀργυροδίνης	silver-eddying
ἄρειος	devoted to Ares, warlike, martial
ἀρείων	better, stouter, stronger, braver, more excellent
ἀρέταιχμος	
ἀρετάω	to be fit or proper, to thrive, prosper
ἀρετή	goodness, excellence
ἀρηίφιλος	dear to Ares, favoured of the god of war
Ἀρηίφιλος	
Ἄρης	Ares
ἀρίγνωτος	easy to be known
Ἄρις	
ἀρισταλκής	
ἀρίσταρχος	best-ruling
ἀριστόκαρπος	
Ἀριστομένειον	
ἄριστον	the morning meal, breakfast
ἀριστοπάτρα	
ἄριστος	best
Ἀριστοτελει	
Ἀριστοτέλης	
Ἀρκαδία	
Ἀρκαδίη	
ἅρμα	a chariot
ἁρμόζω	to fit together, join
ἄρον	
ἄρος	
ἀρόω	to plough
ἁρπαλέος	greedy
Ἄρτεμις	Artemis
ἀρχαῖος	from the beginning
Ἀρχέμορος	
ἀρχή	a beginning, origin, first cause
ἀρχηγέτης	a first leader, the founder
ἀρχηγός	beginning, originating
ἄρχω	to be first
ας	
ἄσπετος	unspeakable, unutterable, unspeakably great
αστ	
ἀστραπή	a flash of lightning, lightning
ἀστράπτω	to lighten, hurl lightnings
ἄστρον	the stars
ἄστυ	a city, town
ἀστύθεμιν	
ἀσφαλής	not liable to fall, immoveable, steadfast, firm
Ἀσωπός	
ἀτάρβακτος	
ἀταρβομάχας	
ἀτάσθαλος	presumptuous, reckless, arrogant
ἅτε	just as, so as
ἄτερ	without
ἄτη	bewilderment, infatuation, reckless impulse
Ἀτρείδης	
ἀτρέμας	without trembling, without motion
ἀτρόμητος	
ἄτρομος	intrepid, dauntless
ἄτρυτος	not worn away, untiring, unwearied
ἀτύζω	to be distraught from fear, mazed, bewildered
αὐγή	the light of the sun, sunlight
αὐδάζομαι	to cry out, speak
αὐδάω	to utter sounds, speak
αὐδήεις	speaking with human voice
αὐθιγενής	born on the spot, born in the country, native
αὖθις	back, back again
αὐλέω	to play on the flute
αὐλή	the court-yard
αὐλός	a flute
αὐξάνω	to make large, increase, augment
ἄυπνος	sleepless, wakeful
αὔρα	air in motion, a breeze
αὔριον	to-morrow
αὐτ	
αὖτε	again
αὐτίκα	forthwith, straightway, at once
Ἀυτομήδει	
Αὐτομήδει	
αὐτός	self
αὐτοῦ	at the very place, just here, just there
ΑὐτῷἹπποις	
ΑὐτῷΚελητι	
αὐχήν	the neck, throat
Ἀφάρητα	
ἄφατος	not uttered, nameless
ἀφικνέομαι	to come to
ἀφνειός	rich, wealthy
Ἀφροδίτη	Aphrodite
ἀφροσύνη	folly, thoughtlessness, senselessness
Ἀχαία	Achaia
ἀχαιά	
Ἀχαιός	Achaian
ἀχειρής	
ἀχεύω	grieving, sorrowing, mourning
ἀχέω	
Ἀχιλλεύς	Achilles
ἄχος	pain, distress
ἀχρεῖος	useless, unprofitable, good for nothing
ἀωτεύοντα	
β	
βαθυδείελος	
βαθύζωνος	deep-girded
βαθύξυλος	with deep wood
βαθυπλόκαμος	
βαθύπλουτος	exceeding rich
βαθύς	deep or high
βάλλω	to throw
βαρυαχής	heavy with woe
βαρύβρομος	loud-roaring, loud-sounding
βαρυηχής	deep-voiced
βαρυπενθής	causing grievous woe
βαρύς	heavy
βαρύτλατος	
βαρύφθογγος	loud-sounding, roaring
βάσανος	the touch-stone
βασιλεύς	a king, chief
βέλος	a missile
βία	bodily strength, force, power, might
βιάζω	to constrain
βιάω	to constrain
βίος	life
βιοτή	a living, sustenance
βλέπω	to see, have the power of sight
βλέφαρον	mostly in pl. the eyelids
βληχρός	weak, faint, slight
βλώσκω	to go or come
βόα	
βοάω	to cry aloud, to shout
βόειος	of an ox or oxen
βοή	a loud cry, shout
βοηθόος	hasting to the battle-shout, hasting to battle
Βοιωτός	a Boeotian
βορεάς	
Βορέας	the North wind
βόρειος	from the quarter of the North wind, northern
βούθυτος	of or belonging to sacrifices
βουκόλος	a cowherd, herdsman
βουλεύω	to take counsel, deliberate, concert measures
βουλή	will, determination
βοῦς	cow
βοῶπις	ox-eyed
βραχύς	short
βρέχωf	
βρίζω	to be sleepy, to slumber, nod
βρίθω	to be heavy or weighed down with
Βρισηί̈ς	
βροτᾶν	
βροτός	a mortal man
βροτωφελής	
βρύω	to be full to bursting
βωμός	any raised platform, a stand
γαῖα	a land, country
Γαῖα	
γαμβρός	any one connected by marriage
γάμος	a wedding, wedding-feast
γάρ	for
γάρυϊ	
γᾶρυν	
γε	at least, at any rate
γέγωνα	to call out so as to be heard
γελανώσας	
γέμω	to be full
γενεά	race, stock, family
γενέτης	the begetter, father, ancestor
γένος	race, stock, family
γεραίρω	to honour or reward with
γέρας	a gift of honour
γέρων	an old man
γέτας	
γεύω	to give a taste of
γῆ	earth
εὐσέβεια	reverence towards the gods, piety, religion
εὐσεβέω	to live or act piously and religiously
εὐσεβής	righteous
εύσων	
εὖτε	when, at the time when
εὔτυκος	ready
εὔυδρος	well-watered, abounding in water
εὐφεγγής	bright, brilliant
εὐφραίνω	to cheer, delight, gladden
εὐφροσύνη	mirth, merriment
εὐφρόσυνος	in good cheer
εὐχή	a prayer, vow
εὔχομαι	to pray, offer prayers, pay one's vows, make a vow
εὐώδης	sweet-smelling, fragrant
ἐφέζομαι	to sit upon
ἐφημέριος	on, for or during the day, the day through
ἐφήμερος	living but a day, short-lived
ἐφίημι	to send to
ἐφίστημι	to set or place upon
ἔχθιστος	most hated, most hateful
ἐχθρός	hated, hateful
ἔχιδνα	an adder, viper
Ἔχιδνα	
ἔχις	an adder, viper
ἔχω	to have or to hold
ζάθεος	very divine, sacred
ζεύγνυμι	to yoke, put to
Ζεύς	Zeus
Ζέφυρος	Zephyrus, the west wind
ζέω	to boil, seethe
ζωή	a living
ζωός	alive, living
ζώω	
ἦ	in truth, truly, verily, of a surety
ᾗ	which way, where, whither, in or at what place
ἤ	
ἡβάω	to be at man's estate, to be in the prime of youth
ἥβη	manhood, youthful prime, youth
ἠγάθεος	very divine, most holy
ἠδέ	and
ἤδη	by this time, before this, already
ἦδος	delight, enjoyment, pleasure
ἡδυεπής	sweet-speaking
ἡδύς	sweet
Ηίθεοι	
ἠίθεος	a youth just
ἧλιξ	of the same age
ἥλιος	the sun
ἧμαι	to be seated, sit
ἦμαρ	day
ἡμέρα	day
ἥμερος	tame, tamed, reclaimed
ἡμέτερος	our
ἠμί	I say
ἡμίθεος	a half-god, demigod
ἥμισυς	half
ἡμός	
ἤπειρος	terra-firma, the land
ἠπιόφρον	
ἤρα	acceptable gifts, kindnesses
Ἥρα	Hera
Ἡρακλέης	Heracles
ἥρως	warriors
Ἡσίοδος	
ἦτορ	the heart
ἠύ̈δενδρον	
ἠύτε	as, like as
ἠχέω	to sound, ring, peal
ἠχή	a sound or noise
ἠώς	the morning red, daybreak, dawn
θάλασσα	the sea
θάλεια	blooming, luxuriant, goodly, bounteous
θαλέω	
θαλία	abundance, plenty, good cheer
θάλλω	to bloom, abound, to be luxuriant
θαμά	often, oft-times
θαμβέω	to be astounded, amazed
θάνατος	death
θανατόω	to put to death
θάπτω	to pay the last dues to a corpse, to honour with funeral rites
θαρσέω	to be of good courage, take courage
θάρσος	courage, boldness
θατήρ	
θαῦμα	whatever one regards with wonder, a wonder, marvel
θαυμάζω	to wonder, marvel, be astonied
θαυμαστός	wondrous, wonderful, marvellous
θεά	a goddess
θέα	a seeing, looking at, view
Θεανώ	
θείνω	to strike, wound
θεῖος	
θελημός	
θέλησις	a willing, will
θελξιεπής	
θελξίμβροτος	
θελοιμ'	
Θέμις	
θέμις	that which is laid down or established by custom
θεόδμητος	god-built, made or founded by the gods
θεόδοτος	
θεόπομπος	
θεός	God
θεοτίματον	
θεότιμος	
θεοφιλής	dear to the gods, highly favoured
θεράπων	a waiting-man, attendant
θέραψ	
θερμός	hot, warm
Θερμώδων	
θερσιεπής	
θέσμιος	according to law, lawful
θεσπέσιος	divinely sounding, divinely sweet
Θεσσαλία	
Θεσσαλίη	
Θεσσαλός	a Thessalian
ΘεσσαλῷἹπποις	
Θέστιος	
θευπροπία	
θέω	to run
θέωσις	
Θῆβαι	Thebes
Θήβη	
θηητός	gazed at, wondrous, admirable
θηλέω	to be full of
θηροσκόπος	looking out for wild beasts
Θησεύς	Theseus
θιγγάνω	to touch, handle
θίς	a heap
θνήσκω	to die, be dying
θνητός	liable to death, mortal
θοάς	
θοός	swift
θοόω	to make sharp or pointed
Θράκιος	Thracian
θράσις	
θράσος	courage, boldness
θρασυκάρδιος	bold of heart
θρασυμέμνων	bravely steadfast
θρασυμηδέα	
θρασύς	bold, spirited, courageous, confident
θρασύχειρ	bold of hand
θρέομαι	to cry aloud, shriek forth
θροέω	to cry aloud
θρῴσκω	to leap, spring
θυγάτηρ	a daughter
θυγάτρων	
θυμάρμενος	
θυμός	the soul
θυσία	an offering or mode of offering
θύω	
ι	
ἰαίνω	to heat
Ἰάονες	the Ionians
ἰατορία	the art of healing, surgery
Ἰάων	
ἰδέ	and
Ἴδη	Ida
ἴδη	a timber-tree
Ἴδης	
ἱδρώεις	
ἱερά	
ἱεραί	
ἱερή	
ἱερόν	
ἱερός	super-human, mighty, divine, wonderful
ἱερόω	to hallow, consecrate, dedicate
Ἱέρων	
ἵζω	to make to sit, seat, place
ἵημι	to set a going, put in motion
ἰθύς	
ἰθύω	to go straight, press right on
ἱκάνω	to come, arrive
ἵκετις	
ἱκνέομαι	to come
ἴκρια	the half-decks
ἵκω	to come to
ἴλαος	propitious, gracious
Ἴλιον	
Ἴλιος	Ilian, Trojan
ἱμείρω	to long for, yearn after, desire
ἱμεράμπυκος	
ἱμερόγυιος	
ἱμερόεις	exciting love or desire, lovely, delightsome, charming
ἱμερτός	longed for, lovely
ἵνα	in that place, there
Ἴναχος	
ἰοβλέφαρος	violet-eyed
fιοβλεφάρων	
Ἰόλη	
fιόν	
ἰοπλόκαμος	
fιόπλοκον	
ἰοπλόκος	weaving violets
ἰόπλοκος	
ἰός	
fιοστέφανον	
ἰοστέφανος	violet-crowned
ἱππευτής	a rider, horseman
ἱππίας	
ἵππιος	of a horse or horses
ἱππόβοτος	grazed by horses
ἱπποδίνητος	
ἱππόνικον	
ἵππος	a horse, mare
ἱπποτρόφος	horse-feeding, abounding in horses
ἱππώκεος	
ἰσάνεμος	
Ἰσθμια	
Ἰσθμιονίκης	
Ἰσθμιόνικον	
Ἴσθμιος	
ἴσθμιος	Isthmian
ἰσθμός	any narrow passage
fισθμοῦ	
ἰσόθεος	equal to the gods, godlike
ἰσοθεόω	to make equal to the gods
ἴσος	equal to, the same as
ἱστάω	
ἵστημι	to make to stand
ἱστίον	any web, a sail
ἵστωρ	a wise man, one who knows right, a judge
ἰσχυρός	strong, mighty
ἰσχύς	strength
ἴσχω	to hold, check, curb, keep back, restrain
Ἴφικλος	
Ἰώ	Io
Ιώ	
ἰώ	oh!
Ἴων	Ion
κ	
Κάδμος	Cadmus
καθά	according as, just as
καθό	in so far as, according as
καί	and
καίριος	in or at the right place
καιρός	due measure, proportion, fitness
καίω	to light, kindle
κακομήχανος	mischief plotting, mischievous, baneful
κακόποτμος	ill-fated, ill-starred
κακός	bad
κακόφρων	ill-minded, malicious, malignant
καλέω	to call, summon
κάλη	
καλλίζωνος	with beautiful girdles
καλλικέραν	
Καλλιόπη	Calliope, the beautiful-voiced
καλλιπάρᾳον	
καλλιρόη	
κάλλιστα	
καλλίχορος	with beautiful places
καλός	beautiful, beauteous, fair
Καλυδών	
καλυκοστέφανος	crowned with flower-buds
κάλυμμα	a head-covering
καλύπτω	to cover with
κάλυψις	
κάμνω	to work
κάμπτω	to bend, curve
καναχή	a sharp sound: the ring or clang
καναχός	
κάπρος	the boar, wild boar
καρδία	the heart
καρτερόθυμος	stout-hearted
καρτερός	strong, staunch, stout, sturdy;
καρτερόχειρ	strong-handed
κάρτος	strength, vigour, courage
καρύσσω	
καρχαρόδους	with sharp, jagged teeth
καρχαρόδων	
κάσα	
κάσας	a carpet or skin to sit upon, a saddle
κασιγνήτη	a sister
κασιγνητοῖς	
Κασταλία	
κατά	down, downwards, with gen. or acc.
κατακτείνω	to kill, slay, murder
καταναίω	to make to dwell, settle
κατανάσσω	to stamp or beat down firmly
κατανεύω	to nod assent
καταχραίνομαι	to besprinkle
κατέπεφνον	to kill, slay
κατέχω	to hold fast
κατορθόω	to set upright, erect
κεδνός	careful, diligent, sage, trusty
κεῖμαι	to be laid
Κεῖῳ	
ΚεῖῳΠαιδι	
κελαδέω	to sound as rushing water
κελάδω	sounding, roaring
κέλευθος	a road, way, path, track
κελεύω	to urge or drive on, urge, exhort, bid, command, order
κέλομαι	to urge on, exhort, command
κενόω	to empty out, drain
κεραυνεγχής	
κερδαίνω	to gain, derive profit or advantage
κέρδος	gain, profit, advantage
Κερκυών	
κεφαλή	the head
Κέως	Ceos
κῆδος	care for
Κηϊα	
κήλη	a tumor
Κήναιον	
κῆρ	the heart
κήρυξ	
κῆρυξ	a herald, pursuivant, marshal, public messenger
κηρύσσω	to be a herald, officiate as herald
κηὔτυκτον	
κικλήσκω	to call, summon
κινέω	to set in motion, to move
Κίρρη	
κιχάνω	to reach, hit
κιχήσας	
κίω	to go
κλάδος	a young slip or shoot broken off
κλάζω	to make a sharp piercing sound
κλεεννός	
κλεινός	famous, renowned, illustrious
Κλειώ	Clio
Κλεοπτολέμῳ	
κλέος	a rumour, report, news
κλέω	to tell of, celebrate
κλῄζω	
κλισία	a place for lying down
κλονέω	to drive in confusion, drive before one
κλύμενον	
Κλύμενος	
κλυτός	heard of
κλυτότοξος	famous for the bow, renowned archer
κλυτοφόρμιγγες	
κλύω	to hear
κνίζω	to scrape or grate: to tickle
Κνώσιον	
Κνωσίων	
Κνωσσός	
κοινόω	to make common, communicate, impart
κολπόω	to form into a swelling fold;
κομάω	to let the hair grow long, wear long hair
κόμη	the hair, hair of the head
κομπάζω	to vaunt, boast, brag
κόνις	ashes
κόρη	a maiden, maid, damsel
κόρος	
κορυφή	the head, top, highest point;
κορώνη	sea-crow
κοσμέω	to order, arrange
κόσμος	order
κουρεύς	a barber, hair-cutter
Κουρῆτες	
κοῦρος	
κοῦφος	light, nimble
κραδίας	
κραίνω	to accomplish, fulfil, bring to pass
κράς	the head
κραταιόομαι	
κραταιός	strong, mighty, resistless
κρατερός	strong, stout, mighty
κρατέω	to be strong, mighty, powerful
κράτος	strength, might
Κρεμμυῶνος	
Κρεούσα	
κρέουσαν	
Κρής	a Cretan
Κρήτη	Crete
Κρητικόν	
Κρητικός	of or from the island of Crete, Cretan
κρίνον	a lily
κρίνω	to pick out, choose
Κρῖσα	Crisa
κρίσις	a separating, power of distinguishing
κριτός	picked out, chosen
Κροῖσος	
Κρονίδης	son of Cronus
Κρόνιος	Saturnian, of Cronus or Saturn
κρόταφος	the side of the forehead
κρύπτω	to hide, cover, cloak
κτείνω	to kill, slay
κτίζω	to people
κυανανθής	
κυάνεος	dark-blue, glossy-blue
κυανοπλόκαμος	
κυανόπρῳρος	with dark-blue prow, dark-prowed
κυανῶπις	dark-looking
κυβερνάω	to act as pilot or helmsman
κυβερνήτης	a steersman, helmsman, pilot
κῦδος	glory, renown
κυδρός	glorious, illustrious, noble
κύκλος	a ring, circle, round
Κύκλωψ	a Cyclops
κύκνος	a swan
κῦμα	anything swoln
κυνέα	
κυνέη	a dog's skin
κύνεος	shameless, unabashed
Κύπρις	Cypris
κυρέω	to hit, light upon
κύων	a dog or bitch
κωκυτός	a shrieking, wailing
κωμάζω	to go about with a party of revellers, to revel, make merry
κῶμος	a village festival: a revel, carousal, merry-making
λ	
λαγχάνω	to obtain by lot, by fate, by the will of the gods
λαιψηρός	light, nimble, swift
Λάκαινα	Lacaena, a Laconian woman
λάκατος	
Λακεδαιμόνιος	
Λαμνίαν	
Λάμπος	bright
λαμπρός	bright, brilliant, radiant
λάμπω	to give light, shine, beam, be bright, brilliant, radiant
Λάμπων	
λανθάνω	to escape notice, to be unknown, unseen, unnoticed
Λαομέδων	
λαός	the people
λαοφόνος	slaying the people
Λάρισα	Larissa
λάρναξ	a coffer, box, chest
Λαρτιᾴδᾳ	
λάχη	
Λάχων	
Λάχωνα	
Λάχωνι	
λέγω	
λείπω	to leave, quit
λείριον	a lily
λείριος	
λειω	
λεπτόπρυμνος	
λεπτότριχα	
λεύκη	white leprosy
λευκός	light, bright, brilliant
λευκώλενος	white-armed
λέχος	a couch, bed
λέων	a lion
λήγω	to stay, abate
ληίς	booty, spoil
ληιστής	
ληιστός	to be carried off as booty, to be won by force
λῃστής	a robber, plunderer
Λητοίδης	son of Leto
Λητώ	Leto
λιγυκλαγγής	
λιγύφθογγος	clear-voiced
λινόστολος	
λιπαρέω	to persist, persevere, hold out
λιπαρής	persisting or persevering
Λιπαρίωνι	
λιπαρόζωνος	bright-girdled
λιπαρός	oily, shiny with oil
λιπάω	to be fat and sleek
λίπτομαι	to be eager
λίσσομαι	to beg, pray, entreat, beseech
λόγος	the word or that by which the inward thought is expressed
Λοξίας	the ambiguous
λούω	to wash
Λυγκεύς	
λυγρός	sore, baneful, mournful
Λυδία	Lydia
Λυδίης	
Λύδιος	of Lydia, Lydian
Λύκιοι	the Lycians
λύκιον	
Λύκιος	Lycian.
Λυκόρμης	
λύσσα	rage, fury
λυσσάω	to be raging
Λυταίου	
Μαῖα	Maia
μαίνομαι	to rage, be furious
Μάιος	of May
μάκαρ	blessed, happy
μάκαρος	
Μακελώ	
μακράν	a long way, far, far away
μακρός	long
Μαλέη	
μανία	madness, frenzy
μαρμαρυγή	a flashing, sparkling
μάρναμαι	to fight, do battle
Μάρπησσα	
μάταιος	vain, empty, idle, trifling, frivolous
ματεύω	to seek, search
μάχη	battle, fight, combat
μεγάθυμος	high-minded
μεγαίνητος	
μεγαλοκλέας	
μεγαλοσθενής	exceeding strong
μεγαλοῦχος	
μεγαλώνυμος	with a great name, giving glory
μέγαρον	a large room or chamber
μέγας	big, great
μεγασθενής	
μεγιστοάνασσα	
μεγιστοπάτωρ	
μεδέων	a guardian
μει	
μειγνυτ	
μειλίχιος	gentle, mild, soothing
μειόω	to make smaller, to lessen, moderate
μείς	a month
μείων	less
μελαγκευθής	
μέλαθρον	the ceiling of a room
μέλαινα	
μελαμφαρής	
μελάμφυλλος	dark-leaved
μέλας	black, swart
μελέαγρον	
Μελέαγρος	
μέλεος	idle, useless
μελετάω	to care for, attend to
μελέτη	care, attention
μέλη	
μελίγλωσσος	honey-tongued
μελίζω	to modulate, sing, warble
μέλισσα	a bee
μελίφρων	sweet to the mind, delicious
μέλλω	to think of doing, intend to do, to be about to do
μέλος	a limb
μέλπω	to sing of, celebrate with song and dance
μέλω	to be an object of care or thought
μέν	on the one hand, on the other hand
μένανδρος	
μενέκτυπος	
Μενέλαος	withstanding-men
μενεπτόλεμος	staunch in battle, steadfast
μένος	might, force, strength, prowess, courage
μέριμνα	care, thought
μεριμνάω	to care for, be anxious about, think earnestly upon, scan minutely
μέρος	a part, share
μέση	
μέσης	
μεσονύκτιος	of or at midnight
μέσος	middle, in the middle
μετά	in the midst of, among with gen., dat., and acc.
μεταί	
μετά-οἰχνέω	
ΜεταποντινῷΠαιδι	
Μεταπόντιον	
μεταπόντιος	
μεταπρέπω	to distinguish oneself or be distinguished among
μή	not
μηδέ	but not or and not, nor
μήδομαι	to be minded, to intend, resolve
μηλόβοτος	grazed by sheep
μηλοδαί̈κταν	
μηλοθύτης	one who sacrifices sheep, a priest
μῆλον	
μηλοτρόφος	sheep-feeding
μήν	now verily, full surely
μήνη	the moon
μῆνις	wrath, anger
μηνύω	to disclose what is secret, reveal, betray
μής	
μήτηρ	a mother
μῆτις	the faculty of advising, wisdom, counsel, cunning, craft
μήτρως	a maternal uncle
μίγνυμι	to mix, mix up, mingle, properly of liquids
μιμνήσκω	to remind, put
μίμνω	to stay, stand fast
μιν	himself
μινύθω	to make smaller or less, lessen, curtail
μινύνθη	
Μίνως	Minos
μίτρα	a belt or girdle
μοῖρα	a part, portion
Μοῖσα	
μονοπάλη	
μόνος	alone, left alone, forsaken solitary
μονόω	to make single or solitary
Μοῦσα	the Muse
Μοῦσος	
μῦθος	anything, delivered by word of mouth, word, speech
μυρίος	numberless, countless, infinite
μύρω	to flow, run, trickle
μυχός	the innermost place, inmost nook or corner
μῶμος	blame, ridicule, disgrace
ν	
ναήσατ'	
ναίω	
ναός	the dwelling of a god, a temple
νάπη	a wooded vale, dell
ναυβάτης	"a ""ship-goer,"" a seaman"
ναῦς	a ship
νάω	to flow
νεανίης	a young man, youth
νεάω	to plough up anew
νεβρός	the young of the deer, a fawn
νει	
νεῖκος	a quarrel, wrangle, strife
Νεῖλος	the Nile
Νέμεα	
Νεμέα	Nemea
Νέμειος	Nemean
νέμος	a wooded pasture, glade
νέμω	to deal out, distribute, dispense
νεόκροτος	
νεόκτιτος	
νεόπλοκον	
νέος	young, youthful
Νέσσος	
νευρά	a string or cord of sinew, a bowstring
νευρή	
νέφος	a cloud, mass or pile of clouds
νέω	
νῆις	unknowing of, unpractised in
Νηρεύς	Nereus
Νηρηίς	a daughter of Nereus, a Nereid or Nymph of the sea
νησιώτης	an islander
νῆσος	an island
νίζω	to wash the hands or feet
νικάω	to conquer, prevail, vanquish
νίκη	victory in battle
Νίκη	
νῖκος	
νιν	him, her
νίφω	to snow
νόημα	that which is perceived, a perception, thought
νόος	mind, perception
νόσος	sickness, disease, malady
νόσφι	aloof, apart, afar, away
νότος	the south or south-west wind
νύμφη	a young wife, bride
νῦν	now at this very time
νύξ	the night-season or a night
Νύξ	
νωμάω	to deal out, distribute
ξανθοδερκής	
ξάνθοθριξ	
ξανθόθριξ	yellow-haired
ξανθός	yellow
ξενία	the rights of a guest, hospitality, friendly entertainment or reception
ξένιος	belonging to a friend and guest, hospitable
ξένος	
ξενόω	to make one's friend and guest
ξεστός	smoothed, polished, wrought
ξίφος	a sword
ξουθός	yellowish, brown-yellow, tawny
ξύλινος	of wood, wooden
ξυνός	common, public, general, concerning or belonging to all in common
ο	
ὁ	the, that
ὀβριμοδερκής	
ὀβριμόσπορος	
ὁδάω	to export and sell;
ὅδε	this
ὁδός	
ὀδούς	
ὁδόω	to lead by the right way
ὀδύρομαι	to lament, bewail, mourn for
Ὀδυσσεύς	
ὀδών	
ὅθεν	from whom
ὅθι	
fοι	
οἶδα	to know
οἰκεῖος	in or of the house, domestic
οἰκειόω	to make one's own
οἰκείω	
οἰκεύς	an inmate of one's house
οἰκέω	to inhabit, occupy
οἰκίζω	to found as a colony or new settlement
Ὀϊκλείδας	
οἶκος	a house, abode, dwelling
οἰκτείρω	to pity, feel pity for, have pity upon
Οἰνεί̈δης	
Οἰνεύς	
οἷος	such as, what sort or manner of nature, kind
ὀιστός	an arrow
οἰστροπλάξ	
Οἰχαλία	
οἴχομαι	to be gone, to have gone
ὀλβία	
ὄλβιος	happy, blest
ὄλβος	happiness, bliss, weal, wealth
ὄλεθρος	ruin, destruction, death
ὀλιγοσθενής	
ὁλκάς	a ship which is towed, a ship of burthen, trading vessel, merchantman
ὄλλυμι	to destroy, make an end of
ὀλολύζω	to cry to the gods with a loud voice, cry aloud
ὅλοξ	whole, entire, complete
ὀλοός	destroying, destructive, fatal, deadly, murderous
Ὀλυμπία	Olympia
Ολύμπια	
Ὀλύμπια	the Olympic games, in honour of Olympian Zeus
Ὀλυμπίας	
Ὀλυμπιεῖον	the temple of Olympian Zeus
Ὀλυμπιοδρόμος	
Ὀλυμπιονίκη	
Ὀλυμπιονίκης	a conqueror in the Olympic games
Ὀλύμπιος	Olympian, of Olympus, dwelling on Olympus
Ὄλυμπος	Olympus
ὁμιλέω	to be in company with, consort with
ὅμιλος	any assembled crowd, a throng of people
ὄμμα	the eye
ὀμματόω	to furnish with eyes
ομοι	
ὀμφαλός	the navel
ὀμφή	the voice of a god
ον	
ὀξύς	sharp, keen
ὀπ	
ὀπάζω	to make to follow, send with
ὅπη	by which way
fοπί	
ὀπίσσω	
ὀπίσω	backwards
ὅπλον	a tool, implement
ὁπλότερος	the younger
ὁπότε	when
ὁράω	To see
ὀρέγω	to reach, stretch, stretch out
ὀρθοδίκας	judging righteously
ὀρθόδικος	
ὀρθός	straight
ὀρθόω	to set straight
ὁρία	
ὀρίνω	to stir, raise, agitate
ὅριον	a boundary, limit
ὅριος	of boundaries
ὁρμαίνω	to turn over or revolve anxiously in the mind, to debate, ponder
ὁρμάω	to set in motion, urge
ὁρμή	a violent movement onwards, an assault, attack, onset
ὄρνις	a bird
ὄρνυμι	to stir, stir up
ὅρος	a boundary, landmark
ὄρος	a mountain, hill
ὀρούω	to rise and rush violently on, to move quickly, rush on, hasten, dart forward
ὀρσίαλος	
ὀρσιβάκχαν	
ὀρσιμάχου	
ὄρχος	a row of vines or fruit-trees
ὅς	this, that;
ὅσιος	hallowed, sanctioned by the law of God
ὅσος	quantus
ὁσσάκις	
ὅστε	who, which
ὅστις	any one who, anything which
ὅταν	whenever
ὅτε	when
ὅτι	
ὀτρύνω	to stir up, rouse, egg on, spur on, encourage
ου	
οὐ	not
οὐδέ	but not
οὐδείς	and not one
οὐδός	
οὐκέτι	no more, no longer, no further
οὔλιος	baleful, baneful
οὖλος	
οὖν	really, at all events
οὔπω	not yet
Οὐρανία	Urania, the heavenly one
Ουρανίας	
Οὐρανίδης	son of Uranus
οὐράνιος	heavenly, of or in heaven, dwelling in heaven
οὐρανός	heaven
οὐρία	
οὔριος	with a fair wind
οὖρον	
οὖρος	
ους	
οὔτε	and not
οὔτι	not, I suppose . . , surely you do not mean that . .
οὔτις	no one or nobody
οὔτοι	indeed not
οὗτος	this
ὀφθαλμός	the eye
ὄφρα	that, in order that, to the end that
ὀφρυάω	to have ridges
ὀφρύς	the brow, eyebrow
ὄχθη	a rising ground, a bank, dyke
ὄχθος	a bank, hill
ὄψ	a voice
οδε	
παγκρατής	all-powerful, all-mighty
παγκράτιον	a complete contest, an exercise which combined both wrestling and boxing
παγξείνου	
πάγξενος	
Παιάν	Paean or Paeon
παιανίζω	
παῖς	a child
Πακτωλός	
πάλα	
παλαιός	old in years
παλαιόω	to make old
ΠαλαιστῇΠυθια	
παλαίστρα	a palaestra, wrestling-school
πάλη	wrestling
πάλιν	back, backwards
παλίντροπος	turned back, averted
Παλλάς	Pallas
πάλλω	to poise or sway
παμμαχία	
πάμπαν	quite, wholly, altogether
πανδαμάτωρ	the all-subduer, all-tamer
πανδερκής	all-seeing
Πανδίων	
πανελλάνων	
πανθαλής	
Πανθείδα	
Πανθείδᾳ	
πάννικος	
πανσυδίῃ	with all speed
πάντῃ	
παντοδαπής	
παντοδαπός	of every kind, of all sorts, manifold
πάντοθεν	from all quarters, from every side
παντοῖος	of all sorts or kinds, manifold
παρά	from the side of, c. gen., beside, alongside of, c. dat., to the side of, motion alongside of, c. acc.
παραπλήξ	stricken sideways
παρατρέπω	to turn aside
παραχώννυμι	to throw up beside
πάρεδρος	sitting beside
πάρειμι	to be by or present
παρέχω	to hold beside, hold in readiness, to furnish, provide, supply
παρηίς	
παρθενία	
παρθενίας	
παρθενίης	the son of a concubine
παρθενική	
παρθενικός	of or for a maiden
παρθένιος	of a maiden or virgin, maiden, maidenly
παρθένος	a maid, maiden, virgin, girl
παρίημι	to let drop beside or at the side, let fall
παρίστημι	to make to stand or to place beside
πάροιθε	before, in the presence of
πάρος	beforetime, formerly, erst
πάρφρων	
πᾶς	all, the whole
πᾶσις	
πασιφανής	
πάτηρ	
πατήρ	a father
πάτρα	fatherland, native land, country, home
πάτρη	
πάτριος	of or belonging to one's father
πατρῷος	of or from one's father, coming or inherited from him
παῦλα	rest, a resting-point, stop, end, pause
παῦρος	little, small
παῦσις	
παύω	to make to cease
πεδάω	to bind with fetters, to bind fast, make fast
πέδιον	
πεδίον	a plain or flat
πέδον	the ground, earth
πείθω	to prevail upon, win over, persuade
Πειράναν	
πείρω	to pierce quite through, fix
πεισίμβροτος	
πέλαγος	the sea
πελάζω	to approach, come near, draw near or nigh
Πελλάνη	
Πέλοψ	Pelops
πέλω	to be in motion
πέμπω	to send, despatch
πέμψις	a sending, mission, dispatch
πενία	poverty, need
πένταθλον	the contest of the five exercises
πένταθλος	one who practises the πένταθλον or conquers therein
πέντε	five
πεντήκοντα	fifty
πέρθω	to waste, ravage, sack, destroy
περί	around, round about with gen., dat., and acc.
περικλειτός	famed all round, farfamed
Περσείδης	
Περσεύς	Perseus
Πέρσης	a Persian, inhabitant of Persis
πέταλον	a leaf
πέταλος	broad, flat
πετάννυμι	to spread out
πέτασος	a broad-brimmed felt hat
πετραῖος	of a rock
πῆ	in what way? how?
πήγνυμι	to make fast
Πηλείδης	
Πηλεύς	Peleus
πῆμα	suffering, misery, calamity, woe, bane
Πηνειός	
πηρός	disabled in a limb, maimed
πῆρος	
πιαίνω	to make fat, fatten
Πιερίαθεν	
Πιερίδες	the Pierides
Πιερίς	
πινυτή	understanding, wisdom
πινυτός	wise, prudent, discreet, understanding
πίνω	to drink
πίπτω	to fall, fall down
Πῖσα	Pisa
πίσα	
πίσυνος	trusting on, relying or depending on, confiding in
Πιτθεύς	
πιτυώδης	abounding in pines
πιφαύσκω	to make manifest, declare, tell of
πλαγκτός	wandering, roaming
Πλεισθενίδης	
πλείσταρχος	
πλείων	more, larger
Πλευρών	
πλημύρων	
πλήξιππος	striking or driving horses
πλήσσω	to strike, smite
πλόκος	a lock of hair, a braid, curl
πλοῦτος	
πνέω	to blow
πνοή	a blowing, blast, breeze
πόα	grass, herb
ποδάνεμον	
ποδαρκής	
πόθεν	whence?
ποθεν	from some place or other
ποικίλλω	to work in various colours, to broider, work in embroidery
ποικίλος	many-coloured, spotted, mottled, pied, dappled
ποιμήν	
ποῖος	of what nature? of what sort?
πολέμαιγις	
πολέμαρχος	one who begins or leads the war, a leader, chieftain
πολεμηί̈αν	
πολεμήιος	warlike
πόλεμος	battle, fight, war
πολεμόω	to make hostile, make an enemy of
πολέω	to go about, range over
πολιός	gray, grizzled, grisly
πόλις	a city
πολυδάκρυος	
πολύδακρυς	of or with many tears
πολύζηλος	full of jealousy and rivalry
πολυζήλωτος	much envied
πολυήρατος	much-loved, very lovely
πολυκρατής	very mighty
πολύκρημνος	
πολύκριθος	
πολυλάϊον	
πολύλλιστος	sought with many prayers
Πολυνείκης	
Πολυπήμων	
πολυπλάγκταν	
πολύπλαγκτος	much-wandering, wide-roaming
πολύπυργος	with many towers
πολύς	many
πολύστονος	much-sighing, mournful
πολύφαντος	
πολύφατος	much-spoken-of, very famous, excellent
πολύχρυσος	rich in gold
πόνος	work
ποντίζω	to plunge in the sea
πόντιος	of the sea
πόντονδε	into the sea
πόντος	the sea
Πορθανίδα	
πορθέω	to destroy, ravage, waste, plunder
πόρος	a means of passing a river, a ford, ferry
πορσύνω	to offer, present
πορτιτρόφος	nourishing calves
πορφύρα	the purple-fish
πορφύρεος	darkgleaming, dark;
πορφυροδίναν	
πορφυρόζωνος	
πόρω	to furnish, offer, present, give
Ποσειδάν	
Ποσειδᾶνι	
Ποσειδᾶνος	
ποταίνιος	fresh, new
ποταμός	a river, stream
ποτέ	at some time or other, at some time
πότερος	whether of the two?
ποτή	flight
πότμος	that which befals one, one's lot, destiny
πότνια	mistress, queen
ποτόν	
ποτός	drunk, fit for drinking
πού	anywhere, somewhere
ποῦ	where?
πούς	a foot
πρᾶξις	a doing, transaction, business
πράσσω	to pass over
πρέπω	to be clearly seen, to be conspicuous
πρέσβυς	an old man
Πρίαμος	Priam
πρίν	comparative
πρό	before
προ	
πρόδομον	
πρόδομος	
προίημι	to send before, send on or forward
Προῖτος	
πρόκειμαι	to be set before one
Προκόπτας	
προλείπω	to go forth and leave, to leave behind, forsake, abandon
πρόξενος	a public
προπάροιθε	before, in front of
προπέμπω	to send before, send on or forward
πρόπολος	employing oneself before
πρός	motion from
προσεῖδον	to look at or upon
προσεῖπον	to speak to
προσεννέπω	to address, accost
πρόσθεν	before
πρόσπολος	a servant
προστίθημι	to put to
πρόσφημι	to speak to, address
προσφωνέω	to call or speak to, address, accost
πρότερος	prae.
προφαίνω	to bring forth, bring to light, shew forth, manifest, display
προφανής	shewing itself or seen beforehand
προφέρω	to bring before
προφήτης	one who speaks for a God and interprets his will
προχοή	the outpouring
πρύμνα	the hindmost part of a ship, the stern, poop
πρύτανις	a prince, ruler, lord, chief
πρώθηβος	
πρών	a foreland, headland
πρώτιστος	the very first, first of the first
πρῶτος	
πτέρυξ	the wing
πτήσσω	to frighten, scare, alarm
Πυθέης	
Πύθια	the Pythian games
Πύθιον	the temple of Pythian Apollo
Πυθιόνικος	of or a belonging to a Pythian victory
Πύθιος	Pythian
πυθμήν	the hollow bottom or stand of a cup
Πυθώ	Pytho
πύθω	to make rot, to rot
Πυθών	
πυκιν	
πύλη	one wing of a pair of double gates
πύματος	hindmost, last
πυνθάνομαι	to learn by hearsay or by inquiry
πύξ	with clenched fist
πῦρ	fire
πύργος	a tower
πυργόω	to gird or fence with towers
πυρή	any place where fire is kindled
πυριέθειρα	
πυρός	wheat
Πύρριχος	
πυρρός	flame-coloured, yellowish-red
πυρσός	a firebrand, torch
πυρσόχαιτος	
πω	up to this time, yet
πῶλος	a foal, young horse
πῶμα	
ῥᾴδιος	easy, ready, easy to make or do
ῥαίδιον	
ραν	
ῥεῖθρον	that which flows, a river, stream
ῥέπω	to incline downwards, to sink, fall
ῥιπή	the swing or force with which anything is thrown
ῥίπτω	to throw, cast, hurl
ῥοδοδάκτυλος	rosy-fingered
ῥοδόεις	of roses
ῥόδον	the rose
ῥοδόπηχυς	rosy-armed
ῥοή	a river, stream, flood
ς	
σαγόραι	
σαίνω	to wag the tail, fawn
σακεσφόρος	shield-bearing
σάλπιγξ	a war-trumpet, trump
σάν	
σάπεται	
Σάρδεις	Sardes
σαφής	clear, plain, distinct, manifest
σβέννυμι	to quench, put out
σεῖος	
σεισίχθων	earth-shaker
σείω	to shake, move to and fro
σέλας	a bright flame, blaze, light
σελήνη	the moon
Σεμέλη	
σεμνοδότειρα	
σεμνόν	
σεμνός	revered, august, holy, awful
σεμνόω	to make solemn or grand, to exalt, magnify, embellish
σεύω	to put in quick motion: to drive, hunt, chase away
σῆμα	a sign, mark, token
σημαίνω	to shew by a sign, indicate, make known, point out
σής	a moth
σθένος	strength, might
σθένω	to have strength or might, be strong or mighty
σί	
Σικελία	Sicily
Σικυών	Sicyon
Σίνις	
σιωπή	silence
Σκάμανδρος	the Scamander
σκῆπτρον	a staff or stick to lean upon, a walking-stick
Σκίρων	which blew from the Scironian rocks
σκοπέω	to look at or after
σκότος	darkness, gloom
σμερδαλέος	terrible to look on, fearful, aweful, direful
σόει	
σός	thy, thine, of thee
σοφός	skilled in any handicraft or art, cunning in his craft
Σπάρτη	Sparta
Σταδίει	
στάδιον	a stade, =
στάδιος	standing firm
στάζω	to drop, let fall or shed drop by drop
στείχω	to walk, march, go or come
στέρνον	the breast, chest
στέρομαι	to be wanting in, to lack, want
στέφανος	that which surrounds
στεφανοφόρων	
στεφανόω	to be put round
στῆθος	the breast
στίλβω	to glisten
στολή	an equipment, armament
στόρεννυμι	
στρατα	
στραταγέταν	
στρατάω%	
στρατηγός	the leader or commander of an army, a general
στρατία	an army
στρατιά	
στρατός	an encamped army
στρωφάω	to turn constantly
στυγερός	hated, abominated, loathed
Στύξ	the Styx
σύ	
συμβολέω	to meet or fall in with
συμφορά	an event, circumstance, chance, hap
σύμφωνος	agreeing in sound, in unison
σύν	along with, in company with, together with
σύνειμι	
συνετός	intelligent, sagacious, wise
συνεχής	holding together
σύνοικος	dwelling in the same house with
Συρακοσία	the territory of Syracuse
Συρακόσιος	Syracusan
ΣυρακοσίῳἹπποις	
Συρακόσσας	
σφάζω	to slay, slaughter
σφέτερος	their own, their
σφῦρα	a hammer
σχάζω	to let loose
σχέτλιος	unwearying
σῶμα	the body
σῶς	safe and sound, alive and well, in good case
σώφρων	of sound mind
τ	
ταινία	a band, riband, fillet
Ταλαϊονίδης	
Ταλαιονίδης	
τάλαντον	a balance
ταλαπενθής	patient in woe
τάλας	suffering, wretched
τᾶν	sir, my good friend
τανίσφυρος	
τανίφυλλος	
τανύσφυρος	with taper ancles
ταρφύς	thick, close
ταῦρος	a bull
ταύ̈σιον	
τάφος	
τάχα	quickly, presently, forthwith
τάχος	swiftness, speed, fleetness, velocity
ταχύς	quick, swift, fleet
ταχυτής	quickness, swiftness
τε	and
τέγγω	to wet, moisten
τέθηπα	to be astonished, astounded, amazed
τέθμιος	settled, regular
Τεισίᾳ	
τεῖχος	a wall
τέκνον	that which is borne or born, a child
τέκος	the young
Τελαμών	
τέλειος	having reached its end, finished, complete
τελειόω	to make perfect, complete
τελευταῖος	last
τελευτάω	to complete, finish, accomplish
τελευτή	a finishing, completion, accomplishment
τελέω	to complete, fulfil, accomplish
τέλλω	to make to arise, accomplish
τέλος	the fulfilment or completion
τέμενος	a piece of land cut off, assigned as a domain
τέμνω	to cut, hew
τεός	
τέος	
τέρας	a sign, wonder, marvel
τέρπω	to satisfy, delight, gladden, cheer
τερψιεπής	
τέρψις	enjoyment, delight
τέταρτος	fourth
τετραέλικτος	four times wound round
τέτρατος	fourth
τεῦχος	a tool, implement
τεύχω	to make ready, make, build, work
τέχνη	art, skill, craft in work, cunning of hand
τηλαυγής	far-shining, far-beaming
τίθημι	to set, put, place
τίκτω	to bring into the world
τιμάω	to pay honour to, hold in honour, to honour, revere, reverence
τιμή	that which is paid in token of worth or value
Τιμόξενος	
τιν	
Τιρύνθιος	
Τίρυνς	
τίς	who? which?
τις	any one, any thing, some one, some thing;
τιταίνω	to stretch
τιτύσκων	
τίω	to pay honour to
τλήμων	suffering, enduring, patient, stout-hearted
τόθεν	hence, thence
τόθι	there, in that place
τοι	let me tell you, surely, verily
τοῖος	quality, such, such-like
τοιόσδε	such a
τοιοῦτος	such as this
τον	
τοξόκλυτος	
τόξον	a bow
τόσος	so great, so vast
τότε	at that time, then
τραχύς	rugged, rough
τρεισκαίδεκα	thirteen
τρέφος	
τρέφω	to thicken or congeal
τρέω	to flee from fear, flee away
τριάκοντα	thirty
τριέτης	of or for three years
τρίπους	three-footed, of or with three feet
τρισευδαίμων	thrice-happy
τρίτατος	
τρίτος	the third
Τροία	Troy
Τροιζήνιος	of Troezen
τροχοειδής	round as a wheel, circular
Τρώς	Tros
τυγχάνω	to hit
τυφλός	blind
τύχη	the good which man obtains
τυχόν	
τύχος	
τῷ	therefore, in this wise, thereupon
τώς	so, in this wise
ὕβρις	wantonness, wanton violence or insolence
Ὕβρις	
ὑγίεια	health, soundness
ὑγρός	wet, moist, running, fluid
ὕδωρ	water
υἱός	A son
ὑλάω	to howl, bark, bay
ὕλη	forest-trees
ὑμέτερος	your, yours
ὑμνέω	to sing, laud, sing of
ὕμνησις	
ὑμνοάνασσα	
ὕμνος	a hymn, festive song or ode, in praise
ὑπέρ	over, above, w. gen, over, beyond, w. acc.
ὑπεράφανος	
ὑπέρβιος	of overwhelming strength or might
Ὑπερβόρεοι	the Hyperboreans
Ὑπερβόρεος	
ὑπέρθυμος	high-spirited, high-minded, daring
ὑπέροπλος	proudly trusting in force of arms, defiant, presumptuous
ὑπέροχος	prominent, eminent, distinguished above
ὑπέρτατος	uppermost, highest, supreme
ὑπερφίαλος	overbearing, overweening, arrogant
ὕπνον	
ὕπνος	sleep, slumber
ὑπνόω	to put to sleep
ὑπό	from under, by, c. gen. under, c. dat., towards c. acc.
ὗς	the wild swine
ὑσμίνη	a fight, battle, combat
ὕστερον	
ὕστερος	latter, last
ὑφαίνω	to weave
ὑφαιρέω	to seize underneath or inwardly
ὑφή	a web
ὑψαυχής	
ὑψιδαίδαλτος	
ὑψίδειρος	
ὑψίζυγος	sitting high on the benches;
ὑψικέραν	
ὑψιμέδων	ruling on high
ὑψίνοος	
ὑψίπυλος	with high gates
ὑψιφαής	high-shining, far-seen
ὑψιφανής	
ὑψοῦ	aloft, on high
ὑψόω	to lift high, raise up
φαεσίμβροτος	bringing light to mortals
φαίδιμος	shining
φαίνω	to bring to light, make to appear
Φαί̈σκου	
φάλαγξ	a line of battle, battle-array
φάος	light, daylight
φαρέτρα	a quiver
φάρος	
φᾶρος	a large piece of cloth, a web
φάσγανον	a sword
φάσκω	to say, affirm, assert
φάτις	a voice from heaven, the voice of an oracle, an oracle
φέγγος	light, splendour, lustre
φερεκυδής	
Φερένικος	
φερεστέφανος	
Φέρης	
φέριστος	
Φερσέφασσα	
φέρτατος	bravest, best
φέρω	to bear
φεῦ	ah! alas! woe!
φεύγω	to flee, take flight, run away
φήμη	a voice from heaven, a prophetic voice
φημί	to declare, make known
φθέγγομαι	to utter a sound or voice
φθίω	to decay, wane, dwindle
φθόνος	ill-will, envy, jealousy
φθόρος	a pestilent fellow
φιλ	
φιλάγλαος	loving splendour
φιλάνωρ	fond of one's husband, conjugal
φιλέω	to love, regard with affection
φίλιππος	fond of horses, horse-loving
φιλοξενία	hospitality
φιλόξενος	loving strangers, hospitable
φῖλος	
φίλος	loved, beloved, dear
φιλοστέφανος	loving crowns, garlanded
φιτρός	a block of wood, log
ΦλειάσιῳΠενταθλῳ	
Φλειοῦντα	
φλόξ	a flame
φοβέω	to put to flight
φόβος	flight
φοιβάν	
Φοῖβος	
φοινίκασπις	
φοινίκοθριξ	
φοινικοκραδέμνοιο	
φοινικοκραδέμνοισι	
φοινικόνωτος	
φοινικοστερόπας	hurler of red lightnings
φοῖνιξ	a purple-red, purple or crimson
Φοῖνιξ	a Phoenician
φοινίσσω	to redden, make red
φοιτάω	to go to and fro, up and down, to stalk
φονάω	to be athirst for blood, to be murderous
φόνος	murder, homicide, slaughter
φόρμιγξ	the phorminx
φραδή	understanding, knowledge
φράτρα	a brotherhood
φρενοάραις	
φρενόω	to make wise, instruct, inform, teach
φρήν	the midriff or muscle which parts
φρονέω	to think, to have understanding, to be sage, wise, prudent
φροντίς	thought, care, heed, attention
φρόντισις	
φρύγιον	
Φρύγιος	Phrygian, of, from Phrygia
φυή	growth, stature
φυλάζω	to divide into tribes
φύλαξ	a watcher, guard, sentinel
φύλαξις	a security
φυλάσσω	to keep watch and ward, keep guard
φύλλον	a leaf;
φῦλον	a race, tribe, class
φυτεύω	to plant
φύω	to bring forth, produce, put forth
φωνέω	to produce a sound or tone
φωνή	a sound, tone
φώς	a man
χαίτη	long, flowing hair
χαλεπός	hard to bear, painful, sore, grievous
χάλκασπις	with brasen shield
χαλκεόκρανος	
χαλκεόκτυπος	
χαλκεομίτρας	
χαλκεόστερνος	
χαλκοθώραξ	
χαλκόκτυπος	
χαλκοκώδων	
χαλκός	copper
χαλκοτειχής	
χάος	chaos
χάρις	Grace
Χάρις	
χάριτος	
χαριτόω	to shew grace to
χαριτώνυμος	
χάρμα	a source of joy, a joy, delight
χάρμη	the joy of battle, lust of battle
χάρμης	
χεῖμα	winter-weather, cold, frost
χειμών	winter
χείρ	the hand
χειρόω	to bring into hand, to manage, master, subdue
χέρσος	dry land, land
χέω	to pour
χθών	the earth, ground
χιτών	the garment worn next the skin, a frock
χλαμύς	a short mantle
χλωραύχενα	
χοις	
χόλος	gall, bile
χολόω	to make angry, provoke, anger
χορός	a round dance
χόω	to throw or heap up
χραίνω	to touch slightly
χρεῖος	needing, being in want of
χρέος	that which one needs must pay, an obligation, debt
χρή	it is fated, necessary
χρηστός	useful, good of its kind, serviceable
χροιά	the surface of a body, the skin; the body
χρόνος	time
χρυεῳ	
χρυσάμπυξ	with fillet or frontlet of gold
χρυσάορος	with sword of gold
χρυσάρματος	with or in car of gold
χρύσασπις	with shield of gold
χρυσάωρ	
χρυσεόπλοκος	
χρύσεος	golden, of gold, decked or inlaid with gold
χρυσεόσκαπτρος	
χρυσηλάκατος	with spindle of gold
χρυσοδίνας	
χρυσόθρονος	gold-enthroned
χρυσοκόμη	
χρυσοκόμης	the golden haired
χρυσόπαχυς	
χρυσόπεπλος	
χρυσός	gold
χρώς	the surface of the body, the skin
χώρα	the space in which a thing is
χωρέω	to make room for another, give way, draw back, retire, withdraw
ψευδοκύων	a sham Cynic
ψυχή	breath
ὦ	O! oh!
ὧδε	in this wise, so, thus
ὠκύμορος	quickly-dying, dying early
ὠκύπομπος	quick-sending, conveying rapidly
ὠκύπους	swift-footed
ὠμηστής	eating raw flesh
ὦμος	ulna
ὡς	thus, as, so that, since
ὡσεί	just as if, as though
ὥστε	as, as being