Field1	Field2
ἆ	ah!
ἀάω	to hurt, damage
Ἀβαντιάς	
Ἄβας	
ἁβατάν	
ἄβροχος	unwetted, unmoistened
ἀγαθός	good
ἀγάλακτες	
ἄγαλμα	a glory, delight, honour
ἄγαμαι	to wonder, be astonished
Ἀγαμέμνων	the very steadfast
ἀγγελιώτης	
ἀγγελιῶτις	
ἄγε	come! come on! well!
Ἁγεσίλαι	
ἀγινέω	to lead, bring, carry
ἅγιος	devoted to the gods, sacred, holy
Ἀγκαῖος	
ἀγκάλη	the bent arm
ἁγνός	full of religious awe
ἄγνυμι	to break, shiver
Ἀγοράνακτος	
ἄγος	any matter of religious awe
ἄγρα	a catching, hunting
ἀγρευτήρ	
ἀγρευτής	a hunter
ἀγρεύω	to take by hunting or fishing, to catch, take
ἀγρέω	to capture, seize
ἄγριος	living in the fields
ἀγρόθι	
ἀγρυπνία	sleeplessness, waking, watching
ἀγρώσσω	to catch
ἀγυιά	a street, highway
ἀγχόθι	near
ἄγω	to lead or carry, to convey, bring
ἀγών	a number of people brought together, a gathering, assembly
ἀδελφή	a sister
ἀδελφός	sons of the same mother
ἄδηλος	not seen or known, unknown, obscure
ἅδην	to eat their fill
ᾍδης	Hades or Pluto
ἀδηφαγία	
ἀδιάφορος	
ἀδικέω	to do wrong
ἀδίκημα	a wrong done, a wrong
ἄδικος	wrong-doing, unrighteous, unjust
ἄδμητος	unbroken
Ἄδμητος	
άδος	
Ἀδράστεια	the Inevitable
ἀέθλιος	
ἀεί	always, for ever
ἀείδει'	
ἀείδω	to sing
ἀειζώων	ever-living
ἀείρω	to lift, heave, raise up
ἄεισμα	
ἀέκων	against one's will, unwilling
ἀέλιος	
ἄεμμα	
ἀέναος	ever-flowing
ἀενάων	
ἀέξω	to increase, enlarge, foster, strengthen
ἀεργός	not-working, idle
Ἀζήνια	
Ἄζιλιν	
ἀηδονίς	a nightingale
ἀηδών	the songstress
ἄημα	a blast, gale
ἄημι	to breathe hard, blow
ἀήρ	the lower air, the air
ἀήτη	
ἀήτης	a blast, gale
ἀθάνατος	undying, immortal
Ἀθήναια	
Ἀθήναιον	the temple of Athena
Ἀθηναῖος	Athenian, of or from Athens
Ἀθήναιος	
Ἀθήνη	Athena
ἄθικτος	untouched
ἀθλέω	having contended with
ἄθλιος	gaining the prize
ἆθλον	the prize of contest
ἆθλος	a contest for a prize
ἀθλοφόρος	bearing away the prize, victorious
ἀθρέω	to look at, gaze at, observe, perceive
αι	
αἶα	
Αἰγαῖος	Aegaean
αἴγειρος	the poplar
Αἰγιαλός	
αἰγιαλός	the sea-shore, beach, strand
Αἰγίνηθεν	
Αἰγύπτιος	Egyptian
αἰδέομαι	to be ashamed to do
Ἀίδηι'	
Αἵδης	
ἄιδι	
Αἰετίωνος	
αἰζηός	strong, lusty, vigorous
αἴθε	would that
αἰθήρ	ether, the brighter purer air, the sky
Αἰθιοπῆος	
αἰθός	
αἴθυια	a gull or diver
αἴθω	to light up, kindle
αἴθων	fiery, burning, blazing
αἴλινον	
αἴλινος	a plaintive dirge
αἴλουρος	a cat
αἷμα	blood
Αἷμος	
αἰνέω	to tell or speak of
Αἴνιος	
αἰνογένειος	
αἰνός	dread, dire, grim
αἴξ	a goat
Αἰολεύς	an Aeolian
Αἰολίς	
αἰόλος	quick-moving
αἰπόλος	a goatherd
αἱρέω	to take with the hand, grasp
αἴρω	to take up, raise, lift up
αις	
ἄισατε	
αἰσθάνομαι	to perceive, apprehend by the senses, to see, hear, feel
ἄισθετο	
αἴσιος	boding well, auspicious
αἶσις	
Αἴσχρην	
Αἰσχυλίς	
αἰτέω	to ask, beg
αἰτίζω	to ask, beg
αἴτιος	to blame, blameworthy, culpable
Αἰτναῖος	of or belonging to Etna
Αἴτνη	
αἰφνίδιος	unforeseen, sudden
αἰχμάζω	to throw the spear
αἰχμή	the point of a spear
αἶψα	quick, with speed, on a sudden
ἀίω	
αἰώνιος	lasting for an age
ἀκακήσιος	
Ἀκακήσιος	
Ἀκάνθιος	
Ἀκέσων	
ἀκηδής	uncared for, unburied
ἀκήριος	unharmed by the Κῆρες, unharmed
ἀκλαυτεί	
ἀκλεής	without fame, inglorious, unsung
ἀκμάζω	to be in full bloom, be at one's prime or perfection
ἀκμή	a point, edge
ἄκμων	a thunderbolt
ἀκοή	a hearing, the sound heard
ἄκολος	a bit, morsel
ἀκουάζομαι	to hearken
ἀκουή	
ἄκουσις	
ἀκούω	to hear
ἄκρα	a headland, foreland, cape
Ακρητος	
Ἀκρίσιος	
ἄκρον	the highest or furthest point
ἄκρος	at the furthest point
ἄκρων	
ἀκρώρεια	a mountain-ridge
Ἀκταίονα	
Ἀκτορίων	
ἄκυθος	
ἀκωκή	a point
ἄκων	a javelin, dart
ἀλάβαστρον	a box or casket of alabaster
ἀλάομαι	to wander, stray or roam about
ἀλαός	not seeing, blind
ἀλαπάζω	to empty, drain, exhaust
Ἀλάς	
ἀλαστέω	to be full of wrath
ἄλαστος	not to be forgotten, insufferable, unceasing
ἀλγέω	to feel bodily pain, suffer
ἄλγος	pain
ἀλεγεινός	hard
ἀλέγω	to trouble oneself, have a care
ἀλεείνω	to avoid, shun
Ἀλείοιο	
ἀλέκτρινον	
ἀλέκτωρ	a cock
ἀλέομαι	to avoid, shun
ἀλετρίς	a female slave who grinds corn
ἀλέω	to grind, bruise, pound
Ἅλη	
ἄλη	
ἁλή	
ἀληθής	unconcealed, true
ἀληθινός	agreeable to truth
ἁλία	an assembly of the people
Ἁλίαρτος	
ἁλιεύς	one who has to do with the sea
ἁλίζω	
ἁλίη	
'Αλικαρνησεῦ	
ἅλιος	
ἁλίπληκτος	sea-beaten
ἁλίπλοος	covered with water
ἁλίς	
ἅλις	in heaps, crowds, swarms, in abundance, in plenty
ἀλιταίνω	to sin or offend against
ἀλιτήμων	
ἀλιτήριος	sinning or offending against
ἀλιτρός	sinful, sinning
Ἀλκείδης	
ἀλκυονίς	
ἀλ́λα	
ἀλλά	otherwise, but
ἀλλαιχ'	
ἄλληκτος	unceasing, ceaseless
ἀλλήλων	of one another, to one another, one another
ἅλλομαι	to spring, leap, bound
'ἄλλος	
ἄλλος	alius, another, one besides
ἄλλοτε	at another time, at other times
ἀλλότριος	of or belonging to another
ἄλλως	in another way or manner
ἄλοχος	a bedfellow, spouse, wife
ἅλς	a lump of salt
ἄλσις	
ἄλσος	a glade or grove
ἀλυσθμαίνουσα	
ἀλώπηξ	a fox
ἀμ	
ἅμα	at once, at the same time
ἅμαζαι	
Ἀμαζονίδες	
Ἀμαζονίς	
ἀμαθής	unlearned, ignorant, stupid, boorish
Ἀμαλθεία	
ἄμαξα	a wagon, wain
ἀμάρα	a trench, conduit, channel
ἀμάσηι	
ἀμάω	
ἀμβολαδίς	
Ἀμβρυσσῷ	
ἀμείβω	to change, exchange
ἀμέλγω	to milk
ἁμές	
ἀμηχανία	want of means, helplessness, impotence
ἀμι	
ἀμιθρέω	
ἄμιτρος	
Ἀμνισιάδες	
Ἀμνισίδας	
ἀμογητί	without toil or effort
ἀμοιβή'	
ἀμορβός	
ἁμός	
ἀμπλάκημα	an error, fault, offence
ἀμπλακία	
ἄμπωτις	a being sucked back, the ebb-tide
Ἀμυμώνη	
ἀμύνω	to keep off, ward off
ἀμφήριστος	contested on both sides
ἀμφί	on both sides
ἀμφιβαίνω	to go about or around
ἀμφιβάλλω	to throw or put round
ἀμφιβόητος	noised abroad
ἀμφιετής	
ἀμφιλαφής	taking in on all sides, widespreading
Ἀμφιπολίτεω	
ἀμφίπολος	busied about, busy
ἀμφότερος	each or both of two
Ἀμφρυσσῷ	
Ἀμφρυσσῶι	
Ἀμφρυσῷ	
ἄμφω	
ἄν	
ἄνα	
ἀνά	up, upon
ἀναβάλλω	to throw or toss up
ἀνάβλησις	a putting off, delay
ἀναγκάζω	to force, compel
ἀναγκαίη	
ἀναγκαῖος	with or by force
ἀνάγκη	force, constraint, necessity
ἀνάγω	to lead up
ἀνάθεμα	anything devoted to evil, an accursed thing
ἀναθύω	
ἀναιδής	shameless
ἀναίνομαι	to reject with contempt, turn one's back on, spurn
ἀναίρω	to lift up
ἀνακαίω	to light up
ἀνάκειμαι	to be laid up
ἀνακλίνω	to lean
ἀνάκτορον	a palace
ἀναλέγω	to pick up, gather up
ἀναλύω	to unloose, undo
ἀναμίγνυμι	to mix up, mix together
ἀναμιμνήσκω	to remind
ἀνάμνησις	a calling to mind, recollection
ἀνάμπυκες	
ἄναξ	a lord, master
ἀναξηραίνω	to dry up
ἀναπαύω	to make to cease, to stop or hinder from
ἀναπλέω	to sail up, to go up stream
ἄνασσα	a queen, lady, mistress
ἀνάσσω	to be lord, master, owner, to rule, in
ἀναστρέφω	to turn upside down, upset
ἀνά-τανύω	
ἀνατίθημι	to lay upon
ἀνατρέχω	to run back
ἄναυρος	
Ἄναυρος	a torrent
ἀνά-ὕω	
ἁνδάνω	to please, delight, gratify
ἀνδρίς	
ἀνδρογίγαντας	
ἀνδρόω	to rear up into manhood
ἄνειμι	to go up
ἄνεμος	wind
ἀνέραμαι	to love again, love anew
ἀνέραστος	not loved
ἀνέρομαι	to enquire of, question
ἀνέρπω	to creep up or upwards
ἀνευρίσκω	to find out, make out, discover
ἄνη	fulfilment
ἀνηβάω	to grow young again
ἀνήκοος	without hearing
ἀνηλεής	without pity, unmerciful:—
ἀνήρ	a man
ἀνθαιρέομαι	to choose
ἄνθεμα	
ἄνθεμον	costliest
ἀνθέρικος	
ἀνθέριξ	the beard
ἄνθος	a blossom, flower
ἄνθρα	
ἄνθραξ	charcoal, coal
ἄνθρωπος	man
ἀνιάζω	to grieve, distress
ἀνῖαι	
ἀνιάομαι	to cure again, repair
ἀνιαρός	grievous, troublesome, annoying
ἀνιάω	to grieve, distress
ἀνίημι	to send up or forth
ἀνίστημι	to make to stand up, raise up
ἀννί	
ἄνοδος	
ἄνοος	without understanding, foolish, silly
ἀντάω	to come opposite to, meet face to face, meet with
ἄντη	
ἀντημοιβός	
ἄντην	against, over against
ἀντηχέω	to sound or sing in answer
ἀντί	over against, opposite. c. gen.
ἀντιάζω	to meet face to face
ἀντί-ἀνύω	
ἀντιάω	to go for the purpose of meeting
Ἀντίκλεια	
ἄντομαι	to meet
ἄντυξ	the edge or rim of anything round or curved
ἄνω	
ἀξίνη	an axe-head
ἄξιος	weighing as much, of like value, worth as much as
ἄοζος	a servant, attendant
ἀοιδή	song, a singing
ἀοίδιμος	sung of, famous in song
ἀοιδός	a singer, minstrel, bard
ἀολλίζω	to gather together
Ἀονίη	
ἄορ	a hanger, sword
ἀοσσητῆρα'	
ἄπαις	childless
ἀπαιτέω	to demand back, demand
ἀπαμείβομαι	to reply, answer
ἀπαρνέομαι	to deny utterly, deny
ἀπαρχή	the beginning of a sacrifice, the primal offering
ἀπάρχω	
ἅπας	quite all, the whole
ἄπαστος	not having eaten, fasting
ἀπαυγάζω	to beam forth
ἀπεδίλωτοι	
ἀπειθής	disobedient
ἀπειλέω	
ἀπειλή	boastful promises, boasts
ἀπειλητήρ	a threatener, boaster
ἀπεῖπον	to speak out, tell out, declare
Ἀπελλίδος	
ἀπερείδω	to rest, fix, settle
ἀπέρχομαι	to go away, depart from
ἀπεχθής	hateful, hostile
ἀπέχω	to keep off or away from
ἀπημονία	
Ἀπιδανῆες	
ἄπλοια	impossibility of sailing, detention in port
ἄπνοος	without breath, lifeless
ἀπό	from, away from. c. gen.
ἀποβρίζω	to go off to sleep, go sound asleep
ἀποδατέομαι	to portion out to
ἀποδείκνυμι	to point away from
ἀποδέχομαι	to accept from
ἀπό-ἐρῶ	
ἀποθύμιος	not according to the mind, unpleasant, hateful
ἀποκλίνω	to turn off or aside
ἀποκόπτω	to cut off, hew off
ἀποκρύπτω	to hide from, keep hidden from
ἀπόκτισις	
ἀπολάμπω	to shine or beam from
ἀπολείπω	to leave over or behind
ἀπόλλυμι	to destroy utterly, kill, slay
Ἀπόλλων	Apollo
Απόλλωνα	
ἀπολύω	to loose from
ἀπομάσσω	to wipe clean
ἀπονίζω	wash off
ἀποπαύω	to stop or hinder from, make to cease from
ἀποπνέω	to breathe forth
ἀπορούω	to dart away
ἀπορρώξ	broken off, abrupt, sheer, precipitous
ἀποστάζω	to let fall drop by drop, distil
ἀποστρέφω	to turn
ἀποστυγέω	to hate violently, abhor, loathe
ἀποτίθημι	to put away, stow away
ἀποτίνω	to pay back, repay, return
ἄποτος	not drinkable
ἀποτρέπω	to turn
ἀποτρέχω	to run off or away
ἀπό-τρωπάω	
ἀποφέρω	to carry off or away
ἀποχέω	to pour out or off, shed, let fall
ἄππας	
ἅπτω	to fasten, bind fast
ἄπυστος	not heard of
ἄρα	
ἆρα	particle introducing a question
ἄραβος	a gnashing or chattering
ἀραιός	thin, narrow, slight, slender
ἀράομαι	to pray to
ἀραρίσκω	to join, join together, fasten
ἀράσσω	to strike hard, smite
ἀράτειραν	
ἀρατός	accursed, unblest
Ἀραφηνίδας	
Ἀργεῖος	of or from Argos, Argive
Ἄργη	
Ἄργος	
ἀργύρεος	silver, of silver
ἀργυροδίνης	silver-eddying
ἄρδω	to water
Ἄρεος	
Ἀρεστοριδᾶν	
ἀρετάω	to be fit or proper, to thrive, prosper
ἀρετή	goodness, excellence
ἀρήγω	to help, aid, succour
Ἄρης	Ares
ἀρητός	
Ἄρητος	
ἀρίζαλος	
ἀριήκοος	
ἀριθμέω	to number, count or reckon up
ἀριθμός	number
Ἀριμασποί	
Ἀρίμμα	
Ἄρις	
Ἀρισταῖος	
Ἀρίστιππος	
ἄριστος	best
Ἀριστοτέλης	
Ἀρκαδία	
Ἀρκαδίη	
Ἀρκαδικός	
Ἀρκασίδαο	
ἀρκίος	
ἄρκτος	a bear
ἅρμα	a chariot
ἀρνέομαι	to deny, disown
ἄρον	
ἄρος	
ἀροτήρ	a plougher, husbandman
ἀροτριάοντι	
ἀροτριάω	
ἄροτρον	a plough
ἄρουρα	tilled or arable land, seed-land, cornland
ἀρόω	to plough
ἁρπάγιμος	ravished, stolen
ἁρπάζω	to snatch away, carry off
ἁρπακτής	
ἁρπακτύς	
ἀρσενικόν	
ἀρσενικός	
ἄρσην	male
Ἀρσινόη	
Ἄρτεμις	Artemis
ἄρτι	just, exactly
ἀρτύω	to arrange, devise, prepare
ἀρχαῖος	from the beginning
Ἀρχῖν'	
Ἀρχῖνος	
ἄρχμενοι	
ἄρχω	to be first
ἄσβεστος	unquenchable, inextinguishable
Ἀσβυστίδι	
ἀσθμαίνω	to breathe hard, gasp for breath
ἀσίγητος	
Ἀσκλήπιε	
ἀσπαίρω	to pant, gasp, struggle convulsively
ἀσπίς	a round shield
'Ἀσσυρίου	
Ἀστακίδην	
Ἀστακίδης	
ἄσταχυς	an ear of corn
ἀστερίας	
Ἀστερίη	
ἀστέριος	
ἀστήρ	a star
ἄστυ	a city, town
ἀστυφέλικτος	unshaken, undisturbed
ἀσύλλωτοι	
ἀσφαλής	not liable to fall, immoveable, steadfast, firm
Ἀσωπός	
Ἀταλάντη	
ἀτάρ	but, yet
Ἀταρνείτης	
ἀτέλεστος	without end or issue, to no purpose, without effect, unaccomplished
Ἀτέμιδος	
ἄτερ	without
ἀτίζω	not to honour, to hold in no honour
ἀτιμάζω	to hold in no honour, to esteem lightly, dishonour, slight
ἀτιμάω	to dishonour, treat lightly
ἄτιμος	unhonoured, dishonoured
ἀτραπός	a path with no turnings
Ἀτρείδης	
ἀτρεκής	real, genuine
ἄτριχος	
ἄτροπος	unchangeable, eternal
'ἄττα	
ἀττάραγος	
αὖ	
αὐαλέος	dry, parched
αὐγάζω	to view in the clearest light, see distinctly, discern
Αὔγη	
αὖθι	on the spot, here, there
αὖθις	back, back again
αὖλαξ	a furrow
αὐλέω	to play on the flute
αὔλιες	
αὐλίζομαι	to lie in the court-yard
αὖλις	a place for passing the night in, a tent, roosting-place
αὖος	dry
αὔρα	air in motion, a breeze
αὔριον	to-morrow
αὐσταλέος	sunburnt, squalid
αὖτε	again
ἀυτέω	to cry, shout
αὐτῆμαρ	on the self-same day
αὐτίκα	forthwith, straightway, at once
ἀυτμή	breath
αὐτός	self
αὐτοῦ	at the very place, just here, just there
αὐτοχερί	
αὐτόχθων	sprung from the land itself
αὐχήν	the neck, throat
αὔω	
ἀφαιρέω	to take from, take away from
ἀφανής	unseen, invisible, viewless
ἄφαρ	straightway, forthwith, at once, quickly, presently
ἄφατος	not uttered, nameless
ἀφείδεα	
ἀφειδής	unsparing or lavish of
ἀφένοιο	
ἄφενος	riches, wealth, plenty
ἄφετος	let loose, at large, ranging at will
ἄφθογγος	voiceless, speechless
ἀφίημι	to send forth, discharge
ἀφίστημι	to put away, remove
ἀφνειός	rich, wealthy
ἀφνίδιος	unforeseen, sudden
ἀφρικτί	
Ἀφροδίτη	Aphrodite
ἀφρός	foam
ἄφρων	without sense
ἀφύσσω	to draw
Ἀχαιιάς	
Ἀχαιίς	the Achaian land
ἀχάριστος	ungracious, unpleasant, unpleasing
Ἀχελῶιε	
Ἀχελῶιος	
Ἀχελώιος	
Ἀχελῷος	Achelous
ἄχθομαι	to be loaded
ἄχθος	a weight, burden, load
Ἀχιλλεύς	Achilles
ἄχλαινος	without cloak or mantle
ἄχνη	anything that comes off the surface
ἀχράαντος	
ἄχρι	to the uttermost, utterly
ἄψ	backwards, back, back again
ἀψόφητος	noiseless
ἄψοφος	
ἄωτον'	
βάζω	to speak, say
βαθύγειος	
βαθύς	deep or high
βαίνω	to walk, step
βάκτρον	
Βάκχος	Bacchus
βάλλις	
βάλλω	to throw
βάπτω	to dip in water
βαρβαρικός	barbaric, foreign, like a foreigner
βαρέω	to weigh down, depress
βαρύγουνος	heavy-kneed, lazy
βαρύθυμος	heavy in spirit: indignant, sullen
βαρύνω	to weigh down, oppress by weight, depress
βαρύς	heavy
βασίλεια	a queen, princess
βασιλεύς	a king, chief
βασίλη	
Βασιλώ	
βασκανία	slander, envy, malice
Βαττιάδεω	
Βαττιάδης	
Βάττος	stammerer
βέβαλοι	
βέλεμνον	a dart, javelin
βέλος	a missile
βέμβιξ	
βερεκύνθιος	
Βερενίκη	
βία	bodily strength, force, power, might
βιάζω	to constrain
βιάω	to constrain
βιβρώσκω	to eat, eat up
βίος	life
βίοτος	life
βιόω	to live, pass one's life
βλέπω	to see, have the power of sight
βλητός	
βλοσυρός	grim, fierce
βλώσκω	to go or come
βόα	
βοάω	to cry aloud, to shout
βόειος	of an ox or oxen
βοή	a loud cry, shout
βοηδρομέω	to run to a cry for aid, haste to help
βοηδρόμιος	
βοηθόος	hasting to the battle-shout, hasting to battle
βοηθός	assisting, auxiliary
Βοιωτός	a Boeotian
βοιωτοῦ	
βοόστασις	
βορέαο	
Βορέας	the North wind
Βορέης	
βόρειος	from the quarter of the North wind, northern
βόσκω	to feed, tend
βουβόσιον	
βούβρωστις	eating enormously
βουκολέω	to tend cattle
βουλεύω	to take counsel, deliberate, concert measures
βουλή	will, determination
βούλομαι	to will, wish, be willing
Βούρα	
βοῦς	cow
βραχύς	short
βραχυσυλλαβία	
βρέμω	to roar
βρέτας	a wooden image of a god
βρέφος	the babe in the womb
Βριαρῆος	
Βριτόμαρτις	
Βρόντης	thunderer
βυθός	the depth
βυσσόθεν	from the bottom
βυσσός	the depth of the sea, the bottom
βωλευτόν	
βωμός	any raised platform, a stand
Γαῖα	
γαῖα	a land, country
'Γαῖα	
Γαῖον	
γάλα	milk
Γαλάται	
Γαλάτης	
γαληναίη	
γαληναῖος	
γάλοως	a husband's sister or brother's wife, a sister-in-law
γαμέω	to marry
γάμος	a wedding, wedding-feast
Γανυμήδης	
γάρ	for
γαστήρ	the paunch, belly
γε	at least, at any rate
γείνομαι	to be born
γείτων	one of the same land, a neighbour
γελαστύς	
γελάω	to laugh
γενεά	race, stock, family
γενέθλη	race, tock, family
γενέθλιος	of or belonging to one's birth
γενειάς	a beard
γενειάτης	bearded
γένειον	the part covered by the beard, the chin
γενετή	the hour of birth
γενέτης	the begetter, father, ancestor
γένος	race, stock, family
γέντο	he grasped
Γεραίστιον	
γέρας	a gift of honour
γεροντικός	
γέρων	an old man
γῆ	earth
γηγενής	earthborn
γηλεχής	
γημόρος	one who has a share of land, a landowner
γίγας	the Giants
γίγνομαι	to come into being
γιγνώσκω	to learn to know, to perceive, mark, learn
Γλαῦκος	
γλαύξ	the owl
γλυκερός	
γλυκύμαλον	sweet-apple
γλυκύς	sweet
γλωχίν	any projecting point
γναμπτός	curved, bent
γνήσιος	of or belonging to the race
γνωσεῖται	
γνωτός	perceived, understood, known
γοερός	mournful, lamentable
γονεύς	a begetter, father
γόνυ	the knee
Γορτυνίδα	
γράμμα	that which is drawn
γραῦς	an old woman
γράφω	to scratch, scrape, graze
γυῖον	a limb
γυιός	lame
γυίων'	
γυμνός	naked, unclad
γυνή	a woman
γώνατα	
δ	
δ̔	
δαιμόνιος	of or belonging to a δαίμων
δαίμων	a god, goddess
δαίνυεν	
δαίς	
δαίτης	
δαίω	
δάκνω	to bite
δάκος	an animal of which the bite is dangerous, a noxious beast
δακρυόεις	tearful, much-weeping
δάκρυον	a tear
δακρύω	to weep, shed tears
'Δάματερ	
̔Δάματερ	
Δάματερ	
Δαμάτερα	
Δαμάτηρ	
Δάματρα	
Δάματρι	
Δάματρος	
Δανάη	
Δαναοί	the Danaans
Δαναός	
δάνος	money lent, a loan, debt
δανός	burnt, dry, parched
δασύνειν	
δάφνη	the laurel
δάφνινος	
Δάφνις	
δαψιλής	abundant, plentiful
δέ	but
δεδοίκαμεσ'	
δεῖ	it is binding on
δείδω	to fear
δείκνυμι	to bring to light, display, exhibit
δείλαιος	wretched, sorry, paltry
δειλός	cowardly, craven
δεινός	fearful, terrible, dread, dire
δειπνέω	to make a meal
δειρή	the neck, throat
δέκα	ten
δεκάτευμα	
δεκάτη	
δεκατηφόρος	
δέκατος	tenth
Δελφός	
δέμνιον	the bedstead or matrass
δέμω	to build
δένδρεον	a tree
δένδρον	a tree
Δεξαμενός	
δεξιός	on the right hand or side
δεξιτερός	right, the right
δέον	that which is binding, needful, right, proper
δεσποτικός	of or for a master
δεσπότις	
δεύτερος	second
δεύω	
'δέχομαι'	
δέχομαι	to take, accept, receive
δέω	
δή	exactness
Δηιονίδαο	
Δηλιάς	a Delian woman
Δήλιος	Delian
Δῆλος	Delos
Δημήτηρ	Demeter
Δήμητρι	
Δημοδίκης	
δῆμος	a country-district, country, land
δημόσιος	belonging to the people or state
δήν	long, for a long while
δηναιός	long-lived
Δηοῖ	
δηοῖ	
δηοῦς	
Δηώ	Demeter
δήω	to find, meet with
δι	
'δῖα	
διά	through c. gen. through, by means of c. acc.
Δῖα	
διαβαίνω	to make a stride, walk or stand with the legs apart
διάβροχος	very wet, moist
διά-εἴδομαι	
διά-εἰμί	
διά-ἠμί	
διακριδόν	eminently, above all
διαμετρέω	to measure through, out or off
διαπλέω	to sail across
διαπρύσιος	going through, piercing
διατρέχω	to run across or over
διάτριχα	in three divisions, three ways
διαυγής	transparent
δίαυλος	a double pipe
διαφαίνω	to shew through, let
διδάσκω	to teach
δίδημι	to bind, fetter
Διδύμη	
διδυμητόκος	
δίδυμος	double, twofold, twain
δίδωμι	to give
διέβενεν	
διείρομαι	to question closely
διερός	fresh, active, nimble
διέρχομαι	to go through, pass through
δίζημαι	to seek out, look for
δίζω	to be in doubt, at a loss
Δίη	
διίστημι	to set apart, to place separately, separate
δικάζω	to judge, to give judgment on
δικασπόλος	one who administers law, a judge
δικεῖν	to throw, cast
δίκη	custom, usage
Δικταῖαι	
Δικταίηισιν	
Δικταῖος	
Δίκτυνα	
δίκτυον	a casting-net, a net
δίκτυς	
Δίκων	
Δινδυμήνη	
δίνη	a whirlpool, eddy
δίνω	to thresh out on the
διό	wherefore, on which account
Διοκλείδης	
'Διοκλέοσ'	
Διομήδης	Jove-counselled;
Δῖον	
Διόνυσος	Dionysus
δῖος	god-like, divine
Δίος	
Δῖος	
Διοφῶν	
διπλόος	twofold, double
Δίρκη	
δίς	twice, doubly
δίσκος	a
διφάω	to search after
δίφρας	
δίφρος	the chariot-board
δίχα	in two, asunder
διχοστασία	a standing apart, dissension
διψαλέος	thirsty
διψάσας	
διωκτύς	
διώκω	to pursue
Δίων	
δοιή	doubt, perplexity
δοιός	
δοκεύς	
δοκέω	videor mihi, to think, suppose, imagine, expect
Δολίχη	
δολιχός	long
δόμος	a house
δορκαλίς	made of the vertebrae of an antelope
δορκάς	a kind of deer
δόρξ	
δόρυ	a stem, tree
'δός	
δοτα	
δότης	
δοῦλος	a born bondman or slave
δοῦπος	any dead, heavy sound, a thud
δράγμα	as much as one can grasp, a handful, truss
δρᾶμα	a deed, act
δράσσομαι	to grasp
δράω	to do
δρηστήρ	a labourer, working man
δρόμος	a course, running, race
δρυμός	an oak-coppice;
δρῦς	a tree
δς	
δύη	woe, misery, anguish, pain
δυθμή	
δύναμαι	to be able, capable, strong enough
δύο	two
δυομένων'	
δυσαής	ill-blowing, stormy
δύσερως	sick in love with
δυσήροτος	
δυσμενέων	bearing ill-will, hostile
δυσμενής	full of ill-will, hostile
δυστοκεύς	an unhappy parent
δύω	to strip off
δυώδεκα	twelve
δωδεκέτης	twelve years old
Δωδώνηθι	
δῶλαι	
δῶμα	a house
δωμάω	to build
Δωριεύς	a Dorian, descendant of Dorus
δῶρον	a gift, present
Δώτιον	
δώτωρ	
ἕ	sui.
ἐ	
ἑα	
ἔα	ha! oho!
ἑαδό	
ἐάν	if haply
ἔαρ	spring
ἑαυτοῦ	itself, absolutely
ἐάω	to let, suffer, allow, permit
ἔβαλεσ'	
ἑβδομάκις	
ἔβραμεν	
ἔβρος	
ἐγγύθι	hard by, near
ἐγείρω	to awaken, wake up, rouse
ἐγηροκόμει	
ἐγκατατίθεμαι	put
ἐγχέω	to pour in
ἔγχος	a spear, lance
ἐγώ	ego
ἐγώγε	
ἐδέθλιον	
ἔδεθλον	a seat, abode
ἔδεσμα	meat
ἔδοιεν'	
ἕδος	a sitting-place
ἕδρα	a sitting-place
ἔδω	to eat
ἕζομαι	to seat oneself, sit
ἔθειρα	hair
ἐθελημός	willing, voluntary
ἐθέλω	to will, wish, purpose
ἐθήσαο	
ἔθος	custom, habit
ἔθω	to be accustomed
εἰ	whether.
ει	
'εἰ	
εἱαμενή	a river-side pasture, meadow
εἶδαρ	food
εἴδομαι	are visible, appear
εἶδον	to see, perceive, behold
εἶδος	that which is seen, form, shape, figure
εἰδύλλιον	a short descriptive poem
εἶεν	well!
εἴθε	would that!
εἰκάζω	to make like to, represent by a likeness, portray
εἰκάς	the twentieth day of the month
εἴκοσι	twenty
εἴκω	to yield, give way, draw back, retire
εἰκών	a likeness, image, portrait
εἰλαπιναστής	a feaster, quest, boon-companion
εἰλαπίνη	a feast or banquet
Εἰλείθυια	Ilithyia
Εἰλείθυιον	
Εἰλήθυια	
εἴλω	to roll up, pack
εἶμι	to go
εἰμί	to be, to exist
εἰναετιζόμεναι	
εἰνάλιος	
εἰνάτερες	sisters-in-law
εἰνέτεας	
εἴπερ	strengthd. for
εἶπον	to speak, say
εἶπος	
εἰρήνη	peace, time of peace
Εἰρήνη	
εἷς	
εἰς	into, to c. acc.
εἰσαίω	to listen or hearken to
εἰσακούω	to hearken or give ear to one
εἴσειμι	to go into
εἰσέρχομαι	to go in or into, enter
εἰσέτι	still yet
εἰσίζομαι	to sit down in
εἰσ-κυλίνδω	
εἰσόκε	until
εἰσ-ὀψάομαι	
εἰσ-σεύω	
εἴσω	to within, into
εἴτε	
ἐκ	from out of
ἑκαβολίαι	
Ἑκαέργη	
Ἑκάεργος	the far-working
ἑκάς	far, afar, far off
ἕκαστος	every, every one, each, each one
ἑκατόν	a hundred
ἐκβαίνω	to step out of or off from
ἔκβολος	cast out of
ἔκγονος	born of, sprung from
ἐκεῖθεν	from that place, thence
ἐκεῖνος	the person there, that person or thing
ἐκεῖσε	thither, to that place
ἑκηβολία	skill in archery
ἐκ-θρῴσκω	
ἐκκεραΐζεισ'	
ἐκκόπτω	to cut out, knock out
ἐκλύω	to loose, release, set free, from
ἑκούσιος	voluntary
ἔκπαγλος	terrible, fearful
ἐκτερέιξαν	
ἕκτος	sixth
ἐκφέρω	to carry out of
ἐκφεύγω	to flee out or away, escape
ἑκών	willing, of free will, readily
ἐλαία	the olive-tree
ἔλαιον	olive-oil
ἔλαιος	the wild olive
ἐλατήρ	a driver
ἐλαύνω	to drive, drive on, set in motion
ἐλαφηβολία	a shooting of deer
ἔλαφος	a deer
ἐλαφρίζουσι	
ἐλαφρός	lightly, buoyantly
ἔλαχος	
ἔλεγος	a song of mourning, a lament
ἔλεγχος	a cross-examining, testing
ἐλέγχω	to disgrace, put to shame
ἐλεέω	to have pity on, shew mercy upon
ἐλεημοσύνη	pity, mercy: a charity, alms
Ἐλείθυια	
ἐλελίζω	
ἑλένη	
Ἑλένη	
ἔλεος	pity, mercy, compassion
Ἐλευσῖνι	at Eleusis
Ἐλευσίς	Eleusis, an old city of Attica
ἑλίκη	
Ἑλίκη	
Ἑλικών	Helicon
Ἑλικωνιάδες	the dwellers on Helicon, the Muses
ἐλινύω	to keep holiday, to take rest, be at rest, keep quiet, stand idle
ἑλίσσω	to turn round, to turn
ἑλκέω	to drag about, tear asunder
́Ελκος	
ἕλκος	a wound
ἕλκω	to draw, drag
ἑλλά	
Ἑλλάς	Hellas
Ἕλλην	Hellen
Ἐλλοπίευς	
ἐλλοφόνον	
ἐλπίς	hope, expectation
ἔλπω	to make to hope
ἐλύω	to roll round
ἐμβάλλω	to throw in, put in
ἐμετός	
ἐμέω	to vomit, throw up
ἐμμάσσομαι	
ἔμμορος	partaking in, endued with
ἐμός	mine
ἔμπαλιν	backwards, back
ἔμπας	notwithstanding, nevertheless
ἐμπέραμος	skilled in the use of
ἐμπλέκω	to plait or weave in
ἔμπλην	besides, except
ἔμπορος	one who goes on shipboard as a passenger
ἔμπυρος	in the fire
'ἐν	
ἐν	in, among. c. dat.
ἐνάλιος	in, on, of the sea
ἐνάσς	
ἐνδέξιος	towards the right hand, from left to right
ἐνδέω	
ἔνδιον	
ἔνδιος	at midday, at noon
ἔνδοθι	within, at home
ἔνδοι	
ἐνδόμυχος	in the inmost part of a dwelling, lurking within
ἐνδρομίς	a high shoe
ἐνδυτός	put on
ἐνέζομαι	to have one's abode in
ἕνεκα	on account of, for the sake of, because of, for
ἐνέκλασσας	
ἐνέπω	to tell, tell of, relate, describe
ἔνερθε	from beneath, up from below
ἐνεσία	a suggestion
ἐνέχω	to hold within
ἐνθ	
ἔνθα	there
ἐνθάδε	thither, hither
ἔνθεν	on the one side
ἐν-θρῴσκω	
ἐνιαύσιος	of a year, one year old
ἐνιδρύω	to set in
ἐνίημι	to send in or into
Ἔνναι	
ἐνναίω	to dwell in
ἐννάσαντο	
ἐννέα	nine
ἐννεσία	
ἕννυμι	to put clothes on
ἐνόπλιος	a war-tune, march
ἕνος	belonging to the former of two periods, last year's
ἐνστηρίζω	to fix in
ἔντεα	fighting gear, arms, armour
ἐντελής	complete, full
ἐντίθημι	to put in or into
ἐντρίβω	to rub in or into
Ἐνυώ	Enyo
ἐξαιρέω	to take out of
ἐξαίφνης	on a sudden
ἐξάλλομαι	to leap out of or forth from
ἐξάνειμι	to rise from the
ἐξανίημι	to send forth, let loose
ἐξαπίναιος	sudden, unexpected.
ἐξαπίνης	
ἔξαρχος	a leader, beginner
ἔξειμι	to go out, come out
ἐξελαύνω	to drive out from
ἐξερύω	to draw out of
ἐξέτασις	a close examination, scrutiny, review
ἐξέτι	even from
ἑξήκοντα	sixty
ἐξότε	from the time when
ἔξοχος	standing out
ἔοικα	to be like
ἑός	his, her own
ἐπάγω	to bring on
ἐπαείδω	to sing to or in accompaniment
ἐπαινέω	to approve, applaud, commend
ἐπαίσσω	to rush at or upon
ἐπακτήρ	a hunter
ἐπαοιδή	
ἐπεί	after that, after (postquam), since, when (quum)
ἐπείγω	to press down, weigh down
ἐπεῖδον	to look upon, behold
ἔπειμι	to be upon
ἐπεῖπον	to say besides
ἔπειτα	thereupon
ἐπέρχομαι	to come upon, come near, come suddenly upon
'ἔπεσ'	
ἔπεσεσ'	
ἐπετήσιος	from year to year, yearly
ἐπέχω	to have or hold upon
ἐπήκοος	
ἐπηύτησε	
ἐπί	on, upon with gen., dat., and acc.
ἐπί-βάζω	
ἐπίβαθρον	a passenger's fare
ἐπιβάλλω	to throw or cast upon
ἐπί-βρωμάομαι	
ἐπιγιγνώσκω	to look upon, witness, observe
ἐπίγραμμα	an inscription
Επιγράμματα	
ἐπιδαίσιος	
ἐπιδείκνυμι	to exhibit as a specimen
ἐπίδειξις	a shewing forth, making known
ἐπιδέξιος	towards the right
ἐπίδεξις	
ἐπιδημέω	to be at home, live at home
ἐπίδημος	popular, current
ἐπίδρομος	that may be overrun
ἐπιέννυμι	to put on besides or over
ἐπιθυμήτειρα	
ἐπίκηρος	subject to death, perishable
ἐπικηρος	
ἐπικληρόω	to assign by lot
ἐπίκλητος	called upon, called in as allies
ἐπικουρέω	to act as an ally
ἐπικραίνω	to bring to pass, accomplish, fulfil
Ἐπικύδης	
ἐπικωμάζω	to rush in like revellers, to make a riotous assault.
ἐπιλέγω	to choose, pick out, select
ἐπιλήθω	to cause to forget
ἐπιμαίνομαι	to be mad after, dote upon
ἐπιμέμφομαι	to cast blame upon
ἐπίμεστος	
ἐπιμηλάδες	
ἐπιμίσγω	
ἐπιμύζω	to murmur at
ἐπιμύω	to wink
ἐπινέμω	to allot, distribute
ἐπινεύω	to nod
ἐπινέω	
ἐπινήχομαι	to swim upon
ἐπιπλέω	to sail upon or over
ἐπιπνέω	to breathe upon, to blow freshly upon
ἐπιπορπίς	
ἐπιρραίνω	to sprinkle upon or over
ἐπισκέπτομαι	
ἐπίσκοποσ'	
ἐπίσταθμος	at the door
ἐπίσταμαι	to know
ἐπιστάτη	
ἐπιστείβω	to tread upon, stand upon
ἐπιτρέπω	to turn towards
ἐπιφθέγγομαι	to utter after or in accordance
ἐπί-ψοφέω	
ἕπομαι	
ἐποπτεύω	to look over, overlook, watch
ἔπος	a word
ἐπόψιος	full in view, conspicuous
ἔποψις	a view over
ἑπτά	seven
ἑπτάμυχος	
ἑπτάς	
ἐπῳδή	a song sung to or over: an enchantment, charm, spell
ἐπωμίς	the point of the shoulder
ἔπωνε	
ἐπωνυμία	a surname, name given after
ἐπωνύμιος	called by the name of
ἔραζε	to earth, to the ground
ἔραμαι	to love, to be in love with
ἔρανος	a meal to which each contributed his share
ἐραστής	a lover
ἐραστός	beloved, lovely
ἐράω	
ἐργάζομαι	to work, labour
ἔργμα	a work, deed, business
ἔργνυμι	to confine
ἔργον	work
ἔργω	
ἔρδω	to do
ἐρείδω	
ἔρεισις	
ἐρέσσω	to row
ἐρέτης	a rower
ἔρευθος	
ἐρέω	to ask, enquire
ἐρῆμος	desolate, lone, lonely, lonesome, solitary
ἐριδαίνω	to wrangle, quarrel, dispute
ἐρίζω	to strive, wrangle, quarrel
ἔρις	strife, quarrel, debate, contention
ἔριφος	a young goat, kid
ἕρκος	a fence, hedge, wall
Ἑρμῆς	Hermes
ἔρνος	a young sprout, shoot, scion
ἔρομαι	to ask, enquire
ἔρος	
ἑρπετόν	a walking animal, quadruped
ἕρπω	to creep, crawl
ἔρρω	to go slowly, wander about
ἔρσα	dew
ἐρύκω	to keep in, hold back, keep in check, curb, restrain
Ἐρύμανθος	
ἐρυμνός	fenced, fortified
'Ἐρυσίχθονα	
Ἐρυσίχθων	
Ἐρυσίχθων'	
ἐρύω	to drag along the ground, drag, draw
ἔρχεο'	
ἔρχομαι	to come or go
ἐρῶ	I will say or speak
ἐρωέω	to rush, rush forth
ἐρώμενος	one's love
ἔρως	love
ἐσθίω	to eat
ἐσθλός	good
ἔσθω	to eat
ἐσομ	
'Ἕσπερε	
ἑσπέριος	at even, at eventide
'Εσπερῖται'	
ἕσπερος	of or at evening
ἔσσαν	
ἐσσῆνα	
ἐσσομ	
ἔστε	up to the time that, until
ἐστἐ	
ἑστία	the hearth of a house, fireside
Ἑστία	Vesta
ἑστιάω	to receive at one's hearth or in one's house: to entertain, feast, regale
ἕστιος	
ἐσχατάω	to be at the edge, on the border
ἐσχατιά	the furthest part, edge, border, verge
ἔσχατος	outermost
ἔσω	to the interior
ἔται	
ἑταίρα	a companion
ἑταιρέω	to keep company
ἑταιρίζω	to be a comrade
ἑταῖρος	a comrade, companion, mate
ἐτεός	true, real, genuine
ἕτερος	one of the
ἔτης	clansmen
ἔτι	yet, as yet, still
ἑτοιμάζω	to make or get ready, prepare, provide
ἑτοῖμος	at hand, ready, prepared
ἔτος	a year
εὖ	well
εὐαγέω	to be pure, holy
εὐαγής	
εὐάγκειαν	
εὐαγορία	
εὐαής	well ventilated, fresh, airy
εὐαίνετος	
εὐαίων	happy in life
εὐάντησον	
Εὐβοίηθε	
Εὐβοίηθεν	
εὔβοτος	with good pasture
εὐγήρως	
εὐγμα	
εὖγμα	a boast, vaunt
εὐδαίμων	blessed with a good genius;
Εὔδημος	
εὕδω	to sleep, lie down to sleep
εὐέστιος	
εὐηπελία	
Εὐηρείδα	
εὐήχης	
Εὐθυμένης	
εὐθύς	
εὐκαμπής	well-curved, curved
εὔκυκλος	well-rounded, round
εὔλοχος	helping in childbirth
εὐμάθεια	readiness in learning, docility
εὐμειδής	
Εὐμήδης	
εὔμοιρος	blest with possessions
Εὐξίθεος	
εὔορκος	keeping one's oath, faithful to one's oath
εὐρέιος	
Εὔριπος	
εὑρίσκω	to find
εὖρος	breadth, width
εὐρυάνασσα	
Εὐρύπυλος	
εὐρύς	wide, broad
Εὔρυτος	
Εὐρώτης	
ἐύς	good, brave, noble
εὐσεβέω	to live or act piously and religiously
εὐσεβής	righteous
εὔσκοπος	sharp-seeing, keen-sighted, watchful
εὐστοχία	skill in shooting at a mark, good aim
εὖτε	when, at the time when
εὔτεκνος	blest with children
εὐτοκία	happy child-birth
εὔτυκος	ready
εὔυδρος	well-watered, abounding in water
εὔυμνος	celebrated in hymns
εὐφημέω	to use words of good omen
εὐχαίτης	with beautiful hair
εὐχή	a prayer, vow
εὔχομαι	to pray, offer prayers, pay one's vows, make a vow
εὐώδης	sweet-smelling, fragrant
εὐῶπις	fair to look on
εὐώψ	fair to look on
ἔφεδρος	sitting or seated upon
ἐφέζομαι	to sit upon
ἔφεισατο	
ἐφέπω	to go after, follow, pursue
Ἔφεσος	
ἐφετμῆι'	
ἐφήκω	to have arrived
ἐφίζω	to set upon
ἐφίημι	to send to
ἐφίστημι	to set or place upon
ἐφυμνέω	to sing or chant after or over
ἐφύμνιον	
ἐφύπερθε	above, atop, above
Ἔφυρα	
Ἐφύρα	Ephyra
Ἐφύρηνδε	
Ἐχέμμα	
ἐχθαίρω	to hate, detest
ἐχθέω	
ἔχθος	hate, hatred
ἐχθρός	hated, hateful
ἔχθω	to hate
Ἐχινάδες	
Ἐχῖναι	the islands in the Ionian sea
ἔχις	an adder, viper
ἔχω	to have or to hold
ἑψιάομαι	to play with pebbles
ἕως	until, till
ζάω	to live
ζείοντα	
ζευγίτης	yoked in pairs
ζευγῖτις	
ζεῦγλα	
ζεύγλη	the strap or loop of the yoke
ζεύγνυμι	to yoke, put to
Ζεύς	Zeus
ζεφυρῖτις	
Ζέφυρος	Zephyrus, the west wind
ζέω	to boil, seethe
ζηλήμων	jealous
ζορκός	
ζωή	a living
ζώνη	a belt, girdle
ζώννυμι	to gird
ζωός	alive, living
ζωστήρ	a girdle
ζώω	
η	
ἦ	in truth, truly, verily, of a surety
ᾗ	which way, where, whither, in or at what place
ἤ	
ἡγεμόνην	
ἡγέομαι	to go before, lead the way
ἠδέ	and
ἤδη	by this time, before this, already
ἥδομαι	to enjoy oneself, take delight, take one's pleasure
ἦδος	delight, enjoyment, pleasure
ἡδύς	sweet
ἠέ	
ἠέλιος	
ἦθος	an accustomed place
ηι	
ἠίθεος	a youth just
ηις	
ηισι	
ἥκω	to have come, be present, be here
ἠλαίνω	to wander, stray
ἠλέματος	idle, vain, trifling
'Ἥλιε	
ἤλιθα	enough, sufficiently
ἧλιξ	of the same age
ἥλιος	the sun
Ἥλιος	
ἧμαι	to be seated, sit
ἦμαρ	day
ἡμέρα	day
ἥμερος	tame, tamed, reclaimed
ἡμέτερος	our
ἠμί	I say
ἡμιθνής	
ἥμισυς	half
ἡμός	
ἦμος	at which time, when
Ἡν	
ἤν	see! see there! lo!
ἠνεμόεις	windy, airy
'ἠνίδε	
ἡνίκα	at which time, when
ἠοῖος	morning
ἤπειρος	terra-firma, the land
ἠπειρωτικός	continental
ἤπιος	gentle, mild, kind
́Ηρα	
Ἥρα	Hera
Ἡράκλεα	
Ἡρακλέης	Heracles
Ἡράκλειτε	
Ἡρακλῆι	
'Ἥρη	
́Ηρη	
ἦρι	early
ἡρωίνη	a heroine
ἡρωίς	
́Ηρως	
Ἡσίοδος	
ἡσυχία	stillness, rest, quiet
ἡσύχιος	still, quiet, at rest, at ease
ἥσυχος	still, quiet, at rest, at ease, at leisure
ἦτορ	the heart
Ἥφαιστος	Hephaestus
ἠχέω	to sound, ring, peal
ἠχή	a sound or noise
ἧχι	where
ἦχος	
ἠχώ	a sound
Ἠχώ	
Ἠῶιοι	
ἠώς	the morning red, daybreak, dawn
θαλάμη	a lurking-place, den, hole, cave
θάλαμος	an inner room or chamber
θάλασσα	the sea
θαλασσοπορεῖ	
Θάλης	
θαμινός	frequent
θάμνος	a bush, shrub
θάνατος	death
θανατόω	to put to death
θάπτω	to pay the last dues to a corpse, to honour with funeral rites
θαρσαλέος	bold, of good courage, ready, daring, undaunted
θαρσέω	to be of good courage, take courage
θάρσος	courage, boldness
θασεῖσθε	
θάσσων	quicker, swifter
Θαύμας	
θεά	a goddess
θέα	a seeing, looking at, view
θέαινα	a goddess
θεαίτητος	
θεάομαι	to look on, gaze at, view, behold
θείνω	to strike, wound
Θειοδάμας	
θεῖος	
θέμεθλα	the foundations, lowest part, bottom
θεμείλια	
θέμειλον	
θέμις	that which is laid down or established by custom
θεμιτός	allowed by the laws of God and men, righteous
Θεναί	
Θενάς	
Θεόκριτος	
θεομορία	destiny
θεοπρόπος	foretelling things by a spirit of prophecy, prophetic
θεός	God
θεράπων	a waiting-man, attendant
θερισμός	reaping-time, harvest
θερμάστρα	
θέρος	summer, summertime
θέρω	to heat, make hot
θέσαν	
θέσμιος	according to law, lawful
Θεσπίευς	
Θεσπιεύς	
θεσπίζω	to declare by oracle, prophesy, divine
Θεσπίη	
Θεσπίης	
Θεσπιός	
Θεσσαλία	
Θεσσαλίη	
Θεσσαλικός	
Θεσσαλίς	
Θεσσαλός	a Thessalian
Θέτις	Thetis
θευμορίη	
θεύς	
θέω	to run
θεωθείς	
θεωρίς	a sacred ship, which carried the
θεώτερος	more divine
Θῆβαι	Thebes
Θήβη	
̔Θήβη	
θηητός	gazed at, wondrous, admirable
θῆλυς	female
θήρ	a wild beast, beast of prey
Θήρα	
θηρατήρ	a hunter
θηράω	to hunt or chase
Θήρη	
Θήρης	
θηρήτειρα	
θηρίον	a wild animal, beast
θηρίον'	
'Θῆρις	
Θησεύς	Theseus
θίς	a heap
θλίβω	to press, squeeze, pinch
θνήισκειν	
θνήισκουσι	
θνήσκω	to die, be dying
θνητός	liable to death, mortal
θοάζω	to move quickly, ply rapidly
θοάς	
θοός	swift
θοῦρος	rushing, raging, impetuous, furious
Θρᾷξ	a Thracian;
θριαί	
θρίξ	the hair of the head
θρόνον	flowers embroidered on cloth, patterns
θρόνος	a seat, chair
θυγάτηρ	a daughter
θυμαρής	suiting the heart
θυμάρμενος	
θυμός	the soul
θυμόω	to make angry
θυόεις	laden with incense, odorous, fragrant
θυόω	to fill with sweet smells
θύρετρα	a door
θυωρός	
ι	
ἰά	a voice, cry
ἴαμβος	an iambus
ἰάομαι	to heal, cure
Ἰάονες	the Ionians
Ἰάσιος	
ἰατρός	one who heals, a mediciner, physician or surgeon
ἰαχέω	to cry, shout, shriek
ἰάχω	to cry, shout, shriek
Ἰάων	
Ἰδαῖος	of Ida
ἰδέ	and
Ἴδη	Ida
ἴδη	a timber-tree
Ἴδης	
ἴδιος	one's own, pertaining to oneself
ἴδρις	experienced, knowing, skilful
ἱδρόω	to sweat, perspire
ἱδρύω	to make to sit down, to seat
ἱδρώς	sweat
ἱερά	
ἱεραί	
Ἱερέη	
ἱερεύς	a priest, sacrificer
ἱερή	
ἱερόν	
ἱερός	super-human, mighty, divine, wonderful
'ἱερός	
ἱερόω	to hallow, consecrate, dedicate
ἵζω	to make to sit, seat, place
'ἱή	
ἱή	
ἵημι	to set a going, put in motion
Ἴης	
ἴθμα	a step, motion
ἰθύνω	to make straight, straighten
ἱκανός	becoming, befitting, sufficing
Ἰκάριος	Icarian
ἴκελος	like, resembling
ἱκνέομαι	to come
ἴλαος	propitious, gracious
ἵλαος	
ἴλη	a crowd, band, troop
ἵλημι	be gracious!
ἰλυός	
Ἰμβρασίη	
ἱμερόεις	exciting love or desire, lovely, delightsome, charming
ἵμερος	a longing or yearning after
ἵνα	in that place, there
Ἰναχίης	
Ἰναχίω	
Ἰναχιώνης	
Ἴναχος	
Ἰνωπός	
ἰοδόκος	holding arrows
Ἰόλειαν	
ἰός	
ἰουλίς	
ἴουλος	the young hair at the side of the face, the whiskers
ιπειωι	
Ἱππαίου	
Ἱππακόν	
ἱππεία	a riding or driving
ἵππειος	of a horse or horses
ἱππημολγοί	the mare-milkers
ἵππος	a horse, mare
Ἱππός	
Ἱππώ	
ἵππων'	
ἶρις	
Ἶρις	Iris
ἱρός	
ἴς	a muscle
ἰσαῖος	
ἰσάριθμος	equal in number.
ἰσθμός	any narrow passage
Ἴσις	
Ἰσμηνός	
ἴσος	equal to, the same as
ἵστημι	to make to stand
ἰσχάς	a dried fig
ἰσχίον	the hip-joint
ἰσχύς	strength
Ἰταλία	
ἴτης	
ἴτον	
Ἰτωνιάς	
ἰχθυβολεύς	
ἴχνια'	
ἴχνιον	a track, trace, footstep
ἴχνος	a track, footstep
Ἰώλκιον	
Ἰωνίς	
ἰωνίς	
Κάβειροι	the Cabeiri
Καδμηίς	
Κάδμος	Cadmus
καθαρός	clear of dirt, clean, spotless, unsoiled
καθέρπω	to creep down
κάθημαι	to be seated
καθίζω	to make to sit down, seat
καθίημι	to send down, let fall
καθύπερθε	from above, down from above
καί	and
καινόω	to make new, innovate
καίνω	to kill, slay
καίπερ	although, albeit
Καίρατος	
καίριος	in or at the right place
καιρός	due measure, proportion, fitness
καίω	to light, kindle
κακογείτων	a bad neighbour or a neighbour to
κακόγλωσσος	ill-tongued
κακός	bad
κακόω	to treat ill, maltreat, afflict, distress
κάλαθος	a vase-shaped basket
καλάμη	the stalk or straw of corn
καλέω	to call, summon
καλιά	a wooden dwelling, hut, barn
καλίστρα	
καλιστρέω	
καλλι	beautiful
Καλλίγνωτος	
Καλλίμαχος	
κάλλιον	
Καλλίστιον	
Καλλίχορον	
καλλίχορος	with beautiful places
καλός	beautiful, beauteous, fair
κάλπις	a vessel for drawing water, a pitcher or ewer
Καλυδώνιος	
καμινόθεν	
κάμνω	to work
Κανάκη	
καναχηδά	with a sharp loud noise
κανθι	
Κανωπίται	
καπνός	smoke
κάπρος	the boar, wild boar
κάρα	the head
Καρίων	
Καρνειάδες	
Καρνεῖε	
Καρνεῖον	
καρτερός	strong, staunch, stout, sturdy;
κάρτος	strength, vigour, courage
Κάστωρ	Castor
κατά	down, downwards, with gen. or acc.
καταβλέπω	to look down at
καταβόσκω	to feed flocks upon or in
καταδέομαι	
καταδέω	
κατά-δύω	
κατά-ἕζομαι	
καταθνήσκω	to die away, be dying
καταθυμέω	to be quite cast down, lose all heart
καταθύμιος	in the mind or thoughts
κατᾶιξ	
κατά-καθέζομαι	
κατακλάω	to break down, break short, snap off
κατακληῖδα	
κατά-κροταλίζω	
καταλέγω	to lay down
κατανεύω	to nod assent
καταρρέζω	to pat with the hand, to stroke, caress
καταρρέω	to flow down
κατατρέχω	to run down
καταχεύω	
κάτειμι	to go or come down
κατεναίρομαι	to kill, slay, murder
κατέπεφνον	to kill, slay
κατεργάζομαι	to effect by labour, to achieve, accomplish
κατέρχομαι	to go down from
κατέχω	to hold fast
κατηφέω	to be downcast, to be mute
κατισχαίνοντι	
κάτοπτρον	a mirror
κάτος	
κατουδαῖος	under the earth
κατοχεύς	
κάτω	down, downwards
κατωμάδιος	from the shoulder
κατώτερος	
καυθι	
Καύκων	
Καύκωνες	
καυρι	
Καύστριος	of or from the river Cayster
κεῖμαι	to be laid
κείρω	to cut
κεῖται'	
κεκμηυῖαι	
Κεκροπίδαι	
Κεκροπίηθεν	
Κέκροψ	Cecropian, Athenian
Κελάδων	
κέλευθος	a road, way, path, track
κέλομαι	to urge on, exhort, command
Κελτός	
κεμάς	a young deer, a pricket
κενός	empty
κενόω	to empty out, drain
Κένταυρος	a Centaur
κεραελκής	
κεραός	horned
κέρας	the horn of an animal
κερατώδης	
κεραυνός	a thunderbolt
κεραυνόω	to strike with thunderbolts
κερδαίνω	to gain, derive profit or advantage
κερδαλέος	having an eye to gain, wily, crafty, cunning
κέρδος	gain, profit, advantage
Κέρκυρα	Corcyra
κερόεις	horned
Κερύνειος	
Κερχνίς	
κευθμός	
κεφαλή	the head
Κέφαλος	
κήδω	to trouble, distress, vex
κηρίον	a honeycomb
κῆρυξ	a herald, pursuivant, marshal, public messenger
κηρύσσω	to be a herald, officiate as herald
Κιθαιρών	
κίθαρις	
κιθαρισμός	
κικλήσκω	to call, summon
Κιμμερικός	Cimmerian
Κιμμέριοι	the Cimmerians
Κιμμέριος	
Κίμων	
κίνυμαι	to go, move
κινύρομαι	to utter a plaintive sound, lament, wail
κινώπετον	
κισσός	ivy
κιχάνω	to reach, hit
κλαίω	to weep, lament, wail
Κλάριος	
Κλεινίης	
κλείς	that which serves for closing
κλείω	
Κλεόμβροτος	
Κλεόνικε	
κλέω	to tell of, celebrate
κληδών	an omen or presage contained in a word or sound
κλήζηι	
κλήριος	
κλῆρος	a lot;
κληρόω	to appoint
κλίνω	to make to bend, slope
κλύζω	to dash over
Κνίδιος	of or from Cnidos;
Κνωσσός	
κόγχος	
Κοιηίς	
κοῖλος	hollow, hollowed
κόιλος	
κοιμάω	to lull or hush to sleep, put to sleep
κοιμίζω	to put to sleep
κοιρανέω	to be lord or master, to rule, command
κοίτη	the marriage-bed
κόκκος	a grain, seed
κολλάω	to glue, cement
κολούω	to cut short, dock, curtail
κόλπος	the bosom
κόλπου'	
κολπόω	to form into a swelling fold;
κομάω	to let the hair grow long, wear long hair
κομέω	to take care of, attend to, tend
κόμη	the hair, hair of the head
κομίζω	to take care of, provide for
κομπάζω	to vaunt, boast, brag
κόνις	ashes
κόος	
κόπρον	
κόπρος	dung, ordure, manure
κόπτω	to strike, smite, knock down
κόραξ	carrion-crow
κορέω	to sweep, sweep out
κόρη	a maiden, maid, damsel
Κορίη	
κόρις	a bug
κόρος	
κόρση	one of the temples, the side of the forehead
κόρσης	
κορυφάς	
κορυφή	the head, top, highest point;
Κορώνεια	
κοτέω	to bear a grudge against
κοῦρα	
κουρά	a shearing or cropping
Κουράλιος	
κούρητες	young men
κουρίζω	to be a youth
κοῦρος	
κουροτρόφος	rearing boys;
κοῦφος	light, nimble
Κόων	
Κρᾶθιν	
Κράθις	
κραίνω	to accomplish, fulfil, bring to pass
Κραννών	
Κραννώνιος	
κρατερός	strong, stout, mighty
κρατέω	to be strong, mighty, powerful
κρέας	flesh, meat, a piece of meat
κρείοισα	
κρεῖον	a meat-tray, dresser
Κρεῖος	
κρείουσα	
κρείσσων	stronger, mightier, more powerful
Κρείων	
κρείων	a ruler, lord, master
Κρεώφυλος	
Κρηθίδα	
κρημνός	an overhanging bank
κρήνη	a well, spring, fountain
Κρής	a Cretan
Κρηταέες	
Κρηταῖος	
Κρήτη	Crete
Κρήτηθεν	from Crete
κρίνω	to pick out, choose
Κρισσαῖα	
Κριτίης	
κρόκος	the crocus
Κρονίδης	son of Cronus
Κρόνιος	Saturnian, of Cronus or Saturn
Κρόνος	Cronus
κρυμός	icy cold, frost
κρύπτω	to hide, cover, cloak
κρύφα	without the knowledge of
κτείς	a comb
κτῆνος	flocks and herds
κτίζω	to people
κτυπέω	to crash
κτύπος	any loud noise, a crash
κύαθος	a cup
Κύδων	
Κύδωνες	
Κυδώνιος	Cydonian
Κύζικος	of or from Cyzicus
Κυκλάδες	
κυκλάς	round, circular;
κυκλέω	to move round and round, wheel along
κυκλικός	circular
κύκλιος	round, circular
κύκλος	a ring, circle, round
κυκλόω	to encircle, surround
'Κύκλωπες	
Κύκλωψ	a Cyclops
κύκνος	a swan
κυλίνδω	to roll, roll along or down
κύλισσε	
κυλίστρα	a place for horses to roll in
Κυλλήνη	Cyllene, a mountain in Arcadia
κῦμα	anything swoln
κυναγός	a hound-leader
κυνάω	to play the Cynic
κυνηλασία	
Κυνθιάδες	
Κυνθιάδων	
Κύνθος	Cynthus
κυνοδρομία	
κυνοσουρίς	
Κύπρις	Cypris
Κύρβας	
κυρέω	to hit, light upon
Κυρηναῖος	
Κυρήνη	Cyrene
Κύρνος	Cyrnus
κύω	to conceive
κύων	a dog or bitch
κωμικός	
κωνώπιον	
κώρα	
κῶρος	
Λαβδακίδαις	
λαβύρινθος	a labyrinth or maze
λαγχάνω	to obtain by lot, by fate, by the will of the gods
λαγωβολία	
λαγών	the hollow on each side below the ribs, the flank
λαγωός	
λαγῶς	a hare
Λάδων	
λᾶες	
λάθριος	treacherously
λαίφη	
λαῖφος	a tattered garment, rags
Λακεδαιμόνιος	
λάλος	talkative, babbling, loquacious
λαμβάνω	to take
λανθάνω	to escape notice, to be unknown, unseen, unnoticed
λάξις	an allotment of land
λαός	the people
λάπτω	to lap with the tongue
Λάρισα	Larissa
λάσιος	hairy, rough, shaggy, woolly
λάσκω	to ring, rattle, crash
λάω	
λέαινα	a lioness
λέβης	a kettle or caldron
λεγνωτός	
λέγος	
λέγω	
λείβω	to pour, pour forth
λειμών	any moist, grassy place, a meadow, mead, holm
λείπω	to leave, quit
λεξεῖται	
λεοντάγχης	
Λεόντιχος	
Λέπρειον	
λεπταλέος	fine, delicate
λεπτός	peeled, husked, threshed out
λέσχη	a place where people assembled to talk and hear news, a lounge, club-room
λευκαρετανμαν	
λευκόθριξ	white-haired, white
λευκόν	white
λευκός	light, bright, brilliant
Λέχαιον	
λεχαῖος	in bed
λέχριος	slanting, slantwise, crosswise
λεχωίδας	
λεχωίδες	
λεχώιος	of or belonging to child-bed
λεχωίσιν	
λέων	a lion
λήθαιος	of or from Lethe, Lethean
λήθη	a forgetting, forgetfulness
λῆθος	
Ληλάντιον	
Λητοῖ'	
'λητοῖ	
Λητώ	Leto
Λητωιάς	
Λητῷος	of or born from Leto
'Ληφθήσει	
λίαν	very, exceedingly
λιβάς	anything that drops or trickles, a spring, stream
Λιβύη	Libya, the north part of Africa
Λίβυς	a Libyan
λίγειος	
λιγύς	clear, whistling
λιθόλευστος	stoned with stones
λίθος	a stone
λίκνον	a winnowing-fan
λικνοφόρος	carrying the sacred
λιμενοσκόπος	watching the harbour
λιμήν	a harbour, haven, creek
Λίμναι	
λιμνει	
λίμνη	a pool of standing water
λιμός	hunger, famine
λίνον	anything made of flax
Λιπάρα	of Lipara
λιπαρέω	to persist, persevere, hold out
λιπαρός	oily, shiny with oil
λίπος	fat
λίς	
λίσσομαι	to beg, pray, entreat, beseech
λιτή	a prayer, entreaty
λιτός	smooth, plain
λόγος	the word or that by which the inward thought is expressed
λοέσσα	
λοιμός	a plague, pestilence
λοξός	slanting, crosswise, aslant
λουτρόν	a bath, bathing place
λούω	to wash
λοχεία	childbirth, childbed
λοχεῖος	the place of childbirth
λοχεύω	to bring forth, bear
Λύγδαμις	
λύγξ	
λυγρός	sore, baneful, mournful
λύθρον	defilement from blood, gore
λύθρος	
λυκαινίς	
Λυκαῖος	Lycaean, Arcadian
Λυκαονία	in Lycaonian
λύκιον	
Λύκιος	Lycian.
Λύκος	
Λύκτιος	
Λυκωρέος	
λῦμα	the water used in washing, washings, off-scourings, filth
λυμαίνομαι	to treat with indignity, to outrage, to maltreat
λύρα	
λυσαμ	
Λυσανίας	
λυσανίης	ending sorrow
λυσσαμ	
λύχνον	
λύχνος	a portable light, a lamp
λύω	to loose
λῶιστε	
λωίων	more desirable, more agreeable
λῷος	
λωτροχόοι	
μά	in affirmation
μάγειρος	a cook
μαετυρίην	
Μαινάλιος	
Μαίναλον	Mount Maenalus
μαίνομαι	to rage, be furious
μαιόομαι	to deliver
μάκαρ	blessed, happy
μάκαρος	
Μακηδόνι	
μακράν	a long way, far, far away
Μάκρις	
μακρός	long
μάλα	very, very much, exceedingly
μάλη	the arm-pit
μάλιστα	
μᾶλλον	
μᾶλον	
μάνδρα	an inclosed space
μανθάνω	to learn
μανία	madness, frenzy
μαντεῖον	an oracle
μαντεύομαι	to divine, prophesy, presage
μάντις	one who divines, a seer, prophet
μάρμαρον	
μάρμαρος	stone or rock
μάρπτω	to catch, lay hold of, seize
μάρτυς	a witness
μάσσων	longer, greater
μαστός	one of the breasts
ματάω	to be idle, to dally, loiter, linger
μάτη	a folly, a fault
μάτην	in vain, idly, fruitlessly
μάτος	
μάχαιρα	a large knife or dirk
μάχομαι	to fight
μεγαίρω	to look on
μεγάλως	
Μεγαρεύς	a citizen of Megara
Μεγάρη	
μέγας	big, great
μεδέων	a guardian
μεθίημι	to let go, let loose, release
μείλιον	
μείρομαι	to receive as one's portion or due
μείς	a month
μείων	less
μέλαθρον	the ceiling of a room
μελαίνω	to blacken
μελαμψήφις	
μελανέω	
Μελάνιππος	
Μέλας	
μέλας	black, swart
μέλεος	idle, useless
μέλη	
Μέλης	
μελία	the ash
Μελιγουνίς	
μελίζω	to modulate, sing, warble
Μελίη	
μέλισσα	a bee
μελιχρός	honey-sweet
μέλλω	to think of doing, intend to do, to be about to do
μελοίμην'	
μέλος	a limb
μέλπω	to sing of, celebrate with song and dance
μέλω	to be an object of care or thought
μέμφομαι	to blame, censure, find fault with
μέν	on the one hand, on the other hand
Μενέκρατεσ'	
Μενέκρατες	
Μενέξενος	
Μένιππος	
μενοινή	eager desire
Μενοίτης	
μένος	might, force, strength, prowess, courage
μένω	to stay at home, stay where one is, not stir
μερμηρίζω	to be full of cares, to be anxious or thoughtful, to be in doubt
Μεροπηίδα	
μέρος	a part, share
μεσημβρινός	belonging to noon, about noon, noontide
μεσόγαιος	inland, in the heart of a country
μεσόγεια	
μεσόγεως	the inland parts, interior
μέσος	middle, in the middle
μεσσάτιον	
μεσσόγεως	
μέσφα	until
μετά	in the midst of, among with gen., dat., and acc.
μεταί	
μετακιάθω	to follow after
μεταστείχω	to go in quest of
μετατίθημι	to place among
μετάτροπος	turning about, returning
μετέπειτα	afterwards, thereafter
μετόπισθε	from behind, backwards, back
Μετώπη	
μέχρι	to a given point, even so far
μή̓	
μή	not
μηδέ	but not or and not, nor
μήδομαι	to be minded, to intend, resolve
Μήθυμνα	
Μηιόνιον	
μηκέτι	no more, no longer, no further
μηκύνω	to lengthen, prolong, extend
μήκων	the poppy
Μηλιεύς	an inhabitant of Malis
Μηλίς	Malis
μῆλον	
μήν	now verily, full surely
μήποτε	never, on no account
μήπω	not yet
μής	
μήτε	and not
μήτηρ	a mother
μήτις	lest any one, lest anything; that no one, that nothing
μίγνυμι	to mix, mix up, mingle, properly of liquids
Μίκκος	
μικκός	
Μίκκου	
μικρός	small, little
μικτός	mixed, blended, compound
Μικύλος	
Μίλητος	Miletus
Μίμας	
μιμνήσκω	to remind, put
μίμνω	to stay, stand fast
μιν	himself
μινύρομαι	to warble
Μίνως	Minos
μισέω	to hate
μισθός	wages, pay, hire
μισθόω	to let out for hire, farm out, let
μίτρα	a belt or girdle
μνάομαι	to turn one's mind
μνηστεύω	to woo, court, seek in marriage
μογέω	to toil, suffer
μοῖρα	a part, portion
Μοῖρα	
μοιράω	to share, divide, distribute
μόλις	not scarcely
μολπή	the song and dance, a chant or song accompanied by measured movements
μονιός	
μόνος	alone, left alone, forsaken solitary
μορμύσσεται	
μόρον	
μόρος	man's appointed doom, fate, destiny
Μουνιχίη	
μουνόγληνα	
μουνοτόκος	
Μοῦσα	the Muse
μοχθέω	to be weary with toil, to be sore distressed
μοχθηρός	suffering hardship, in sore distress, miserable, wretched
μοχθίζω	to suffer
μύδρος	a mass of red-hot metal
μύζω	to murmur with closed lips, to mutter, moan
'μῦθοσ'	
μῦθος	anything, delivered by word of mouth, word, speech
Μυκαλησσίδες	
μύκημα	a lowing, bellowing, roaring
μύξα	the discharge from the nose
μυρίος	numberless, countless, infinite
μύρον	sweet juice extracted form plants, sweet-oil, unguent, balsam
μῦρος	
μύρσινος	
μύρτον	a myrtle-berry
μύρτος	the myrtle
μυρτούσης	
Μυρτούσσης	
μύρω	to flow, run, trickle
μυσόν	
Μυσός	a Mysian
Μυτιληναῖος	
μυχάς	
μύχατος	
μυχή	
μυχός	the innermost place, inmost nook or corner
μύω	to close, be shut
μωμάομαι	to find, fault with, blame
μῶμος	blame, ridicule, disgrace
ν	
νᾶεν	
'ναί	
ναί	yea, verily
Ναιάς	a Naiad, a river nymph
ναιχί	
ναίω	
Νάξιος	Naxian;
ναός	the dwelling of a god, a temple
νάπη	a wooded vale, dell
ναυαγός	shipwrecked, stranded
Ναυκρατίτης	
ναῦς	a ship
ναύτης	a mate or companion by sea
ναυτίλος	a seaman, sailor
νδικα	
νέατος	the last, uttermost, lowest
νεάω	to plough up anew
νέβρειος	of a fawn
νεβρός	the young of the deer, a fawn
Νέδη	
Νεῖλος	the Nile
νεῖος	
νειός	land ploughed up anew
νεκρός	a dead body, corpse
νέκυς	a dead body, a corpse, corse
νεμεσάω	to feel just resentment, to be wroth at undeserved
νεμεσητός	causing indignation or wrath
νέμεσις	distribution of what is due;
Νέμεσις	
νέμω	to deal out, distribute, dispense
νενίηλος	
νέομαι	to go or come
νέος	young, youthful
νέρθε	
νευρά	a string or cord of sinew, a bowstring
νευράς	
νευρή	
νεῦσις	
νεύω	to nod or beckon
νέφος	a cloud, mass or pile of clouds
νέω	
νηδύς	the stomach
νηέω	to heap, heap or pile up
Νηλεύς	
Νηρεύς	Nereus
νηρός	
νησάων	
νήσος	
νῆσος	an island
νικάω	to conquer, prevail, vanquish
νίκη	victory in battle
Νικίππη	
Νικοτέλην	
'νικῶ'	
νιν	him, her
νίσσομαι	to go, go away
νιφάς	a snowflake
νιφετός	falling snow, a snowstorm
νιφόεις	snowy, snowclad, snowcapt
Νο	
νοέω	mere sight
νόησις	intelligence, thought
νόμιος	of shepherds, pastoral
νομός	a feeding-place
νόμος	anything assigned, a usage, custom, law, ordinance
νόσος	sickness, disease, malady
νοστέω	to come or go back, return
νόστιμος	belonging to a return
νόσφι	aloof, apart, afar, away
νοτεῖ	
νοτερός	wet, damp, moist
νότιος	wet, moist, damp
νότος	the south or south-west wind
νοῦσος	
'Νύμφαι	
νύμφη	a young wife, bride
νυμφήιον	
Νύμφης	
νῦν	now at this very time
νύξ	the night-season or a night
ξαίνω	to comb or card
ξάνθη	
ξάνθοιο	
ξανθός	yellow
Ξάνθος	
ξενίζω	to receive or entertain strangers, to receive as a guest
ξένος	
ξενόω	to make one's friend and guest
ξίφος	a sword
ξύλον	wood
ξυνός	common, public, general, concerning or belonging to all in common
ο	
ὁ	the, that
'ὅ	
ὄαρ	a wife
ὄαρος	familiar converse, fond discourse, chat, talk
ὄγδοος	eighth
ὀδακτάσαι	
ὅδε	this
ὁδεύω	to go, travel
ὁδός	
ὀδούς	
ὀδών	
ὄζος	a bough, branch, twig, shoot
ὄζω	to smell
ὅθεν	from whom
ὅθι	
Ὄθρυς	Othrys
οἶδα	to know
Οἰδιπόδης	
ὀιζυρός	woful, pitiable, miserable
οἴκαδε	to one's home, home, homewards
οἰκεῖος	in or of the house, domestic
οἰκειόω	to make one's own
οἰκείω	
οἰκέω	to inhabit, occupy
οἰκία	a building, house, dwelling
Οἰκιάδαο	
οἰκίζω	to found as a colony or new settlement
οἰκίον	
οἰκιστήρ	
οἴκοι	at home, in the house
οἶκος	a house, abode, dwelling
οἰκτείρω	to pity, feel pity for, have pity upon
οἰκτίζω	to pity, have pity upon
οἰμάω	to swoop or pounce upon
οἴμη	a song, lay
οἶμος	a way, road, path
Οἰνεύς	
οἶνον	
οἶνος	wine
οἷος	such as, what sort or manner of nature, kind
ὄις	ram
οις	
ὀιστευτής	
ὀιστός	an arrow
οἶτος	fate, doom
οἴχομαι	to be gone, to have gone
οἰωνός	a large bird, bird of prey
ὅκα	
ὁκκόσον	
ὀκνέω	to shrink
ὁλάω	
ὄλβιος	happy, blest
ὄλβος	happiness, bliss, weal, wealth
ὀλίγος	few, little, scanty, small
ὄλλυμι	to destroy, make an end of
ὀλολυγή	any loud cry
ὅλοξ	whole, entire, complete
ὀλόπτω	to pluck out, tear out
ὅλος	
Ὄλυμπος	Olympus
ὁμαρτέω	to meet
ὁμαρτῇ	together
ὄμβρος	
ό̓μβρος	heavy rain
Ὁμήρειον	a temple of Homer
Ὁμήρειος	Homeric
ὄμμα	the eye
ὄμνυμι	to swear
ὁμόθηρος	
ὁμοῖος	
ὅμοιος	like, resembling
ὁμοιόω	to make like
ὁμοκλή	a joint call;
ὁμόνοια	oneness of mind or thought, unity, concord
ὁμός	one and the same, common, joint
ὁμότοιχος	having one common wall, separated by a party-wall, contiguous
ὁμοῦ	at the same place, together
ὁμόω	to unite
ὀμφάλιον	
ὀμφάλιος	having a boss, bossy
ὀμφαλός	the navel
ὅμως	all the same, nevertheless, nothwithstanding, still
ὁμῶς	equally, likewise, alike
ὄναρ	a dream, vision in sleep
ὄνειαρ	anything that profits or helps
ὄνειδος	reproach, censure, blame
ὄνειρος	a dream
ὀνίνημι	to profit, benefit, help, assist
ὄνομα	by name
ὀνομαίνω	to name or call by name
ὀνομαστί	by name
ὀνοτός	
ὄντως	really, verily
ὀξύς	sharp, keen
ὁπ	
ὀπαδέω	to follow, accompany, attend
ὀπάζω	to make to follow, send with
ὅπη	by which way
ὄπισθεν	behind, at the back
ὀπισθίδιος	
ὁπλίζω	to make or get ready
ὅπλον	a tool, implement
ὁπόθεν	whence, from what place
ὁπόθι	where
ὁπότε	when
ὅπου	in some places
ὀπτάω	to roast, broil
ὀπτήρια	presents made by the bridegroom on seeing the bride without the veil
ὀπτός	roasted, broiled
ὅπως	as, in such manner as
ὁράω	To see
ὀργάζω	to soften, knead, temper
ὀργάω	to swell with moisture
ὀργή	natural impulse or propension: one's temper, temperament, disposition, nature
ὀρέγω	to reach, stretch, stretch out
ὀρείχαλκος	copper ore
ὀρέστης	
Ὀρέστης	
ὀρεύς	a mule
ὀρθός	straight
ὅρκος	the object by which one swears, the witness of an oath
ὁρκόω	to bind by oath
Ὀρμενίδης	
ὅρμος	a cord, chain
ὄρνις	a bird
ὄρος	a mountain, hill
ὄρπηξ	a sapling, young tree
Ὀρτυγία	quail-island
ὀρχέομαι	to dance in a row
ὅς	this, that;
ὁσάκις	as many times as, as often as
ὁσειγαρνης	
ὅσος	quantus
ὄσσα	a rumour
Ὄσσα	
́Οσσαι	
ὁσσάκις	
ὀσσείοισιν	
ὅστε	who, which
ὀστέον	the
́Οστις	
ὅστις	any one who, anything which
'ὅτε	
ὅτε	when
ὅτι	
ου	
οὐ	not
οὖδας	the surface of the earth, the ground, earth
οὐδέ	but not
οὐδείς	and not one
οὐδέποτε	and not ever or nor ever, not even ever, never
οὐδέπω	and not yet, not as yet
οὐδός	
'οὐκ	
οὐκέτι	no more, no longer, no further
ουκισυνιφησον	
οὖλον	the gums
οὖλος	
οὐλύμπωι	
οὖν	really, at all events
οὕνεκα	on which account, wherefore
Οὖπι	
Οὖπις	
οὔποκ'	
οὔποκα	
οὔποτε	not ever, never
οὔπω	not yet
οὐρανίδηισι	
οὐράνιος	heavenly, of or in heaven, dwelling in heaven
οὐρανόθεν	from heaven, down from heaven
οὐρανός	heaven
οὐρεύς	a mule
οὖς	auris, the ear
οὔτε	and not
οὔτι	not, I suppose . . , surely you do not mean that . .
οὔτις	no one or nobody
οὗτος	this
'οὗτος	
'οὕτω	
ούτω	
οὕτως	in this way or manner, so, thus
ὀφείλω	to owe, have to pay or account for
ὀφέλσιμος	
ὀφθαλμός	the eye
ὄφις	a serpent, snake
ὅφρα	
ὄφρα	that, in order that, to the end that
ὀφρύς	the brow, eyebrow
ὀχέω	to uphold, sustain, endure
ὄχθη	a rising ground, a bank, dyke
ὀχλίζω	to move by a lever, to heave up
ὄχνη	a wild pear
ὄχος	anything which bears, a carriage
ὀψίγονος	late-born, after-born
π	
Παγγαῖον	
Πάγγαιον	
πάγος	that which is fixed or firmly set
παγχρύσεος	all-golden, of solid gold
πάγχυ	quite, wholly, entirely, altogether
πάθη	a passive state
Παιάν	Paean or Paeon
παίγνιον	a plaything, toy
παίγνιος	sportive, droll
παιδάριον	a young, little boy
παιδεύω	to bring up or rear a child
παιδνός	childish
παίζω	to play like a child, to sport, play
παίπαλον	
παῖς	a child
Πακτωλός	
πάλα	
πάλαι	long ago, in olden time, in days of yore, in time gone by
παλαιός	old in years
παλάσσω	to besprinkle, sully, defile
πάλη	wrestling
παλιμπετής	falling back
πάλιν	back, backwards
παλινάγρετος	to be taken back or recalled
παλίρροια	the reflux of water, back-water
Παλλάς	Pallas
Παλλατίδες	
πάλλω	to poise or sway
πάλος	the lot cast from a shaken helmet
πάμπαν	quite, wholly, altogether
Πάμφιλος	
Πάν	Pan
πᾶνα	
πανάκεια	
πανακής	
Πάνακρα	
Πανακρίδος	
πανάληθες	
παναπηρής	
πανήμερος	
πάνημος	
πανίκα	
πανός	a torch
πανσυδίῃ	with all speed
πάντῃ	
πανυπέρτατος	highest of all
πανυστάτιος	
πανύστατος	last of all
πάομαι	to get, acquire
παρά	from the side of, c. gen., beside, alongside of, c. dat., to the side of, motion alongside of, c. acc.
παράδοσις	a handing down, transmission
παρά-εἰσδύνω	
παρακλίνω	to bend or turn aside
παραπέτομαι	to fly alongside
παρατίθημι	to place beside
παραφαίνω	to shew beside or by uncovering
παραψύχω	to cool gently
παρειά	the cheek
παρέρπω	to creep secretly up to
παρέρχομαι	to go by, beside or past, to pass by, pass
παρέχω	to hold beside, hold in readiness, to furnish, provide, supply
παρθενία	
παρθενίας	
Παρθενίη	
παρθενίης	the son of a concubine
παρθενική	
παρθενικός	of or for a maiden
παρθένιον	
Παρθένιος	
παρθένιος	of a maiden or virgin, maiden, maidenly
παρθένος	a maid, maiden, virgin, girl
παρίζω	to sit beside
παρίημι	to let drop beside or at the side, let fall
παριτός	
Παρνασός	Parnassus
πάροιθε	before, in the presence of
παροικίζω	to place near
πάρος	beforetime, formerly, erst
παρουαίους	
παρράλιος	
Παρρασίη	
Παρράσιος	
πᾶς	all, the whole
πᾶσις	
Πασιφάη	
πᾶσσα	
πάσσον	
πάσσω	to sprinkle
πάσχω	to receive an impression from without, to suffer
πάταγος	a clatter, crash
πατέομαι	to eat
πατέω	to tread, walk
πάτηρ	
πατήρ	a father
πατρίς	of one's fathers
πατρώιος	
πατρῷος	of or from one's father, coming or inherited from him
παυσανίας	
Παυσανίης	
παύω	to make to cease
πάχεις	
πάχνη	hoar-frost, rime
πεδάω	to bind with fetters, to bind fast, make fast
πέδιλον	sandals
πεδίον	a plain or flat
πέδον	the ground, earth
πεζός	on foot
πείθω	to prevail upon, win over, persuade
πειράω	to attempt, endeavour, try
πέκω	to comb or card
πέλαγος	the sea
πελάζω	to approach, come near, draw near or nigh
πέλας	near, hard by, close
Πελασγιάς	
Πελασγός	a Pelasgian;
πέλεκυς	an axe
πελλαῖος	
Πελοπηίς	
πέλω	to be in motion
πέλωρον	a monster, prodigy
πέλωρος	monstrous, prodigious, huge, gigantic
πέμπω	to send, despatch
πενθερά	a mother-in-law
πένομαι	to work for one's daily bread
πέντε	five
πεπλήγοντες	
πέπλος	any woven cloth
πεπλος	
πέπνυμαι	to have breath or soul
πέρ	all
πέρα	beyond, across or over, further
περάτη	
πέρατος	on the opposite side
περάω	
Πέργη	
περί	around, round about with gen., dat., and acc.
περιβόσκω	to let feed around
περιηγής	tied behind one
περικαίω	to burn round about: —
περί-ναίω	
πέριξ	round about, all round
περιπλέκω	to twine or enfold round
περιπρό	very much, especially
περισκεπέεσσιν	
περισκεπές	
περίσκεπτος	to be seen on all sides, far-seen, conspicuous
περισσός	beyond the regular number or size, prodigious
περί-στείνω	
περιστέφω	to enwreathe, surround
περιτροχάω	
περιφεύγω	to flee from, escape from
περίφοιτος	revolving, wandering
περκάζων	
περονάω	to pierce, pin
περόνη	anything pointed for piercing or pinning, the tongue of a buckle or brooch, the buckle or brooch
περσέπολις	destroyer of cities
περσέπτολις	
πέσσω	to soften, ripen or change
πετεινός	able to fly, full fledged
πέτομαι	to fly
πέτρα	a rock, a ledge or shelf of rock
πέτρος	a stone
πεύκη	the pine
πηγή	running waters, streams
πήγνυμι	to make fast
πηγός	well put together, compact, strong
πηδάλιον	a rudder or an oar used for steering
Πηλαγόνων	
Πήλιον	Pelion
Πηνειός	
πηρός	disabled in a limb, maimed
πῆρος	
πῆχυς	the fore-arm
πί	
πῖδαξ	a spring, fountain
πικρός	pointed, sharp, keen
Πίμπλεια	
πίμπλημι	to fill full of
πίναξ	a board, plank
Πίνδος	
πῖνον	
πίνος	dirt, filth
πινύσκω	to make prudent, admonish, correct
πίνω	to drink
πῖον	
πῖος	unctuous
πίπτω	to fall, fall down
πιστεύω	to trust, trust to or in, put faith in, rely on, believe in
Πιτάνη	
Πιττακός	
πίτυς	the pine, stone pine
πίων	fat, plump
πλαγγών	
πλαγκτός	wandering, roaming
πλάζω	to make to wander or roam
πλάσσω	to form, mould, shape
Πλάτων	Plato
πλεῖστος	most, largest
Πλειστός	
πλειών	a full period, a year
πλείων	more, larger
πλέκω	to plait, twine, twist, weave, braid
πλέος	full.
πλέω	to sail, go by sea
πλέως	full of
πληγή	a blow, stroke
πλήθω	to be or become full of
πλήμυρε	
πλήν	more than
πλησίος	near, close to
πλήσσω	to strike, smite
πλόκαμος	a lock or braid of hair
πλόκαμοσ'	
πλόος	a sailing, voyage
πλούσιος	rich, wealthy, opulent
Πλοῦτος	
πλοῦτος	
Πλούτων	Pluto
πνεῦμα	a blowing
πνέω	to blow
πόα	grass, herb
ποδίς	
ποδόρρωρος	
ποθι	anywhere or somewhere
ποι	somewhither
ποῖ	whether?
ποιέω	to make
ποίημα	anything made or done;
ποιητής	one who makes, a maker
ποιητός	made
ποικίλος	many-coloured, spotted, mottled, pied, dappled
ποιμήν	
ποίμνιον	a flock
ποίμνιος	
ποῖος	of what nature? of what sort?
'ποῖοσ'	
ποκάς	
πολεμήιος	warlike
πόλεμος	battle, fight, war
πολεμόω	to make hostile, make an enemy of
πολέω	to go about, range over
πολιά	grayness of hair
πόλιον	
πολιός	gray, grizzled, grisly
πολιοῦχος	protecting a city
πόλις	a city
πολίχνη	a small town
πολλάκις	many times, often, oft
'πολύ	
πολύβωμος	
πολύθεστος	
πολυκτέανος	
πολύλλιστος	sought with many prayers
πολύλλιτος	
πολυμ	
πολύμυθος	of many words
Πολυξώ	
πολύπτολι	
πολύς	many
πολύστιος	
πολύτροφος	well-fed
πολύφαμος	
πολύφημος	abounding in songs and legends
πολυχρόνιος	long-existing, of olden time, ancient
πολύχρυσος	rich in gold
πολυωνυμία	
πονέω	to work hard, do work, suffer toil
πονηρός	toilsome, painful, grievous
πόνος	work
ποντίζω	to plunge in the sea
πόντον'	
πόντος	the sea
πόρος	a means of passing a river, a ford, ferry
πόρω	to furnish, offer, present, give
Πος	
Ποσειδεών	
Ποσειδῶν	Poseidon
πόσις	
πόσος	bulk)
ποσσάκι	
ποταμός	a river, stream
ποτέ	at some time or other, at some time
πότε	when? at what time?
Ποτείδαωνα	
πότερος	whether of the two?
ποτή	flight
πότης	a drinker, tippler, toper
πότις	
ποτίστρα	
πότμος	that which befals one, one's lot, destiny
πότνια	mistress, queen
ποτόν	
ποτός	drunk, fit for drinking
πότος	drinking, a drinking-bout, carousal
ποττόν	
πού	anywhere, somewhere
ποῦ	where?
πουλυμ	
πουλυμέδιμνε'	
πουλυμέλαθρε	
πούς	a foot
πράσσω	to pass over
πράτης	
πρᾶτος	
πρέμνον	the bottom of the trunk of a tree, the stump
πρέμνος	
πρέσβυς	an old man
πρηόνος	
πρηόσιν	
πρίν	comparative
πρό	before
προβαίνω	to step on, step forward, advance
προγίγνομαι	to come forwards
προέχω	to hold before
προθέλυμνος	from the foundations or roots
πρόθυρον	the front-door, the door leading from the
Προῖτος	
πρόκειμαι	to be set before one
προμολή	an approach
πρόξ	the roe-deer
προπέτεια	reckless haste, vehemence, rashness, indiscretion
πρός	motion from
προσαυδάω	to speak to, address, accost
προσδέχομαι	to receive favourably, accept
πρόσειμι	
προσεῖπον	to speak to
προσλέγομαι	to lie beside
προσνήχομαι	to swim towards
πρόσ-πηχύνομαι	
προσπλάσσω	to form or mould upon
προσρέω	to flow towards a point, to stream in, assemble
προστασία	a standing before, leadership
προστάσιος	
προστρέχω	to run to or towards, come to
πρόσφημι	to speak to, address
πρόσω	forwards, onwards, further
προτερέω	to be before, be in advance
προτερηγενής	
πρότερος	prae.
προτέρω	further, forwards
πρότονοι	ropes from the masthead to the forepart of a ship, the forestays
πρόφασιν'	
προχανά	
πρύλις	
πρυμνόθεν	from the bottom
πρυτανεῖον	the presidents' hall, town-hall
πρώιος	early
πρώξ	a dewdrop
πρωτάγριον	the first fruits of the chase
πρώτιστος	the very first, first of the first
πρωτόθρονος	
πρῶτος	
πτελέα	the elm
πτερόν	feathers
πτέρυξ	the wing
πτοέω	to terrify, scare
πτολ	
Πτολεμαῖος	
Πτολεμαίς	Acre
πτολιάρχους	
πτολίεθρον	
πτύω	to spit out or up
Πυθώ	Pytho
πύθω	to make rot, to rot
Πυθών	
πυκινῆν	
Πυλάδης	
Πυλαία	the autumn-meeting of the Amphictyons at Pylae
πυλαῖος	at Pylae
πύλη	one wing of a pair of double gates
πυνθάνομαι	to learn by hearsay or by inquiry
πῦρ	fire
πυράγρα	a pair of fire-tongs
πύργος	a tower
πυρίκμητος	
πω	up to this time, yet
πῶς	how? in what way or manner?
'πῶς	
πως	in any way, at all, by any means
ρ	
ῥ'	
ῥαθάμιγξ	a drop
ῥαίνω	to sprinkle, besprinkle
Ῥαμνουσίς	
ῥέα	easily, lightly
Ῥέα	Rhea
ῥέζω	to do, act, deal
ῥεῖα	easily, lightly
ῥεῖθρον	that which flows, a river, stream
ῥέον	
ῥέος	a stream
ῥέω	to flow, run, stream, gush
ῥήγνυμι	to break, break asunder or in pieces, rend, shiver, shatter
ῥῆσις	a saying, speaking, speech
ῥίζα	a root
ῥιζόω	to make to strike root
ῥιπή	the swing or force with which anything is thrown
ῥόα	a pomegranate-tree
Ῥοδιακός	Rhodian, of Rhodes
Ῥοδίος	
Ῥόδιος	
ῥόδον	the rose
ῥοή	a river, stream, flood
Ῥοῖκος	
ῥόον	
ῥόος	a stream, flow, current
ρῥαιστῆρας	
ρῥόον	
ῥυηφενίη	
ῥυθμός	measured motion, time, rhythm
ῥύομαι	to draw to oneself
ῥώννυμι	to strengthen, make strong and mighty
ῥώομαι	to move with speed or violence, to dart, rush, rush on
σάκας	
σακέσπαλος	wielding a shield
σάκος	a shield
Σάμιος	
Σαμόθρηιξι	
Σάμος	Samos
Σάραπις	
Σάρδεις	Sardes
Σαρδώ	Sardinia
σάρον	a broom, besom
Σαρωνικός	
σαρωνίς	
σαυτοῦ	
σαφής	clear, plain, distinct, manifest
Σάων	
Σαωτήρων	
σεβίζω	to worship, honour
σείω	to shake, move to and fro
σεληναίη	
σεληναῖος	lighted by the moon
σεύω	to put in quick motion: to drive, hunt, chase away
σῆμα	a sign, mark, token
σημαίνω	to shew by a sign, indicate, make known, point out
σημεῖον	a sign, a mark, token
σήμερον	to-day
σής	a moth
σίβδη	
σίδηρον	
σίδηρος	iron
Σικανός	a Sicanian
σικχαίνω	
Σιμόεις	the
Σῖμος	flat-nose
σιμόω	to turn up the nose
σίνις	a ravager, plunderer
σίνομαι	to do
σιωπηλός	silent, still, quiet
σκαίρω	to skip, frisk
σκέπτομαι	to look about, look carefully
σκῆπτρον	a staff or stick to lean upon, a walking-stick
σκίπων	a staff
'σκληρά	
σκολιός	curved, winding, twisted, tangled
σκοπιά	a lookout-place, a mountain-peak
σκοπός	one that watches, one that looks after
σκότοσ'	
σκότος	darkness, gloom
Σκυθία	
Σκυθίη	
Σκυθίηνδε	
Σκύθιος	
σκύλαξ	a young dog, whelp, puppy
σμαραγέω	to crash
σμάω	to wipe
σμικρός	
Σμύρνα	Smyrna
Σμύρνη	
Σολεύς	
σός	thy, thine, of thee
σοῦ	shoo! shoo!
Σούνιον	Sunium
σοφία	skill
σπαρνός	
Σπάρτη	Sparta
σπάω	to draw
σπείρωσε	
σπέος	a cave, cavern, grotto
σπέρχω	to set in rapid motion
σπιλάς	a rock over which the sea dashes, a ledge of rock
σποδιά	a heap of ashes, ashes
σποδίζω	to roast or bake in the ashes, burn to ashes
σπόδιος	
σπονδή	a drink-offering
στάζω	to drop, let fall or shed drop by drop
στάχυς	an ear of corn
στεγανός	covering so as to keep out water, water-tight, waterproof
στείβω	to tread on, tread under foot
στείχω	to walk, march, go or come
στέλλω	to set in order, to arrange, array, equip, make ready
στέμμα	a wreath, garland
στενός	narrow, strait
στενόω	to straiten
στένω	to moan, sigh, groan
στέρνον	the breast, chest
Στερόπης	lightner
στέφανος	that which surrounds
στεφανόω	to be put round
στέφος	a crown, wreath, garland
στῆθος	the breast
στήλη	a block of stone
στηρίζω	to make fast, prop, fix, set
στιβαρός	compact, strong, stout, sturdy
στίζω	to mark with a pointed instrument, to tattoo
στίχος	a row or file
στοιχεῖον	one of a row
στόμα	the mouth
στόνος	a sighing, groaning, lamentation
στρατός	an encamped army
στρεύγομαι	to be squeezed out in drops
στρέφω	to turn about or aside, turn
Στροφίη	
Στρυμονίας	a wind blowing from the Strymon
Στρυμόνιος	
Στρυμών	the Strymon
στύγος	hatred
Στυμφαιίδες	
Στύξ	the Styx
σύ	
συλλέγω	to collect, gather
σύμ	
συμβάλλω	to throw together, dash together
σύμβολον	a sign or token by which one infers
σύμβολος	an augury, omen
συμμίγνυμι	to mix together, commingle
συμφέρω	to bring together, gather, collect
σύν	along with, in company with, together with
συνάντομαι	to fall in with, meet
συναρπάζω	to seize and carry clean away
σύν-γελάω	
συνδείπνιον	
σύνδρομος	running together, meeting
σύνειμι	
συνεπιψεύδομαι	to join in lying
συνέριθος	a helpmate
συνεχής	holding together
συνίημι	to bring or set together
συνοργίζομαι	to be angry together with
συντίθημι	to put together
σύντομος	a short
συοκτόνος	
σῦριγξ	a pipe
συρφετός	anything swept together, sweepings, refuse, rubbish, litter
σφεῖς	they
σφέτερος	their own, their
σφός	their, their own, belonging to them
σφυρόν	the ankle
σχεδόν	close, near, hard by, nigh
σχέτλιος	unwearying
σχῖνος	the mastich-tree
σώζω	to save, keep
σώιζεο	
'σώιζεο	
Σώπολιν	
σῶς	safe and sound, alive and well, in good case
τ	
τἀθάναι	
τάλας	suffering, wretched
τᾶμος	
τᾶν	sir, my good friend
τανύω	to stretch, strain, stretch out
Ταύγετον	Mount Taygetus
Ταῦρος	
ταῦρος	a bull
ταύτῃ	in this way.
τάφος	
τάφρος	a ditch, trench
τάχα	quickly, presently, forthwith
ταχινός	
τάχιστος	
τάχος	swiftness, speed, fleetness, velocity
ταχύς	quick, swift, fleet
τε	and
τέγεος	at or near the roof
τέγος	a roof
τέθηπα	to be astonished, astounded, amazed
τέθμιος	settled, regular
τεῖ	
τείνω	
Τειρεσίης	
τεῖρος	the heavenly constellations, signs
τείρω	to rub hard
τεῖχος	a wall
τεκμαίρομαι	to fix by a mark or boundary, to ordain, decree
τέκνον	that which is borne or born, a child
'τέκνον	
τέκος	the young
τεκταίνομαι	to make, work, frame
τελέθω	to come into being, to be quite or fully
τέλειος	having reached its end, finished, complete
τελεσφορέας	
τελεσφορία	
τελέω	to complete, fulfil, accomplish
τέλθος	
τέλλω	to make to arise, accomplish
Τελχίν	one of the Telchines
τέμνω	to cut, hew
Τέμπη	
τένων	any tight-stretched band, a sinew, tendon
τέος	
τεός	
τέρας	a sign, wonder, marvel
τέρμα	an end, boundary
τέσσαρες	four
τέταρτος	fourth
τέτμον	to overtake, reach, come up to, find
τετραβόειος	
τετράγυος	containing four measures of land
τετραετής	four years old
τετραίνω	to bore through, pierce, perforate
τετράκις	four times
τετράπαλαι	
τετράποδος	
τετράπους	four-footed
τέτρατος	fourth
τετυπόντες	
Τευκρῶν	
τευχηστήρ	an armed man, warrior
τευχηστής	
τεῦχος	a tool, implement
τεύχω	to make ready, make, build, work
τέφρα	ashes
τεχνάομαι	to make by art, to execute skilfully
τέχνη	art, skill, craft in work, cunning of hand
τῇ	here, there
τῇδε	here, thus
Τηθύς	Tethys
τήκω	to melt, melt down
τηλόθεν	from afar, from a foreign land
τῆμος	then, thereupon
τημόσδε	
τημοῦτος	
τῆνος	he, she, it
τίθημι	to set, put, place
τιθηνέομαι	to nurse, suckle, tend as nurse
τιθήνη	a nurse
τίκτω	to bring into the world
Τίμαρχος	
τιμάω	to pay honour to, hold in honour, to honour, revere, reverence
τιμήεις	honoured, esteemed
τίμησις	a valuation
τίμιος	valued
Τιμόδημος	
Τιμόθεος	
'Τιμονόη	
τῖμος	
Τίμων	
τίνω	to pay a price
τίπτε	
Τιρύνθιος	
'τίς	
τις	any one, any thing, some one, some thing;
τίς	who? which?
Τιτάν	the Titans
Τιτανίς	
τιτρώσκω	to wound
Τιτυοκτόνος	slaying Tityus
τλάω	to take upon oneself, to bear, suffer, undergo
τλήμων	suffering, enduring, patient, stout-hearted
Τμαρίοισιν	
'τό	
τόθεν	hence, thence
τόθι	there, in that place
τοι	let me tell you, surely, verily
τοῖος	quality, such, such-like
τοιόσδε	such a
τοιοῦτος	such as this
τοῖχος	the wall of a house or court
τοκάς	of or for breeding
τοκεύς	one who begets, a father
τόκος	a bringing forth, childbirth, parturition
τόξον	a bow
τοξότις	
τοπήιον	
τορός	piercing
τοσάκις	so many times, so often
τόσος	so great, so vast
τοσόσδε	so strong, so able
τότε	at that time, then
τουτάκις	
'τοῦτο	
τόφρα	up to or during that time, so long
τραγικός	of or like a goat, goatish
τράπεζα	four-legged a table
τραῦμα	a wound, hurt
τρεῖς	
τρέμω	to tremble or fear to
τρέπω	to turn or direct
τρέφω	to thicken or congeal
τρέχω	to run
τρέω	to flee from fear, flee away
τριγλώχις	three-barbed
τριέτηρος	
τρίλλιστος	thrice
Τρινάκιος	
τρίοδος	a meeting of three roads
τριόδους	with three teeth, three-pronged
Τριόπης	
Τριοπίδαισιν	
τριπέτηλον	
τριπέτηλος	three-leafed
τριποδήιος	
τρίπους	three-footed, of or with three feet
Τριπτόλεμος	
τρίς	thrice, three times
τρίτατος	
τρίτος	the third
Τροεζῆνος	
Τροιζήν	Troezen
τρόπος	a turn, direction, course, way
τροφός	a feeder, rearer, nurse
τροχόεις	round as a wheel, round
τύμβος	a sepulchral mound, cairn, barrow
Τυνδάρεος	Tyndareos or Tyndarus
τύνω	
τύπτω	to beat, strike, smite
τυτθός	little, small
τυφλός	blind
τύφω	to raise a smoke
τῷ	therefore, in this wise, thereupon
τὠπόλλωνι	
τὠπόλλωνος	
τὦργον	
τὦργος	
τώς	so, in this wise
ὑβριστής	a violent, overbearing person, a wanton, insolent man
ὑγρός	wet, moist, running, fluid
ὑδείομεν	
ὑδροφόρος	carrying water
ὕδωρ	water
υἱός	A son
υἱωνός	a grandson
Ὑλαῖος	
ὑλαῖος	of the forest, savage
ὕλη	forest-trees
ὗλις	
ὑμέναιος	hymenaeus, the wedding or bridal song
ὑμέτερος	your, yours
ὑμνέω	to sing, laud, sing of
ὑμός	your
ὑπαείδω	to sing by way of accompaniment
ὑπαξόνιος	
ὕπαρνος	with a lamb under
ὕπατος	supremus, the highest, uppermost
ὑπέρ	over, above, w. gen, over, beyond, w. acc.
ὑπερ	
ὑπερβα	
ὑπερβασία	a transgression of law, trespass
ὑπέροχος	prominent, eminent, distinguished above
ὑπέχω	to hold or put under
ὑπνάω	to sleep
ὕπνον	
ὕπνος	sleep, slumber
ὑπνόω	to put to sleep
ὑπό	from under, by, c. gen. under, c. dat., towards c. acc.
ὑποβάλλω	to throw, put or lay under
ὑποβλέπω	to look up from under
ὑπογλαύσσω	to glance furtively
ὑποδέχομαι	to receive beneath
ὑπό-δινεύω	
ὑποκόλπιος	under the folds of the robe
ὑποληνίς	
ὑπολύω	to loosen beneath or below
ὑποσχεσίη	
ὑποτρέω	to tremble a little, to shrink back, give ground
ὑποτρώγω	to eat by way of preparation
ὑπόχλοος	
Ὑρράδιον	
ὗς	the wild swine
ὑστάτιος	at last
ὕστερον	
ὕστερος	latter, last
ὕστριξ	the porcupine
ὑφαίνω	to weave
ὑφή	a web
Ὑψηίς	
ὑψηλός	high, lofty, high-raised
ὑψόθε	
ὑψόθεν	from on high, from aloft, from above
ὑψόθι	aloft, on high
Ὕμνοι	
φαγεῖν	to eat, devour
φαεσφορία	
φαεσφόρος	light-bringing
Φαῖδρος	
φαιδρύνω	to make bright, to cleanse
φαίνω	to bring to light, make to appear
φάλαγξ	a line of battle, battle-array
φάος	light, daylight
φαρέτρα	a quiver
φάρμακον	a drug, medicine
φάρμακος	
φάσγανον	a sword
φάσις	
φατίζω	to say, speak, report
φατός	that may be spoken
φέγγος	light, splendour, lustre
Φενειός	
Φεραῖος	
φέρβω	to feed, nourish
φέρτατος	bravest, best
φέρω	to bear
φεύγω	to flee, take flight, run away
φήγινος	oaken
φηγός	oak
φημί	to declare, make known
φθέγγομαι	to utter a sound or voice
φθινόπωρον	late autumn, the fall of the year
φθίω	to decay, wane, dwindle
Φθιώτης	a man of Phthia
φθόγγος	any clear, distinct sound
φθόνος	ill-will, envy, jealousy
φιλαίτερος	
φιλέω	to love, regard with affection
φιληδέω	to find pleasure in, take delight in
φιληδής	fond of pleasure
Φιληρατίς	
Φίλιππος	
φιλόμολπος	loving dance and song
φιλοξεινωτάτη	
Φιλοξενίδεω	
φιλόπαις	loving its young
φῖλος	
φίλος	loved, beloved, dear
φιλότεκνος	loving one's children or offspring
φιλύρα	the lime or linden tree
Φιλύρη	
φίλων	
φιν	
φλεξας	
φλιά	the doorposts, jambs
φλόξ	a flame
φοβέω	to put to flight
φόβος	flight
φοιβάζω	to prophesy
φοιβάω	to cleanse, purify
Φοῖβος	
φοῖνιξ	a purple-red, purple or crimson
Φοῖνιξ	a Phoenician
φοιτασεῖ	
φοιτάω	to go to and fro, up and down, to stalk
φόνος	murder, homicide, slaughter
φορβαῖος	
φορέω	to bear or carry constantly, to be used to carry
φράζω	to point out, shew, indicate
φρέαρ	a well
φρητί	
φρούριον	a watch-post, garrisoned fort, citadel
φρουρός	a watcher, guard
φρυάσσομαι	to neigh and prance
φρυγία	
Φρύγιος	Phrygian, of, from Phrygia
Φρύξ	a Phrygian
φυγή	flight
φῦκος	rouge
φυλάζω	to divide into tribes
φυλάσσω	to keep watch and ward, keep guard
φυλή	a race or tribe
φυλλοβολέω	to shed the leaves
φύλλον	a leaf;
φῦλον	a race, tribe, class
φυράω	to mix
φύρω	to mix
φῦσα	a pair of bellows, bellows
φυσάδεια	
φυταλιά	
φυταλία	a planted place, an orchard or vineyard
φυτάς	
φυτόν	that which has grown, a plant, tree
φυτός	shaped by nature, without art
φύω	to bring forth, produce, put forth
Φωκεύς	a Phocian
φώκη	a seal
φωνή	a sound, tone
φώρ	a thief
φώς	a man
χ	
'χάζευ'	
χάζω	to cause to retire
χαῖρε'	
χαῖρς	
χαίρω	to rejoice, be glad, be delighted
χαίτη	long, flowing hair
χἀκαστάς	
χαλεπός	hard to bear, painful, sore, grievous
χαλέπτω	to oppress, depress, crush
χαλινά	
χαλινοφάγος	
χάλκειος	of copper or bronze, brasen
χάλκεος	of copper or bronze, brasen
χαλκεύς	a worker in copper, a smith
Χαλκιδικός	of or from Chalcis
Χαλκιόπη	
χαλκός	copper
χαμάδις	to the ground, on the ground
χαμαί	on the earth, on the ground
Χαρίδα	
Χαρίδας	
χαρίεις	graceful, beautiful, lovely
χαρίζομαι	to say or do something agreeable
Χαρικλώ	
Χάρις	
χάρις	Grace
χάριτος	
χαριτόω	to shew grace to
Χάρμι	
χάσκω	may
χεῖμα	winter-weather, cold, frost
χειμών	winter
χείρ	the hand
χειρίς	a covering for the hand, a glove
χειρόω	to bring into hand, to manage, master, subdue
χείρων	worse, meaner, inferior
Χειρωνίς	a book on surgery
χέλυς	a tortoise
χέρσος	dry land, land
χεῦμα	that which is poured, a stream
χέω	to pour
χήρα	bereft of a husband, a widow
χῆρος	
Χησιάς	
χθιζός	of yesterday
χθών	the earth, ground
Χίος	Chios
χιτών	the garment worn next the skin, a frock
χιτώνη	
χιών	snow
χλούνης	couching in the greenwood
χνόος	any light porous substance
χόλος	gall, bile
χολόω	to make angry, provoke, anger
χορδή	gut-string, the string
χόριτις	
χορός	a round dance
χοροστασία	institution of choruses
χοὐμός	
χόω	to throw or heap up
χράω	
χρέος	that which one needs must pay, an obligation, debt
χρεώ	want, need;
χρῆμα	a thing that one uses
χρήμη	
χρῖμα	unguent, oil
χρίω	to touch on the surface: to rub or anoint with scented unguents
χροιά	the surface of a body, the skin; the body
χροΐαν	
χρόνος	time
χρυσεοπήληξ	
χρύσεος	golden, of gold, decked or inlaid with gold
χρυσός	gold
χρυσόω	to make golden, gild
χρώς	the surface of the body, the skin
χυτλόω	to wash
χώομαι	to be angry, wroth, indignant
χωρέω	to make room for another, give way, draw back, retire, withdraw
χωρίς	separately, asunder, apart, by oneself or by themselves
χῶρος	a piece of ground, ground, place
ψάμαθος	sand, sea-sand
ψαύω	to touch
ψεῦδις	
ψευδοκύων	a sham Cynic
'ψευδοπάτωρ	
ψεῦδος	a falsehood, untruth, lie
'ψεῦδοσ'	
ψεύδω	to cheat by lies, beguile
ψεύστης	a liar, cheat
ψήχω	to rub down, curry
ψυχή	breath
ψυχρός	cold, chill
ω	
ὦ	O! oh!
'ὦ	
Ὠαρίων	
Ὡγρευτής	
Ὠγύγιος	Ogygian, of or from Ogyges
ὧδε	in this wise, so, thus
ὠδίνω	to have the pains or throes of childbirth, to be in travail or labour
ὠδίς	the pangs or throes of labour, travail-pains
ὤεον	an egg
ὠθάνα	
ὦκα	quickly, swiftly, fast
Ὠκεανίνη	daughter of Ocean
Ὠκεανός	Oceanus
ὠκύθοος	swift-running
ὠκύς	quick, swift, fleet
Ὠλήν	
ὤλξ	a furrow
Ὡμβρακιώτης	
ὤμοι	
ὦμος	ulna
ὠμοτόκος	bringing forth untimely offspring:—
ὠμότοκος	
ὤπολλον	
ὡπόλλων	
Ὥρα	
ὥρα	period
ὦρος	a mountain
ὡρχαῖος	
ὡς	thus, as, so that, since
Ως	
ὥσπερ	just as if, even as
ὥστε	as, as being
Ὦτος	