Field1	Field2
ἀγαθός	good
Ἄγις	
ἀγνοέω	not to perceive or know
ἀγνώς	unknown
ἀγορά	an assembly of the people
ἀγοράζω	to be in the ἀγορά
ἀγοράομαι	to meet in assembly, sit in debate
ἀγός	a leader, chief
ἄγω	to lead or carry, to convey, bring
ἀγών	a number of people brought together, a gathering, assembly
ἀγωνίζομαι	to contend for a prize
ἄγωνος	
ἀδελφός	sons of the same mother
ἀδικέω	to do wrong
ἀδίκημα	a wrong done, a wrong
ἀδικία	wrong-doing, injustice
ἀδικίανἀκυρον	
ἄδικος	wrong-doing, unrighteous, unjust
ἀδόκιμος	not standing the test, spurious
ἀδοξία	ill-repute, disgrace
ἄδοξος	inglorious, disreputable
ἀδύνατος	unable
ἀδωροδόκητος	
ἀεί	always, for ever
Ἀθῆναι	the city of Athens
Ἀθήναια	
Ἀθήναιον	the temple of Athena
Ἀθηναῖος	Athenian, of or from Athens
Ἀθήναιος	
Ἀθήνευς	
Ἀθήνη	Athena
ἀθρόος	in crowds or masses, crowded together
αἱρέω	to take with the hand, grasp
αἴρω	to take up, raise, lift up
αἰσθάνομαι	to perceive, apprehend by the senses, to see, hear, feel
αἰσχροκέρδεια	base covetousness
αἰσχροκερδής	sordidly greedy of gain
αἰσχρός	causing shame, abusive
αἰσχύνη	shame done one, disgrace, dishonour
αἰσχύνω	to make ugly, disfigure, mar
αἰτέω	to ask, beg
αἰτία	a charge, accusation
αἴτιος	to blame, blameworthy, culpable
ἀκολουθέω	to follow
ἀκόλουθος	following, attending on
ἀκούω	to hear
ἀκριβής	exact, accurate, precise, made or done to a nicety
ἀκριβόω	to make exact or accurate
ἀκριβῶς	
ἀκρόπολις	the upper city
ἀκτή	a headland, foreland, promontory, shore
ἄκυρον	
ἄκυρος	without authority
ἀκυρόω	
ἀλέξανδρος	defending men
Ἀλέξανδρος	
ἀλήθεια	truth
ἀληθής	unconcealed, true
ἀληθινός	agreeable to truth
Ἁλιρρόθιος	
ἁλιρρόθιος	dashed over by the sea
ἁλίσκομαι	to be taken, conquered
ἀλιτήριος	sinning or offending against
ἀλλά	otherwise, but
ἀλλήλων	of one another, to one another, one another
ἄλλοθι	elsewhere, in another place, in a strange
ἄλλος	alius, another, one besides
ἀλλότριος	of or belonging to another
ἄλλου	
ἀλόγιστος	unreasoning, inconsiderate, thoughtless, heedless
ἀλυσιτελής	unprofitable
ἁμάρτημα	a failure, fault, sin
ἁμαρτία	a failure, fault, sin
ἀμελέω	to have no care for, be neglectful of
ἁμιλλάομαι	to compete, vie, contend with
ἁμός	
ἁμοῦ	somewhere or other
ἀμύνω	to keep off, ward off
ἀμφισβητέω	to stand apart
Ἄμφισσα	
ἀμφότερος	each or both of two
ἄν	
ἀνά	up, upon
ἀναβαίνω	to go up, mount, to go up to
ἀναβοάω	to shout aloud, utter a loud cry
ἀναγιγνώσκω	to know well, know certainly
ἀναγκάζω	to force, compel
ἀναγκαῖον	a place of constraint, a prison
ἀναγκαῖος	with or by force
ἀνάγκη	force, constraint, necessity
ἀναδείκνυμι	to lift up and shew
ἀναδέχομαι	to take up, catch, receive
ἀνάθημα	a votive offering set up
ἀναίδεια	shamelessness, impudence, effrontery
ἀναιρέω	to take up, raise
ἀνακομίζω	to carry up
ἀνακρίνω	to examine closely, to question, interrogate
ἀναλαμβάνω	to take up, take into one's hands
ἀναλίσκω	to use up, to spend, lavish or squander
ἀναμένω	to wait for, await
ἀναμιμνήσκω	to remind
ἀνάξιος	unworthy, not deemed or held worthy of
ἀναπίμπλημι	to fill up
ἀνάπτω	to make fast on or to
ἀναρπάζω	to snatch up
ἀνάστατος	made to rise up and depart, driven from one's home
ἀνατίθημι	to lay upon
ἀνατρέπω	to turn up or over, overturn, upset
ἀνατρέφω	to feed up, nurse up, educate
ἀναφέρω	to bring or carry up
ἀναψάω	to wipe up:—
ἀνδρεῖος	of or for a man
ἀνδρίς	
ἀνδρόω	to rear up into manhood
ἀνέδην	let loose, freely, without restraint
ἀνέθεσαν	
ἀνείργω	to keep back, restrain
ἀνήκω	to have come up to
ἀνήρ	a man
ἄνθρωπος	man
ἀνιερόω	to dedicate, devote
ἀνίστημι	to make to stand up, raise up
ἄνοος	without understanding, foolish, silly
ἀνόσιος	unholy, profane
ἀντεῖπον	to speak against or in answer, gainsay
ἀντί	over against, opposite. c. gen.
ἀντίθετος	
ἀντικαταλλάσσομαι	to exchange
Ἀντίπατρος	
ἀντιπολιτεύομαι	to be a political opponent
ἀντιπράσσω	to act against, seek to counteract
ἀντιτίθημι	to set against, oppose
Ἀντιφών	
ἄνω	
ἀξία	the worth or value
ἀξιόπιστος	trustworthy
ἄξιος	weighing as much, of like value, worth as much as
ἀξιόω	to think or deem worthy of
ἀξίωμα	that of which one is thought worthy, an honour
ἀπαγορεύω	to forbid
ἀπάγω	to lead away, carry off
ἀπαίρω	to lift off, carry off, take away, to remove from
ἀπαιτέω	to demand back, demand
ἀπαλλάσσω	to set free, release, deliver
ἅπαξ	once, once only, once for all
ἀπαραίτητος	not to be moved by prayer, inexorable
ἅπας	quite all, the whole
ἄπειμι	
ἀπεῖπον	to speak out, tell out, declare
ἄπειρος	
ἀπέρχομαι	to go away, depart from
ἀπέχω	to keep off or away from
ἄπιστος	not to be trusted
ἁπλός	
ἁπλόω	to make single, to unfold, stretch out
ἁπλῶς	singly, in one way
ἀπό	from, away from. c. gen.
ἀποβλέπω	to look away from
ἀπόγονος	born or descended from
ἀποδείκνυμι	to point away from
ἀπόδειξις	a shewing forth, exhibiting
ἀποδέχομαι	to accept from
ἀποδημία	a being from home, a going or being abroad
ἀποδημίη	
ἀποδιδράσκω	to run away or off, escape
ἀποδίδωμι	to give up or back, restore, return
ἀποδοκιμάζω	to reject on scrutiny, to reject for want of qualification
ἀποδοκιμάω	to reject
ἀποθνήσκω	to die off, die
ἀποκρύπτω	to hide from, keep hidden from
ἀποκτείνω	to kill, slay
ἀπολαύω	to have enjoyment of
ἀπολείπω	to leave over or behind
ἀπόλλυμι	to destroy utterly, kill, slay
ἀπολογέομαι	to speak in defence, defend oneself
ἀπολογία	a speech in defence, defence
ἀπολύω	to loose from
ἀπονέμω	to portion out, impart, assign
ἀπόνοια	loss of all sense
ἀπορέω	to be without means or resource
ἀπόρθητος	not sacked, unravaged
ἀπορία	difficulty of passing
ἀπόρρητος	forbidden
ἀποστέλλω	to send off or away from
ἀποστερέω	to rob, despoil, bereave or defraud
ἀποστρέφω	to turn
ἀποτίθημι	to put away, stow away
ἀποτυγχάνω	to fail in hitting or gaining, to miss, lose
ἀποτυχία	
ἀποφαίνω	to shew fort, display, produce
ἀπόφασις	
ἀποφεύγω	to flee from, escape
ἀπόφημι	to speak out, declare flatly or plainly
ἀποχειροτονέω	to vote a charge away from
ἀποψηφίζομαι	to vote away from
ἄπρακτος	doing nothing, ineffectual, unprofitable
ἆρα	particle introducing a question
ἄρα	
ἀρά	a prayer
ἀργυρίζω	
ἀργύριον	a piece of silver, a silver coin
Ἄρειος	
ἄρειος	devoted to Ares, warlike, martial
Ἀρεοπαγῖται	
Ἀρεοπαγίτης	a member of the Areopagus
ἀρετάω	to be fit or proper, to thrive, prosper
ἀρετή	goodness, excellence
Ἀρή	
ἀρή	
Ἄρης	Ares
ἀρθμέω	to be united
ἄρθμιος	united
Ἄρις	
Ἀρίσταρχος	
ἀρίσταρχος	best-ruling
Ἀριστείδης	
Ἀριστογείτων	
ἄριστος	best
Ἀριστοφῶν	
Ἀρκάς	
Ἁρμόδιος	
ἁρμόδιος	fitting together
ἄρον	
ἄρος	
ἀρόω	to plough
ἁρπάζω	to snatch away, carry off
Ἅρπαλος	
'Αρπάλου	
ἄρσην	male
Ἄρτεμις	Artemis
ἄρτιος	complete, perfect of its kind, suitable, exactly fitted
ἀρχαῖος	from the beginning
ἀρχεθεωρία	
ἀρχεθεωρός	
ἀρχή	a beginning, origin, first cause
ἀρχηγός	beginning, originating
ἀρχήν	
Ἀρχῖνον	
ἄρχω	to be first
ἀσεβής	ungodly, godless, unholy, profane
ἀσθένεια	want of strength, weakness, feebleness, sickliness
ἀσθενής	without strength, weak, feeble, weakly
ἀσμενέω	
ἄστυ	a city, town
ἀστυγείτων	near or bordering on a city
ἄστυλος	without pillar or prop
Ἀστύλος	
ἀσφάλεια	security against stumbling or falling
ἀσφαλής	not liable to fall, immoveable, steadfast, firm
ἀτιμώρητος	unavenged
ἄτοπος	out of place
Ἀττικός	Attic, Athenian
ἀτυχέω	to be unlucky or unfortunate, fail, miscarry
ἀτύχημα	a misfortune, mishap
ἀτυχής	luckless, unfortunate
ἀτυχία	ill-luck:—a misfortune, miscarriage, mishap
αὖ	
αὐτίκα	forthwith, straightway, at once
αὐτόνομος	living under one's own laws, independent
αὐτόπτης	seeing oneself, an eyewitness
αὐτός	self
αὐτοῦ	at the very place, just here, just there
αὐτόφωρος	self-detected, caught in the act of theft
ἀφαιρέω	to take from, take away from
ἀφανής	unseen, invisible, viewless
ἄφεσις	a letting go, dismissal
ἀφήκω	to arrive at
Ἀφιδναῖος	
ἀφίημι	to send forth, discharge
ἀφικνέομαι	to come to
ἄφιξις	an arrival
ἀφίστημι	to put away, remove
Ἀχαιός	Achaian
ἄχθομαι	to be loaded
ἄχρηστος	useless, unprofitable, unserviceable
βαδίζω	to go slowly, to walk
βαρβαρόομαι	to become barbarous
βάρβαρος	barbarous
βασιλεύς	a king, chief
βασιλικός	royal, kingly
βέβαιος	firm, steady, steadfast, sure, certain
βεβαιόω	to make firm, confirm, establish, secure, warrant, make good
βέλτιστος	best
βελτίων	better
Βηρισάδην	
βίαιος	forcible, violent
βίος	life
βιόω	to live, pass one's life
βλάβη	hurt, harm, damage
βλάβος	
βλάπτω	to disable, hinder, stop
βλασφημέω	to drop evil or profane words, speak lightly or amiss of sacred things
βλασφημία	a profane speech
βοήθεια	help, aid, rescue, support
βοηθέω	to come to aid, to succour, assist, aid
βουλεύς	
βουλεύω	to take counsel, deliberate, concert measures
βουλή	will, determination
βούλομαι	to will, wish, be willing
Βραυρώνιος	
βραχύς	short
Γαῖα	
γάρ	for
γε	at least, at any rate
γένος	race, stock, family
γεύω	to give a taste of
γῆ	earth
γίγνομαι	to come into being
γιγνώσκω	to learn to know, to perceive, mark, learn
γνώμη	a means of knowing, a mark, token
γνώριμος	well-known, familiar
γοάω	to wail, groan, weep
γόης	one who howls out enchantments, a sorcerer, enchanter
γοητεία	juggling, cheatery
γονεύς	a begetter, father
Γόργιππον	
γράμμα	that which is drawn
γραφεύς	a painter
γραφή	representation by means of lines
γραφής	
γράφω	to scratch, scrape, graze
γυνή	a woman
δαίμων	a god, goddess
δακρύω	to weep, shed tears
δάκτυλος	a finger
δέ	but
δέησις	an entreating, asking: a prayer, entreaty
δεῖ	it is binding on
δείκνυμι	to bring to light, display, exhibit
δεινός	fearful, terrible, dread, dire
δεινόω	to make terrible: to exaggerate
δέκα	ten
δεκάκις	ten-times
δεκαπλάσιος	tenfold
δεκαπλόος	
δεκαπλοῦς	
δεσμωτήριον	a prison
δέσποινα	the mistress, lady of the house
δεῦρο	hither
δευσοποιός	deeply dyed, ingrained, fast
δέχομαι	to take, accept, receive
δέω	
δή	exactness
δήκαι	
δηλονότι	quite clearly, manifestly, plainly
δημαγωγέω	to lead the people
δημαγωγός	a popular leader
Δημάδης	
δημεύω	to declare public property, to confiscate
δημηγορέω	to speak in the assembly
δημηγορία	a speech in the public assembly
δημοκρατία	democracy, popular government
δῆμος	a country-district, country, land
Δημοσθένης	
δημοσίᾳ	
δημόσιος	belonging to the people or state
δημοσιόω	to confiscate
δημοτικός	of or for the people, in common use, common
δήπου	perhaps, it may be
διά	through c. gen. through, by means of c. acc.
διαβολή	false accusation, slander, calumny
διαδίδωμι	to give from hand to hand, to pass on, hand over
διαδικάζω	to give judgment in a case
διαθήκη	a disposition
διάκειμαι	to be in a certain state, to be disposed or affected
διαλέγω	to pick out one from another, to pick out
διά-λέγω	
διαλλάσσω	to change one with another, interchange
διαλύω	to loose one from another, to part asunder, undo
διαμένω	to remain by, stand by
διανέμω	to distribute, apportion
διάνοια	a thought, intention, purpose
διαπειράομαι	to make trial or proof of, to have experience
διαπράσσω	to pass over
διαρπάζω	to tear in pieces
διαρρήδην	expressly, distinctly, explicitly
διασκευάζω	to get quite ready, equip
διατάσσω	to appoint or ordain severally, dispose
διατελέω	to bring quite to an end, accomplish
διατίθημι	to place separately, arrange
διατρίβω	to rub between, rub hard, rub away, consume, waste
διαφέρω	to carry over or across
διαφθείρω	to destroy utterly
διαφθορά	destruction, ruin, blight, death.
διαφυλάσσω	to watch closely, guard carefully
δίδωμι	to give
Δίη	
δικάζω	to judge, to give judgment on
δικαία	
δίκαιος	observant of custom and social rule, well-ordered, civilised
δικαιοσύνη	righteousness, justice
δικαιόω	to set right
δικαστήριον	a court of justice
δικαστής	a judge
δίκη	custom, usage
διό	wherefore, on which account
διοικέω	to manage a house
διοίκησις	government, administration
διόμνυμι	to swear solemnly, to declare on oath that . .
διόπερ	
δῖος	god-like, divine
διότι	for the reason that, since
διπλάσιος	twofold, double, twice as much as, twice as many as, as long as
διπλασίων	
διπλόος	twofold, double
δίς	twice, doubly
δισχίλιοι	two thousand
Διφίλῳ	
δίω	to run away, take to flight, flee
δοκεύς	
δοκέω	videor mihi, to think, suppose, imagine, expect
δοκώ	
δόξα	a notion
δόξις	
δουλεία	servitude, slavery, bondage
δούλειος	slavish, servile
δουλεύω	to be a slave
δραπέτης	a runaway
δραχμή	a handful
δύναμαι	to be able, capable, strong enough
δύναμις	power, might, strength
δυνατός	strong, mighty, able
δύο	two
δυσχερής	hard to take in hand or manage
Δωδωναῖος	of Dodona
Δωδώνη	Dodona
δωρεά	a gift, present
δωροδοκέω	to accept as a present
δωροδοκία	a taking of bribes, openness to bribery
δωροδόκος	taking presents or bribes
δῶρον	a gift, present
δώσων	always going to give
ἕ	sui.
ἐάν	if haply
ἑαυτοῦ	itself, absolutely
ἐάω	to let, suffer, allow, permit
ἐγγίγνομαι	to be born or bred in
ἐγκαλέω	to call in
ἐγκαταγηράσκω	to grow old in
ἐγκαταλείπω	to leave behind
ἐγχειρίζω	to put into one's hands, entrust
ἐγχώριος	in or of the country
ἐγώ	ego
ἐγώγε	
ἔδαφος	the bottom, foundation, base
ἕδος	a sitting-place
ἔδω	to eat
ἐθέλω	to will, wish, purpose
ἐθίζω	to accustom, use
ἔθνος	a number of people accustomed to live together, a company, body of men
ἔθος	custom, habit
ἔθω	to be accustomed
εἰ	whether.
εἶδον	to see, perceive, behold
εἴκοσι	twenty
εἰκότως	in all likelihood, suitably, fairly, reasonably, naturally
εἰκών	a likeness, image, portrait
εἶμι	to go
εἰμί	to be, to exist
εἴπερ	strengthd. for
εἶπον	to speak, say
εἶπος	
εἰρήνη	peace, time of peace
εἰρωνεύομαι	to dissemble
εἰς	into, to c. acc.
εἷς	
εἰσαγγελία	an impeachment
εἰσαγγέλλω	to go in and announce
εἰσάγω	to lead in or into, to introduce
εἰσαγώγιμος	that can or may be imported
εἰσβάλλω	to throw into, put into
εἰσέρχομαι	to go in or into, enter
εἰσίημι	to send into
εἰσποιέω	to give in adoption
εἰσφέρω	to carry into or to
εἰσφορά	a gathering in
εἶτα	then, next
ἐκ	from out of
ἕκαστος	every, every one, each, each one
ἑκατόν	a hundred
ἐκβάλλω	to throw or cast out of
ἐκεῖ	there, in that place
ἐκεῖθεν	from that place, thence
ἐκεῖνος	the person there, that person or thing
ἐκεῖσε	thither, to that place
ἐκκαθάρατε	
ἐκκλησία	an assembly of the citizens regularly summoned, the legislative assembly
ἐκκόπτω	to cut out, knock out
ἐκπέμπω	to send out or forth from
ἐκπλέω	to sail out, sail away, weigh anchor
ἔκπωμα	a drinking-cup, beaker
ἐκστρατεύω	to march out
ἔκτεισις	
ἐκτίνω	to pay off, pay in full
ἐκφέρω	to carry out of
ἑκών	willing, of free will, readily
ἐλασσόω	to make less or smaller, to lessen, diminish, lower
ἐλάσσων	smaller, less
ἐλαύνω	to drive, drive on, set in motion
ἔλεγχος	a cross-examining, testing
ἐλέγχω	to disgrace, put to shame
ἐλεεινός	finding pity, pitied or moving pity, pitiable, piteous
ἐλεέω	to have pity on, shew mercy upon
ἔλεος	pity, mercy, compassion
ἐλευθερία	freedom, liberty
ἐλεύθερος	free
ἐλευθερόω	to free, set free
Ἐλευσίνιος	of Eleusis
ἑλλά	
Ἑλλάς	Hellas
Ἕλλην	Hellen
ἐλπίζω	to hope for, look for, expect
ἐλπίς	hope, expectation
ἐμαυτοῦ	of me, of myself
ἐμβάλλω	to throw in, put in
ἐμέω	to vomit, throw up
ἐμμένω	to abide in
ἐμός	mine
ἐμπίπτω	to fall in or upon or into
ἐμπόριον	the Exchange
ἐμπόριος	
ἔμπροσθεν	before, in front
ἔμφυτος	implanted, innate, natural
ἐμφύω	to implant
ἐν	in, among. c. dat.
ἐναντίον	
ἐναντιόομαι	to set oneself against, oppose, withstand
ἐναντίος	opposite
ἐναύω	
ἐνδείκνυμι	to mark, point out
ἕνδεκα	eleven
ἔνδοξος	held in esteem or honour, of high repute
ἔνειμι	to be in
ἕνεκα	on account of, for the sake of, because of, for
ἐνιαυτός	any long period of time, a cycle, period
ἔνιοι	some
ἐνίοτε	sometimes
ἐνίστημι	to put, set, place in
ἕνος	belonging to the former of two periods, last year's
ἐνοχλέω	to trouble, disquiet, annoy
ἔνοχος	held in
ἐνταῦθα	here, there
ἐντός	within, inside
ἐντυγχάνω	to light upon, fall in with, meet with
ἕξ	six
ἐξαγγέλλω	to send out
ἐξάγω	to lead out
ἑξακισχίλιοι	six thousand
ἐξαπατάω	to deceive or beguile thoroughly
ἐξαπάτη	gross deceit
ἔξειμι	to go out, come out
ἐξελαύνω	to drive out from
ἐξελέγχω	to convict, confute, refute
ἐξεπίτηδες	of set purpose
ἐξέρχομαι	to go or come out of
ἔξεστι	it is allowed, it is in one's power, is possible
ἐξετάζω	to examine well or closely, inquire into, scrutinise, review
ἑξήκοντα	sixty
ἐξίημι	to send out, let
ἐξόριστος	expelled, banished
ἔξω	out
ἐξώλης	utterly destroyed
ἔοικα	to be like
ἐοικότως	similarly, like
ἐπαινέω	to approve, applaud, commend
ἐπακολουθέω	to follow close upon, follow after
Ἐπαμινώνδης	
ἐπανίστημι	to set up again
ἐπανορθόω	to set up again, restore
ἐπεί	after that, after (postquam), since, when (quum)
ἐπειδάν	whenever.
ἔπειμι	to be upon
ἔπειτα	thereupon
ἐπέρχομαι	to come upon, come near, come suddenly upon
ἐπί	on, upon with gen., dat., and acc.
ἐπιβαίνω	to go upon
ἐπιβλέπω	to look upon, look attentively
ἐπιβουλεύω	to plan or contrive against
Ἐπιγένης	
ἐπιγίγνομαι	to be born after, come into being after
ἐπιγράφω	to mark the surface, just pierce, graze
ἐπιδέχομαι	to admit besides or in addition
ἐπιδίδωμι	to give besides
ἐπιλήθω	to cause to forget
ἐπιμέλεια	care, attention
ἐπιμελητής	one who has charge of
ἐπιορκέω	to swear falsely, forswear oneself
ἐπίορκος	sworn falsely
ἐπισκήπτω	to make to lean upon, make to fall upon
ἐπίσταμαι	to know
ἐπιστολή	a message, command, commission
ἐπισφαλής	prone to fall, unstable, precarious
ἐπιτάσσω	to put upon
ἐπιτήδειος	made for an end or purpose, fit or adapted for it, suitable, convenient
ἐπιτίθημι	to lay, put or place upon
ἐπιτιμάω	to lay a value upon
ἐπίτιμος	in possession of his rights and franchises
ἐπιτρέπω	to turn towards
ἐπιχειρέω	to put one's hand on
ἐπιχείρησις	an attempt, attack
ἐράω	
ἐργάζομαι	to work, labour
ἔργνυμι	to confine
ἔργον	work
ἔρδω	to do
Ἐρέτρια	
ἐρέω	to ask, enquire
ἐρημία	a solitude, desert, wilderness
ἔρομαι	to ask, enquire
Ἑρχιέως	
ἔρχομαι	to come or go
ἐρῶ	I will say or speak
ἐσθίω	to eat
ἔσθω	to eat
ἔστε	up to the time that, until
ἑστία	the hearth of a house, fireside
ἑστιάω	to receive at one's hearth or in one's house: to entertain, feast, regale
ἕστιος	
ἐσχατάω	to be at the edge, on the border
ἔσχατος	outermost
ἐτάζω	to examine, test
ἕτερος	one of the
ἔτι	yet, as yet, still
ἑτοῖμος	at hand, ready, prepared
ἔτος	a year
εὖ	well
Εὔβοια	Euboea
Εὔβουλος	
εὐδαιμονία	prosperity, good fortune, wealth, weal, happiness
εὔελπις	of good hope, hopeful, cheerful, sanguine
εὐεργεσία	well-doing
εὐεργετέω	to do well, do good
εὐήθεια	goodness of heart, good nature, guilelessness, simplicity, honesty
εὐθύδικος	righteous-judging
Εὐθύμαχος	
εὐθύς	
εὔνοια	good-will, favour, kindness
εὔνους	well-minded, well-disposed, kindly, friendly
εὔορκος	keeping one's oath, faithful to one's oath
εὑρίσκω	to find
εὐσέβεια	reverence towards the gods, piety, religion
εὐσεβής	righteous
εὐτυχέω	to be well off, successful, prosperous
εὐτύχημα	a piece of good luck, a happy issue, a success
εὐφημία	the use of words of good omen
εὐχερής	easily handled, easy to deal with, easy
εὔχομαι	to pray, offer prayers, pay one's vows, make a vow
εὔψυχος	of good courage, stout of heart, courageous
ἐφηβάω	to come to man's estate, grow up to manhood
ἔφηβος	one arrived at puberty
Ἐφιάλτης	
ἐφιάλτης	
ἐφίστημι	to set or place upon
ἐχθρός	hated, hateful
ἔχις	an adder, viper
ἔχω	to have or to hold
ἕως	until, till
ζάω	to live
Ζελείτην	
ζεῦγος	a yoke of beasts, a pair of mules, oxen or horses
Ζεύς	Zeus
ζέω	to boil, seethe
ζηλόω	to rival, vie with, emulate
ζημία	loss, damage
ζημιόω	to cause loss or do damage to
ζητέω	to seek, seek for
ζήτησις	a seeking, seeking for, search for
ζητητής	a seeker, inquirer
ζητητός	sought for
ᾗ	which way, where, whither, in or at what place
ἦ	in truth, truly, verily, of a surety
ἤ	
ἡγεμονία	a leading the way, going first
ἡγεμών	one who leads
ἡγέομαι	to go before, lead the way
ἤδη	by this time, before this, already
ἦδος	delight, enjoyment, pleasure
ἦθος	an accustomed place
ἥκω	to have come, be present, be here
Ἠλεῖος	
ἡλικία	time of life, age
ἡλίκος	as big as
ἡμέρα	day
ἥμερος	tame, tamed, reclaimed
ἡμέτερος	our
ἠμί	I say
ἡμός	
ἡνίκα	at which time, when
ἤπειρος	terra-firma, the land
Ἡράκλεα	
Ἡρακλέης	Heracles
ἥρως	warriors
ἥσσων	less, weaker, less brave
ἡσυχία	stillness, rest, quiet
ἤτοι	now surely, truly, verily
ἠώς	the morning red, daybreak, dawn
θάλασσα	the sea
θαλλός	a young shoot, young branch
θάνατος	death
θανατόω	to put to death
θαρσέω	to be of good courage, take courage
θαυμάζω	to wonder, marvel, be astonied
θαυμάσιος	wondrous, wonderful, marvellous
θεά	a goddess
θέα	a seeing, looking at, view
Θεαγένης	
θεμίστιος	
Θεμιστοκλέης	
Θεμιστοκλῆς	
θεός	God
θέω	to run
θεωρέω	to look at, view, behold
Θῆβαι	Thebes
Θηβαῖος	Theban
Θήβη	
θήκη	a case to put anything in, a box, chest
θηράω	to hunt or chase
θηρίον	a wild animal, beast
θηριόω	to make into a wild beast.
θνήσκω	to die, be dying
θρασύβουλος	bold in counsel
Θρασυβούλος	
Θράσωνος	
θυσία	an offering or mode of offering
θυσιάζω	to sacrifice
ἴδιος	one's own, pertaining to oneself
ἰδίω	to sweat
ἶδος	violent heat
ἱερά	
ἱεραί	
ἱεράομαι	to be a priest or priestess
ἱερεία	
ἱέρεια	a priestess
ἱερή	
ἱερόν	
ἱερός	super-human, mighty, divine, wonderful
ἱερόω	to hallow, consecrate, dedicate
ἵημι	to set a going, put in motion
ἱκανός	becoming, befitting, sufficing
ἱκανόω	to make sufficient, qualify
ἱκετεύω	to approach as a suppliant
ἱκετήριος	of or fit for suppliants
ἴλαος	propitious, gracious
ἵνα	in that place, there
Ἰνδός	an Indian
ἱππαρχέω	to command the cavalry
ἱππικός	of a horse or horses
ἰσθμός	any narrow passage
ἴσος	equal to, the same as
ἰσόω	to make equal
ἵστημι	to make to stand
ἰσχυρίζομαι	to make oneself strong, to be strong, gain force
ἰσχύς	strength
ἴσχυσις	
ἰσχύω	to be strong
ἴσως	equally, in like manner
Ἰφικράτης	
Καδμεῖος	Cadmean
καθά	according as, just as
καθάπτω	to fasten, fix or put upon
κάθαρμα	that which is thrown away in cleansing;
καθεστῶτα	
καθίζω	to make to sit down, seat
καθίημι	to send down, let fall
καθιστάω	
καθίστημι	to set down, place
καθό	in so far as, according as
κάθοδος	a going down, descent
καί	and
καινός	new, fresh
καιρός	due measure, proportion, fitness
καίτοι	and indeed, and further
κάκη	wickedness, vice
κακοδαιμονάω	to be tormented by an evil genius, be like one possessed
κακοδαιμονέω	to be unfortunate
κακόνους	ill-disposed, disaffected
κακός	bad
κακοῦργος	doing ill, mischievous, knavish, villanous
κάκουργος	
κακόω	to treat ill, maltreat, afflict, distress
καλέω	to call, summon
κάλη	
καλλίας	
Καλλίης	
Καλλιμέδοντα	
κάλλιον	
Κάλλιον	
καλοκαγαθία	
καλός	beautiful, beauteous, fair
κἀν	and if, even if, although
κατά	down, downwards, with gen. or acc.
καταβαίνω	to step down, go or come down
καταγελάω	to laugh at, jeer or mock at
καταγιγνώσκω	to remark, discover
κατάγω	to lead down
καταδουλόω	to reduce to slavery, enslave
καταίρω	to come down, make a swoop
καταισχύνω	to disgrace, dishonour, put to shame
κατακομίζω	to bring down
καταλαμβάνω	to seize upon, lay hold of
καταλείπω	to leave behind
κατάληψις	a seizing
κατάλυσις	a dissolving, dissolution
καταλύω	to put down, destroy
καταμαρτυρέω	to bear witness against
καταναυμαχέω	to conquer in a sea-fight
καταπέμπω	to send down
καταπλάσσω	to plaster over with
καταπλέω	to sail down
καταπληκτέον	
καταπληκτέος	
καταπλήσσω	to strike down
κατάπλοος	a sailing down to land, a putting ashore, putting in
κατάπτυστος	to be spat upon, abominable, despicable
κατάρατος	accursed, abominable
καταρρᾳθυμέω	to lose from carelessness
κατασκευάζω	to equip or furnish fully
κατασκευή	preparation
καταστρέφω	to turn down, trample on
καταφεύγω	to flee for refuge
καταφρονέω	to think down upon
καταφυγή	a refuge, place of refuge
καταχαρίζομαι	to do or give up
καταχειροτονέω	to vote against, to vote in condemnation of
καταχωνεύω	to melt down
καταψεύδομαι	to tell lies against, speak falsely of
καταψηφίζομαι	to vote against or in condemnation of
κάτειμι	to go or come down
κατέχω	to hold fast
κατηγορέω	to speak against, to accuse
κατηγόρημα	an accusation, charge
κατηγορία	an accusation, charge
κατήγορος	an accuser
κατία	
κατοικίζω	to remove to
κατορθόω	to set upright, erect
κάτος	
κάτω	down, downwards
κεῖμαι	to be laid
κέλευσις	
κελεύω	to urge or drive on, urge, exhort, bid, command, order
κενός	empty
κενόω	to empty out, drain
Κέρκυρα	Corcyra
κεφαλή	the head
Κέφαλος	
κηδεμών	one who is in charge
κήδω	to trouble, distress, vex
κήλη	a tumor
κηρύκειον	a herald's wand
κηρύκειος	
κῆρυξ	a herald, pursuivant, marshal, public messenger
Κηφισοφῶν	
κιθαρίστρια	
κίναδος	a fox
κινδυνεύω	to be daring, to make a venture, take the risk, do a daring thing
κίνδυνος	a danger, risk, hazard, venture, enterprise
κλαίω	to weep, lament, wail
κλέπτης	a thief
κλέπτω	to steal, filch, purloin
κλῆρος	a lot;
Κνίδος	
κοινῇ	
κοινός	common, shared in common
κοινόω	to make common, communicate, impart
κοινωνέω	to have or do in common with, have a share of or take part in
κοινωνός	a companion, partner
κολάζω	to curtail, dock, prune
κολακεία	flattery, fawning
κολακεύω	to flatter
Κολλυτέα	
κομίζω	to take care of, provide for
Κόνων	
κόσμος	order
κρείσσων	stronger, mightier, more powerful
κριθάω	to be barley-fed, to wax wanton
κρίνω	to pick out, choose
κρίσις	a separating, power of distinguishing
κριτής	a decider, judge, umpire
κριτός	picked out, chosen
κτάομαι	to procure for oneself, to get, gain, acquire
κτέομαι	
κτῆμα	anything gotten, a piece of property, a possession
Κτήσιππος	
Κυδαντίδην	
Κυδιμάχου	
κυρέω	to hit, light upon
κυρία	
κύριος	a lord, master
κῦρος	supreme power, authority
κωλύω	to let, hinder, check, prevent
λαγχάνω	to obtain by lot, by fate, by the will of the gods
Λακεδαιμόνιος	
λαμβάνω	to take
λαμπρός	bright, brilliant, radiant
λανθάνω	to escape notice, to be unknown, unseen, unnoticed
λάπτω	to lap with the tongue
λέγος	
λέγω	
λείπω	to leave, quit
Λεῦκτρον	
λῆμμα	anything received, income
λίαν	very, exceedingly
λιμήν	a harbour, haven, creek
λιμός	hunger, famine
λογίζομαι	to count, reckon, calculate, compute
λογογράφος	a prose-writer
λογόγραφος	
λογοποιέω	to invent stories, to write, compose
λογοποιός	a prose-writer
λόγος	the word or that by which the inward thought is expressed
λοιδορέω	to abuse, revile
λοιπάς	
λοιπός	remaining, the rest
λόχος	an ambush
Λυκοῦργος	
λυμαίνομαι	to treat with indignity, to outrage, to maltreat
λυσιτελέω	to pay what is due
λύω	to loose
μά	in affirmation
μαίνομαι	to rage, be furious
Μακεδών	a Macedonian
μακρολογέω	to speak at length, use many words
μακρός	long
μάλιστα	
μᾶλλον	
μανθάνω	to learn
μανία	madness, frenzy
μαντεία	prophesying, prophetic power
μαντεῖος	oracular, prophetic
μαρτυρέω	to be a witness, to bear witness, give evidence, bear testimony
μαρτυρία	witness, testimony, evidence
μαρτύρομαι	to call to witness, attest, invoke
μάρτυς	a witness
μάχη	battle, fight, combat
μάχομαι	to fight
Μέγαρα	Megara
μέγαρον	a large room or chamber
Μέγαρος	
μέγας	big, great
μέδιμνος	the medimnus
μεθό	after that.
Μεθώνη	
μείς	a month
μέλλω	to think of doing, intend to do, to be about to do
μέλος	a limb
μέλω	to be an object of care or thought
μέν	on the one hand, on the other hand
μέντοι	
μένω	to stay at home, stay where one is, not stir
Μένων	
μερίζω	to divide, distribute
μερίς	a part, portion, share, parcel
μέρος	a part, share
μέση	
μέσης	
μέσος	middle, in the middle
Μεσσήνη	
μετά	in the midst of, among with gen., dat., and acc.
μεταβάλλω	to throw into a different position, to turn quickly
μεταβολή	a change, changing
μεταγράφω	to write differently, to alter or correct what one has written
μεταί	
μεταλαμβάνω	to have or get a share of, to partake of
μεταλήγω	to leave off, cease from
μεταλλάσσω	to change, alter
μεταξύ	betwixt, between
μετά-οἰωνίζομαι	
μεταπίπτω	to fall differently, undergo a change
μετασκευάζω	to put into another dress
μέτειμι	to be among
μέτριος	within measure
μετριότης	moderation
μέχρι	to a given point, even so far
μή	not
μηδέ	but not or and not, nor
μηδείς	and not one
μηδεπώποτε	never yet
Μῆδος	a Mede, Median
Μήδων	
μήν	now verily, full surely
μηνυτής	bringing to light
μήποτε	never, on no account
μής	
μήτε	and not
μήτηρ	a mother
μήτις	lest any one, lest anything; that no one, that nothing
μιαρός	stained
μικρός	small, little
μιμνήσκω	to remind, put
μισέω	to hate
μισθαρνέω	to work or serve for hire
μισθάρνης	a hired workman
μισθός	wages, pay, hire
μισθόω	to let out for hire, farm out, let
μισθωτός	hired
μισόδημος	hating the commons
μῖσος	hate, hatred
μνᾶ	a weight, =
μνῆμα	a memorial, remembrance, record
μνήμη	a remembrance, memory, record
μνημονεύω	to call to mind, remember
μόλις	not scarcely
μόνος	alone, left alone, forsaken solitary
μονόω	to make single or solitary
μόνως	
μόρα	a mora, one of the six regiments
Μουνιχίη	
μοχθηρός	suffering hardship, in sore distress, miserable, wretched
μυλωθρός	a miller
μυλών	a mill-house
μυρίος	numberless, countless, infinite
ναί	yea, verily
ναξος	
Νάξος	Naxos
ναῦλον	
ναῦλος	passage-money, the fare or freight
ναυμαχία	a sea-fight
ναῦς	a ship
ναυτικός	seafaring, naval
νεώρης	new, fresh, late
νεώριον	a place were ships are taken care of, a dockyard
νεώσοικος	a dock
νή	
Νικάνωρ	
νικάω	to conquer, prevail, vanquish
Νικόδημος	
Νικοφάνην	
νομίζω	to hold or own as a custom or usage, to use customarily, practise
νόμιμος	conformable to custom, usage
νομοθετέω	to make law
νομοθέτης	a lawgiver
νόμος	anything assigned, a usage, custom, law, ordinance
νῦν	now at this very time
νυνί	now, at this moment
ξένος	
ὁ	the, that
ὁδός	
ὀδύρομαι	to lament, bewail, mourn for
ὅθι	
οἶδα	to know
οἴκαδε	to one's home, home, homewards
οἰκεῖος	in or of the house, domestic
οἰκειόω	to make one's own
οἰκείω	
οἰκέω	to inhabit, occupy
οἴκημα	any inhabited place, a dwellingplace
οἰκία	a building, house, dwelling
οἰκοδόμημα	a building, structure
οἴκοι	at home, in the house
οἰκονομία	the management of a household or family, husbandry, thrift
οἶκος	a house, abode, dwelling
οἰκουμένη	the inhabited world
οἰκουρός	watching the house
οἰκτίζω	to pity, have pity upon
οἶκτος	pity, compassion
οἰκτρός	pitiable, in piteous plight
οἴμη	a song, lay
οἴομαι	to suppose, think, deem, imagine
οἷος	such as, what sort or manner of nature, kind
οἴχομαι	to be gone, to have gone
ὀκτώ	
ὁλάω	
ὀλιγαρχικός	oligarchical, of, for or like oligarchy
ὀλίγος	few, little, scanty, small
ὅλοξ	whole, entire, complete
ὅλος	
Ὀλυμπία	Olympia
Ὀλυμπίας	
Ὀλύνθιος	
ὄμνυμι	to swear
ὁμοθυμαδόν	with one accord
ὅμοιος	like, resembling
ὁμοῖος	
ὁμοιόω	to make like
ὁμολογέω	to speak together
ὁμονοέω	to be of one mind, agree together, live in harmony
ὁμόνοια	oneness of mind or thought, unity, concord
ὁμόσπονδος	sharing in the drink-offering, sharing the same cup
ὁμοτράπεζος	eating at the same table with
ὁμόω	to unite
ὅμως	all the same, nevertheless, nothwithstanding, still
ὀνειδίζω	to throw a reproach upon
ὄνομα	by name
ὄντα	existing things, the present
ὅπλον	a tool, implement
ὅποι	to which place, whither
ὁποῖος	of what sort or quality
ὅπου	in some places
ὅπως	as, in such manner as
ὁπωσοῦν	in any way whatever, in some way or other
ὁράω	To see
ὀργή	natural impulse or propension: one's temper, temperament, disposition, nature
ὀργίζω	to make angry, provoke to anger, irritate
Ὀρέστης	
ὀρέστης	
ὀρθός	straight
ὀρθόω	to set straight
ὁρίζω	to divide or separate from, as a boundary
ὅρκος	the object by which one swears, the witness of an oath
ὁρκόω	to bind by oath
ὁρμάω	to set in motion, urge
ὅρος	a boundary, landmark
ὄρυγμα	a trench, ditch, moat
ὅς	this, that;
ὁσία	divine law, natural law
ὅσιος	hallowed, sanctioned by the law of God
ὅσος	quantus
ὅσπερ	the very man who, the very thing which
ὅστε	who, which
ὅστις	any one who, anything which
ὅταν	whenever
ὅτε	when
ὅτι	
ὁτιοῦν	whatsoever
οὐ	not
οὗ	where
οὐδαμός	not even one, no one
οὐδαμοῦ	nowhere
οὐδέ	but not
οὐδείς	and not one
οὐδεπώποτε	nor yet at any time, never yet at any time
οὐδός	
οὐκέτι	no more, no longer, no further
οὐκοῦν	therefore, then, accordingly
οὖν	really, at all events
οὐρανός	heaven
οὐσία	that which is one's own, one's substance, property
οὖσον	
οὔτε	and not
οὔτι	not, I suppose . . , surely you do not mean that . .
οὔτις	no one or nobody
οὗτος	this
οὕτως	in this way or manner, so, thus
ὀφείλω	to owe, have to pay or account for
ὀφθαλμός	the eye
ὀφλισκάνω	to owe, to be liable to pay
πάγος	that which is fixed or firmly set
πᾶγος	
παιδίσκη	a young girl, maiden
παιδοποιέω	to beget children
παῖς	a child
πάλα	
πάλαι	long ago, in olden time, in days of yore, in time gone by
παλαιός	old in years
πάλη	wrestling
πάλιν	back, backwards
πάλλω	to poise or sway
πᾶλος	
πάλος	the lot cast from a shaken helmet
Πάμφιλος	
πανταχόθεν	from all places, from all quarters, on every side
πάντῃ	
παντοδαπός	of every kind, of all sorts, manifold
πάομαι	to get, acquire
παρά	from the side of, c. gen., beside, alongside of, c. dat., to the side of, motion alongside of, c. acc.
παραβαίνω	to go by the side of
παραβάλλω	to throw beside or by, throw to
παραγγέλλω	to transmit as a message
παραγίγνομαι	near, attend upon
παράδειγμα	a pattern or model
παραδίδωμι	to give or hand over to another, transmit
παρακαταθήκη	a deposit entrusted to one's care
παρακατατίθεμαι	to deposit one's own property with
παρακελεύομαι	to order
παρακρούω	to strike aside: to disappoint, mislead
παραλαμβάνω	to receive from
παράνομος	acting contrary to law, lawless
παράπτω	to fasten beside
παρασκευάζω	to get ready, prepare
παράταξις	a placing in line of battle
παρατάσσω	to place side by side, draw up in battle-order
παραχρῆμα	on the spot, forthwith, straightway
παραχώννυμι	to throw up beside
παρεῖδον	to observe by the way, notice
πάρειμι	to be by or present
πάρεργον	a bye-work, subordinate or secondary business, appendage, appendix
πάρεργος	
παρέργως	
παρέρχομαι	to go by, beside or past, to pass by, pass
παρέχω	to hold beside, hold in readiness, to furnish, provide, supply
παρίστημι	to make to stand or to place beside
παροξύνω	to urge, prick or spur on, stimulate
παρρησία	freespokenness, openness, frankness
πᾶς	all, the whole
πᾶσις	
πάσσω	to sprinkle
πάσχω	to receive an impression from without, to suffer
πάτηρ	
πατήρ	a father
πατρικός	derived from one's fathers, paternal, hereditary
πάτριος	of or belonging to one's father
πατρίς	of one's fathers
πατρῷος	of or from one's father, coming or inherited from him
παύω	to make to cease
πεζός	on foot
πείθω	to prevail upon, win over, persuade
πεῖρα	a trial, attempt, essay, experiment
Πειραιεύς	Peiraeeus
πείρω	to pierce quite through, fix
Πελλήνη	
Πελοπίδης	
Πελοπόννησος	the Peloponnesus
πέμπτος	the fifth, oneself with four others
πέμπω	to send, despatch
πένης	one who works for his daily bread, a day-labourer, a poor man
πεντακόσιοι	five hundred
πέντε	five
πεντεδραχμία	
πεντεκαίδεκα	fifteen
πεντήκοντα	fifty
πέρα	beyond, across or over, further
πέρας	an end, limit, boundary
περάω	
πέρθω	to waste, ravage, sack, destroy
περί	around, round about with gen., dat., and acc.
περιβόητος	noised abroad, much talked of, famous
περί-εἶδον	
περίειμι	to be around
περί-εἶμι	
περιέρχομαι	to go round, go about
περί-ἵημι	
περιίστημι	to place round
περιοράω	to look over, overlook
περιπατέω	to walk up and down, to walk about
περιπίτνω	
περιπλέω	to sail or swim round
περιποιέω	to make to remain over and above, to keep safe, preserve
περιπορεύομαι	to travel or go about
περιχαρακόω	to surround with a stockade
Πέρσης	a Persian, inhabitant of Persis
πηρός	disabled in a limb, maimed
πίμπλημι	to fill full of
πιπράσκω	to sell
πιστευτέος	
πιστεύω	to trust, trust to or in, put faith in, rely on, believe in
Πιστίας	
πίστις	trust
πιστόν	
πιστός	
πλεῖστος	most, largest
πλείων	more, larger
πλεονάκις	more frequently, oftener
πλεονεξία	the character and conduct of a πλεονέκτης, greediness, grasping, assumption, arrogance
πλέος	full.
πλέω	to sail, go by sea
πλέως	full of
πλῆθος	a great number, a throng, crowd, multitude
πλημμελέω	to make a false note in music
πλήν	more than
πλησίος	near, close to
πλούσιος	rich, wealthy, opulent
πόα	grass, herb
ποι	somewhither
ποῖ	whether?
ποιέω	to make
ποίησις	a making, fabrication, creation, production
ποιός	of a certain nature, kind or quality
ποῖος	of what nature? of what sort?
πολεμέω	to be at war or go to war, make war
πολεμικός	of or for war
πολέμιος	of or belonging to war
πόλεμος	battle, fight, war
πολεμόω	to make hostile, make an enemy of
πολέω	to go about, range over
Πολιάδης	
Πολιάς	guardian of the city
πόλις	a city
πολιτεία	the condition and rights of a citizen, citizenship
πολιτεύω	to live as a citizen or freeman, live in a free state
πολίτης	a member of a city or state
πολλάκις	many times, often, oft
Πολυεύκτος	
πολύευκτος	much-wished-for, much-desired
πολύς	many
πονηρία	a bad state or condition, badness
πονηρός	toilsome, painful, grievous
ποντίζω	to plunge in the sea
Πόντος	
πορεύω	to make to go, carry, convey
πορθμεύς	a ferryman
πορίζω	to carry: to bring about, to furnish, provide, supply, procure, cause
Ποσειδῶν	Poseidon
ποτέ	at some time or other, at some time
πότε	when? at what time?
Ποτείδαια	
Ποτειδαία	
πότερος	whether of the two?
ποτή	flight
ποτόν	
ποτός	drunk, fit for drinking
πότος	drinking, a drinking-bout, carousal
ποῦ	where?
πού	anywhere, somewhere
πούς	a foot
πρᾶγμα	that which has been done, a deed, act
πρᾶξις	a doing, transaction, business
πρᾶος	Mild, soft, gentle, meek
πράσσω	to pass over
πρέσβεια	
πρεσβεία	age, seniority
πρεσβευτής	an ambassador
πρεσβεύω	to be the elder or eldest
πρέσβις	age
πρέσβος	an object of reverence
πρέσβυς	an old man
πρίν	comparative
πρό	before
προαιρέω	to bring forth, produce from one's stores
προβάλλω	to throw before, throw or toss to
προγίγνομαι	to come forwards
πρόγονος	a forefather, ancestor
προδίδωμι	to give beforehand, pay in advance
προδοσία	a giving up, betrayal, treason
προδότης	a betrayer, traitor
προεδρία	the privilege of the front seats
προερέω	to say beforehand
προετέος	
πρό-ἰάομαι	
προίημι	to send before, send on or forward
προίξ	a gift, present
προίστημι	to set before or in front
προκαταλαμβάνω	to seize beforehand, preoccupy
πρόκλησις	a calling forth, challenging, challenge
προλέγω	
πρόνοια	foresight, foreknowledge
Πρόξενος	
πρόξενος	a public
προοράω	to see before one, see what is just before the eyes
πρός	motion from
προσάγω	to bring to or upon
προσγίγνομαι	to come or go to, to attach oneself to
προσγράφω	to write besides, add in writing
προσδεκτέος	
προσδέχομαι	to receive favourably, accept
προσδοκάω	to expect
προσδοκέω	to be thought besides
προσδοκητέος	
πρόσειμι	
προσεκτέος	one must apply
προσέρχομαι	to come or go to
προσέχω	to hold to, offer
προσήκω	to have arrived at
προσίημι	to send to or towards, let come to
προσκρούω	to strike against
προσποιέω	to make over to
προσποίητος	
προσράπτω	to stitch on
προσστάζω	to drop on, shed over
πρόσταγμα	an ordinance, command
προστάσσω	to place or post at
προστατέω	to stand before, be ruler over, domineer over
προστάτης	one who stands before, a front-rank-man
προστίθημι	to put to
πρόσωπον	the face, visage, countenance
πρότερος	prae.
προτρέπω	to urge forwards
προὔργου	serving for or towards a work, serviceable, profitable, useful
πρόφασις	that which is alleged as the cause, an allegation, plea
προφέρω	to bring before
προχειρίζω	to put into the hand, have ready at hand
προῶνται	
πρυτανεῖον	the presidents' hall, town-hall
πρυτάνειος	
πρύτανις	a prince, ruler, lord, chief
πρώην	lately, just now
πρῶτος	
Πύδνα	
Πυθοκλέης	
πύθω	to make rot, to rot
Πυθώνακτος	
πυνθάνομαι	to learn by hearsay or by inquiry
πῦρ	fire
πυρά	watch-fires
πυρή	any place where fire is kindled
πυρός	wheat
πυρόω	to burn with fire, burn up
πωλέω	to exchange or barter
πώποτε	ever yet
πῶς	how? in what way or manner?
πως	in any way, at all, by any means
ῥᾴδιος	easy, ready, easy to make or do
ῥᾳθυμία	easiness of temper, a taking things easily
ῥᾴθυμος	taking things easy, indifferent, lazy, sluggish
ῥήτωρ	a public speaker, pleader
Ῥοδιακός	Rhodian, of Rhodes
Ῥόδιος	
Ῥοδίος	
Σάμος	Samos
Σάτυρος	a Satyr
σαυτοῦ	
σαφής	clear, plain, distinct, manifest
σεμνός	revered, august, holy, awful
σεμνύνω	to exalt, magnify
σεύω	to put in quick motion: to drive, hunt, chase away
σήμερον	to-day
σής	a moth
σίτησις	an eating, feeding
σκέπτομαι	to look about, look carefully
σκηνή	a covered place, a tent
σκοπέω	to look at or after
Σκύθης	a Scythian
σμικρός	
σός	thy, thine, of thee
σοῦ	shoo! shoo!
σπανίζω	to be rare, scarce, scanty
σπείρω	to sow
σπουδάζω	to make haste
σπουδαῖος	earnest, serious
στατήρ	gold stater
στερκτέος	
στήλη	a block of stone
στρατεία	an expedition, campaign
στρατεύω	to serve in war, serve as a soldier, do military service, take the field, march
στρατηγέω	to be general
στρατηγός	the leader or commander of an army, a general
Στρατοκλέης	
στρεβλόω	to twist or strain tight
σύ	
συγγενής	born with, congenital, natural, in-born
συγγνώμη	acknowledgment, confession
συγχέω	to pour together, commingle, confound
συγχωρέω	to come together, meet
συκοφαντέω	to accuse falsely, slander, calumniate
συκοφάντης	a false accuser, slanderer
συκοφαντία	
συκοφαντίας	
συκοφαντίης	the Sycophant-wind
συλλέγω	to collect, gather
συμβαίνω	to stand with the feet together
συμβουλεύω	to advise, counsel
συμβουλή	counsel, consultation, deliberation, debate
συμβουλία	advice or counsel given
σύμβουλος	an adviser, counsellor
σύμμαχος	fighting along with, allied with
συμπαρακαλέω	to invite together or at the same time
συμπλέκω	to twine or plait together
συμπολιτεύω	to live as fellow-citizens or members of one state
συμπράσσω	to join or help in doing
συμφερόντως	profitably
συμφέρω	to bring together, gather, collect
συμφορά	an event, circumstance, chance, hap
συμφορέω	to bring together, to gather, collect, heap up
συνάγω	to bring together, gather together, collect, convene
συναπολογέομαι	to join in defending
συνδιαφθείρομαι	to perish along with
συνέδριον	a body of men assembled in council, a council-board, council
συνεθίζω	to accustom
σύνειμι	
συνεργία	joint working, cooperation
συνέρχομαι	to go together or in company
συνευπορέω	to help to contribute
συνηγορέω	to be an advocate
συνθήκη	a composition
σύνθημα	anything agreed upon, a preconcerted signal
συνίημι	to bring or set together
συνίστημι	to set together, combine, associate, unite, band together
σύν-λέγω	
σύνοιδα	to share in knowledge, be cognisant of
σύνοικος	dwelling in the same house with
συντάσσω	to put in order together
συσκευάζω	to make ready by putting together, to pack up
συσσιτέω	to mess with
σφόδρα	very, very much, exceedingly, violently
σώζω	to save, keep
σῶμα	the body
σωτήρ	a saviour, deliverer, preserver
σωτηρία	a saving, deliverance, preservation, safety
σωτήριος	saving, delivering
σωφρονέω	to be sound of mind
σώφρων	of sound mind
ταλαίπωρος	suffering, miserable
τάλαντον	a balance
τάξις	an arranging
ταπεινός	low
ταπεινόω	to lower
ταράσσω	to stir, stir up, trouble
τάσσω	to arrange, put in order
Ταυροσθένης	
ταύτῃ	in this way.
ταὐτός	
τάχα	quickly, presently, forthwith
τε	and
τειχέω	to build walls
τεῖχος	a wall
τεκμαίρομαι	to fix by a mark or boundary, to ordain, decree
τέκνον	that which is borne or born, a child
τελευταῖος	last
τελευτάω	to complete, finish, accomplish
τελέω	to complete, fulfil, accomplish
τέλλω	to make to arise, accomplish
τέλος	the fulfilment or completion
τέσσαρες	four
τετράκις	four times
τετρακοσιοστός	
τῇ	here, there
τηλικοῦτος	
τηνικαῦτα	at that time, then
τηρέω	to watch over, protect, guard
τίθημι	to set, put, place
τιμάω	to pay honour to, hold in honour, to honour, revere, reverence
τιμή	that which is paid in token of worth or value
τίμημα	an estimate, valuation
τίμησις	a valuation
Τιμόθεος	
Τιμόλαος	
τιμωρέω	to help, aid, succour
τιμωρία	help, aid, assistance, succour
τίνω	to pay a price
τις	any one, any thing, some one, some thing;
τίς	who? which?
τίσις	payment by way of return or recompense, retribution, vengeance
τοιγάρ	so then, wherefore, therefore, accordingly
τοίνυν	therefore, accordingly
τοιοῦτος	such as this
τόλμα	courage, to undertake or venture
τολμάω	to undertake, take heart
τολμηρός	hardihood
τόλμησις	
τόπος	a place
τοσοῦτος	so large, so tall
τότε	at that time, then
τοτέ	at times, now and then
τράπεζα	four-legged a table
τραπεζίτης	one who keeps a bank, a banker
τρεῖς	
τρέπω	to turn or direct
τρέφω	to thicken or congeal
τρέω	to flee from fear, flee away
τρία	
τριακόσιοι	three hundred
τριήραρχος	the captain of a trireme
τριήρης	
τρίς	thrice, three times
τρόπος	a turn, direction, course, way
τροπόω	to furnish the oar with its thong
τρυφάω	to live softly, delicately, luxuriously, to fare sumptuously
τρυφή	softness, delicacy, daintiness
τρύφος	that which is broken off, a piece, morsel, lump
τυγχάνω	to hit
τύραννος	an absolute sovereign
τύχη	the good which man obtains
τύχος	
τῷ	therefore, in this wise, thereupon
τῶνκατα	
ὑβρίζω	to wax wanton, run riot
ὕβρις	wantonness, wanton violence or insolence
ὑγιής	sound, healthy, hearty, sound in
ὕδωρ	water
υἱός	A son
ὑμέτερος	your, yours
ὑμός	your
ὑπάρχω	to begin, make a beginning
ὑπέρ	over, above, w. gen, over, beyond, w. acc.
ὑπερβολή	a throwing beyond
ὑπό	from under, by, c. gen. under, c. dat., towards c. acc.
ὑποδέχομαι	to receive beneath
ὑπολαμβάνω	to take up by getting under
ὑπολείπω	to leave remaining
ὑπολογίζομαι	to take into account, take account of
ὑπόλογος	
ὑπόλοιπος	left behind, staying behind
ὑπομένω	to stay behind, survive
ὑποστέλλω	to draw in
ὑπόσχεσις	an undertaking, engagement, promise
ὑποφαίνω	to bring to light from under
ὕστερον	
ὕστερος	latter, last
ὑφή	a web
φαίνω	to bring to light, make to appear
φάλαγξ	a line of battle, battle-array
φανερός	open to sight, visible, manifest, evident
φανερόω	to make manifest
φάσκω	to say, affirm, assert
φαῦλος	easy, slight
Φείδιππος	
φείδομαι	to spare
Φείδων	
φενακίζω	to play the
φενακισμός	cheatery, quackery, imposition
φέρω	to bear
φεύγω	to flee, take flight, run away
φημί	to declare, make known
φήνη	sea-eagle
φθείρω	to ruin, waste, spoil, destroy
φιλαργυρία	love of money, covetousness
φιλέω	to love, regard with affection
φιλία	friendly love, affection, friendship
φίλιος	of or from a friend, friendly
Φίλιππος	
Φιλοκλέης	
Φιλοκράτης	
φιλόπολις	loving the city
φίλος	loved, beloved, dear
φίλων	
φοβέω	to put to flight
φόβος	flight
φονάω	to be athirst for blood, to be murderous
φόνος	murder, homicide, slaughter
φορεῖον	a litter
Φορμίσιος	
Φορμίων	
φόρος	that which is brought in, tribute
φράζω	to point out, shew, indicate
φρονέω	to think, to have understanding, to be sage, wise, prudent
φρόνημα	one's mind, spirit
φροντίζω	to think, consider, reflect, take thought, have a care, give heed
φρούραρχος	commander of a watch or fortress
φρουρέω	to keep watch or guard
φυγάς	one who flees
φυγή	flight
φυλάζω	to divide into tribes
φυλακεύς	
φυλακή	a watching or guarding, watch, guard, ward
φύλαξ	a watcher, guard, sentinel
φυλάσσω	to keep watch and ward, keep guard
Φυλεύς	
Φυλή	
φυσάω	to puff or blow up, distend
φύσις	the nature, natural qualities, powers, constitution, condition
φύω	to bring forth, produce, put forth
Χαβρίης	
Χαιρέφιλον	
χαίρω	to rejoice, be glad, be delighted
Χαιρωνεία	
χαλεπός	hard to bear, painful, sore, grievous
χάλκεος	of copper or bronze, brasen
χαλκοῦς	a copper coin
χαλκόω	to make in bronze
Χαρίδημος	
Χαρῖνον	
χάρις	Grace
χάριτος	
χείρ	the hand
χειροτονέω	to stretch out the hand
χειροτονία	a voting or electing by show of hands
χειρόω	to bring into hand, to manage, master, subdue
χείρων	worse, meaner, inferior
χέω	to pour
χίλιοι	a thousand
χίλιος	
χῖον	
Χῖος	Chian, of or from Chios
Χίος	Chios
Χίων	
χόω	to throw or heap up
χράομαι	consulting or using an oracle
χραύω	to scrape, graze, wound slightly
χράω	
χρῆ	need, necessity
χρή	it is fated, necessary
χρῆμα	a thing that one uses
χρηματίζω	to negotiate, transact business, have dealings
χρήσιμος	useful, serviceable, good for use, good, apt or fit
χρηστός	useful, good of its kind, serviceable
χρόνος	time
χρύσεος	golden, of gold, decked or inlaid with gold
χρυσίον	a piece of gold
χρυσός	gold
χρυσόω	to make golden, gild
χώρα	the space in which a thing is
χωρίς	separately, asunder, apart, by oneself or by themselves
ψευδής	lying, false
ψεῦδος	a falsehood, untruth, lie
ψεύδω	to cheat by lies, beguile
ψηφίζομαι	
ψηφίζω	to count or reckon
ψήφισμα	a proposition carried by vote
ψῆφος	a small stone, a pebble, rubbed and rounded
ψήφων	
ψυχή	breath
ὦ	O! oh!
ὤεσθε	
ὠνέομαι	to buy, purchase
ὤνιος	to be bought, for sale
ὡς	thus, as, so that, since
ὥσπερ	just as if, even as
ὥστε	as, as being