Field1	Field2
Α	
Ἀαρών	
Ἀβαδδών	
ἀβαρής	without weight: not burdensome
Ἀββά	
Ἀβειληνῆς	
Ἅβελ	
Ἀβιά	
Ἀβιάθαρ	
Ἀβιούδ	
Ἀβρααμ	
Ἀβραάμ	
ἄβυσσος	with no bottom, bottomless, unfathomed
Ἄγαβος	
ἀγαθοεργέω	to do good
ἀγαθοεργός	doing good
αγαθόν	
ἀγαθοποιέω	to do good
ἀγαθοποιία	well doing
ἀγαθοποιός	doing good, beneficent
ἀγαθός	good
ἀγαθωσύνη	goodness, kindness
ἀγαλλίασις	great joy, exultation
ἀγαλλιάω	to rejoice exceedingly
ἄγαμαι	to wonder, be astonished
ἄγαμος	unmarried, unwedded, single
ἀγανακτέω	to feel irritation
ἀγανάκτησις	irritation
ἀγαπάζω	to treat with affection, shew affection to
ἀγαπάω	to treat with affection, to caress, love, be fond of
ἀγαπη	
ἀγάπη	love
ἀγάπησις	
αΓαπητοί	
ἀγαπητός	beloved
Ἅγαρ	
ἀγγαρεύω	to press
ἀγγεῖον	
ἀγγελία	a message, tidings, news
ἀγγέλλω	to bear a message
ἄγγελος	a messenger, envoy
αγγέλους	
ἄγγος	a vessel
ἄγε	come! come on! well!
ἀγείρω	to bring together, gather together
ἀγέλη	a herd
ἀγενεαλόγητος	of unrecorded descent
ἀγενής	
ἁγής	
ἁγιάζει	
ἁγιάζεται	
ἁγιαζόμενοι	
ἁγιαζομένους	
ἁγιάζον	
ἁγιάζω	
ἁγιάζων	
ἁγιάσαι	
ἁγιάσας	
ἁγιάσατε	
ἁγιάσῃ	
ἁγιασθήτω	
Ἁγιασθήτω	
ἁγιασμός	consecration, sanctification
ἁγίασον	
Ἅγιος	
ἅγιος	devoted to the gods, sacred, holy
ἁγιότης	
ἁγιωσύνη	holiness, sanctity
ἀγκάλη	the bent arm
ἄγκιστρον	a fish-hook
ἄγκυρα	anchor
ἄγναφος	uncarded
ἁγνίᾳ	
ἁγνίζω	to cleanse away
ἁγνισμός	
ἀγνοέω	not to perceive or know
ἀγνόημα	a fault of ignorance, error
ἄγνοια	want of perception, ignorance
ἁγνός	full of religious awe
ἁγνότης	purity, chastity
ἄγνυμι	to break, shiver
ἀγνωσία	ignorance
ΑΓΝΩΣΤΩ	
ἀγοπάσωσιν	
ἀγορά	an assembly of the people
ἀγοράζω	to be in the ἀγορά
ἀγοραῖος	in, of, or belonging to the ἀγορά
ἀγοράομαι	to meet in assembly, sit in debate
ἄγος	any matter of religious awe
ἀγός	a leader, chief
ἄγρα	a catching, hunting
ἀγράμματος	without learning
ἀγραυλέω	to dwell in the field
ἀγρεύω	to take by hunting or fishing, to catch, take
ἀγρέω	to capture, seize
ἀγριέλαιος	of a wild olive
ἄγριος	living in the fields
Ἀγρίππα	
Ἀγρίππας	
ἀγρός	fields, lands
ἀγρυπνέω	to lie awake, be wakeful
ἀγρυπνία	sleeplessness, waking, watching
ἄγω	to lead or carry, to convey, bring
ἀγωγεύς	one that draws or drags
ἀγωγή	a carrying away, carriage
ἀγών	a number of people brought together, a gathering, assembly
ἀγωνία	a contest, struggle for victory
ἀγωνίζομαι	to contend for a prize
Ἀδάμ	
ἀδάπανος	without expense, costing nothing
Ἀδδεί	
ἀδελ	
ἀδέλγεια	
ἀδελφή	a sister
αδελφοί	
ἀδελφός	sons of the same mother
ἀδελφότης	the brotherhood
αδελφῶν	
ἄδηλος	not seen or known, unknown, obscure
ἀδηλότης	
ἀδημονέω	to be sorely troubled
ᾅδης	
ἀδιάκριτος	undecided
ἀδιάλειπτος	unintermitting, incessant
ἀδικέω	to do wrong
ἀδίκημα	a wrong done, a wrong
ἀδικία	wrong-doing, injustice
ἄδικος	wrong-doing, unrighteous, unjust
Ἀδμείν	
ἀδόκιμος	not standing the test, spurious
ἄδολος	without fraud, guileless
ἅδος	satiety, loathing
Ἁδραμυντηνῷ	
Ἁδρίᾳ	
ἁδροτής	strength
ἀδυνατέω	to want strength
ἀδύνατος	unable
ἀεί	always, for ever
ἀείδω	to sing
ἀείρω	to lift, heave, raise up
ἀέκων	against one's will, unwilling
ἀετός	an eagle
ἄζυμος	unleavened
Ἀζώρ	
Ἄζωτος	
ἄζωτος	
ἀήρ	the lower air, the air
ἀθα	
ἀθανασία	immortality
ἀθέμιστος	lawless, without law
ἀθέμιτος	
ἄθεος	without God, denying the gods
ἄθεσμος	
ἀθετέω	to set aside
ἀθέτησις	
Ἀθῆναι	the city of Athens
Ἀθηναῖος	Athenian, of or from Athens
Ἀθήνη	Athena
ἀθλέω	having contended with
ἄθλησις	a contest, struggle
ἀθροίζω	to gather together, to muster
ἀθυμέω	to be disheartened, lose heart
ἀθῷος	unpunished, scot-free
Ἀθῷος	
αἰάζω	to cry αἰαῖ, to wail
αἰγιαλός	the sea-shore, beach, strand
αἰγίοις	
Αἰγύπτιος	Egyptian
Αἴγυπτος	the river Nile
Ἀἰγύπτῳ	
ἀίδιος	everlasting, eternal
αἰδώ	
αἰδώς	a sense of shame, shame, modesty, self-respect
Αἰθίοψ	burnt-face
αἷμα	blood
αἱμα	
αἵματ	
αἱματεκχυσία	shedding of blood
αἱματόω	to make bloody, stain with blood
αἱμορροέω	to have a αἱμόρροια
Αἰνείας	
αἴνεσις	praise
αἰνέω	to tell or speak of
αἴνη	praise, fame
αἴνιγμα	a dark saying, riddle
αἶνος	a tale, story
αἰνός	dread, dire, grim
Αἰνών	
αἵρεσις	a taking especially
αἱρετίζω	to choose, select
αἱρετικός	able to choose
αἱρέω	to take with the hand, grasp
αἴρω	to take up, raise, lift up
αις	
αἰσθάνομαι	to perceive, apprehend by the senses, to see, hear, feel
αἴσθησις	perception by the senses
αἰσθητήριον	an organ of sense
αἰσχροκερδής	sordidly greedy of gain
αἰσχρολογία	foul language, abuse
αἰσχρός	causing shame, abusive
αἰσχρότης	ugliness, deformity
αἰσχύνη	shame done one, disgrace, dishonour
αἰσχύνω	to make ugly, disfigure, mar
αἰτέω	to ask, beg
αἰτή	
αἴτημα	a request, demand
αἴτησις	a request, demand
αἰτία	a charge, accusation
αἴτιος	to blame, blameworthy, culpable
αἰτίωμα	
αἰτόν	
αἰτῷ	
αἰφνίδιος	unforeseen, sudden
αἰχμαλωσία	captivity: a body of captives
αἰχμαλωτεύω	to take prisoner
αἰχμαλωτίζοντα	
αἰχμαλωτίζοντες	
αἰχμαλωτισθήσονται	
αἰχμάλωτος	taken by the spear, captive to one's spear, taken prisoner
αἰών	a period of existence
αἰώνιος	lasting for an age
ἀκαθαρσία	uncleanness, impurity
ἀκάθαρτος	uncleansed, unclean, impure
ἀκαιρέω	
ἄκαιρος	ill-timed, unseasonable, inopportune
ἄκακος	unknowing of ill, guileless
ἄκανθα	a thorn, prickle
ἀκάνθινος	of thorns
ἄκαρπος	without fruit, barren
ἀκατάγνωστος	not to be condemned
ἀκατακάλυπτος	uncovered
ἀκατάκριτος	uncondemned
ἀκατάλυτος	indissoluble
ἀκαταπάστους	
ἀκαταστασία	
ἀκατάστατος	unstable, unsettled
Ἁκελδαμάχ	
ἀκέομαι	to heal, cure
ἀκέραιος	unmixed, pure in blood
ἀκλινής	bending to neither side, unswerving
ἀκμάζω	to be in full bloom, be at one's prime or perfection
ἀκμή	a point, edge
Ἀκοῆ	
ἀκοή	a hearing, the sound heard
ἀκολουθέω	to follow
ἀκολούθησις	
άκουσας	
ἄκουσις	
ἀκούω	to hear
ἀκρασία	bad mixture, ill temperature
ἀκρατής	powerless, impotent
ἄκρατος	unmixed, sheer
ἀκρίβεια	exactness, minute accuracy, precision
ἀκριβής	exact, accurate, precise, made or done to a nicety
ἀκριβόω	to make exact or accurate
ἀκριβῶς	
ἀκρίς	a locust
ἀκροατήριον	a place of audience
ἀκροατής	a hearer
ἀκροβυστία	the foreskin
ἀκρογωνιαῖος	at the extreme angle
ἀκροθίνιον	the topmost part of a heap, the choice part, first-fruits
ἄκρον	the highest or furthest point
ἄκρος	at the furthest point
ἄκρων	
Ἀκύλαν	
Ἀκύλας	
ἀκυρόω	
ἀκώλυτος	unhindered
ἄκων	a javelin, dart
ἀλάβαστρον	a box or casket of alabaster
ἀλαζονεία	false pretension, imposture, quackery
ἀλαζονίας	
ἀλαζών	a vagabond
ἀλαλάζω	to raise the war-cry
ἀλάλητος	unutterable
ἄλαλος	speechless
ἅλας	salt
ἀλεής	in the sun
ἀλείφω	to anoint with oil, oil
ἀλεκτοροφωνία	cock-crow
ἀλέκτωρ	a cock
Ἀλεξανδρεύς	
Ἀλεξάνδρη	
Ἀλεξανδρινόν	
Ἀλεξανδρινῷ	
ἀλέξανδρος	defending men
Ἀλέξανδρος	
ἄλευρον	wheaten flour
Ἀλη	
ἀλήθεια	truth
ἀληθεύω	to speak truth
ἀληθής	unconcealed, true
αΛηθής	
ἀληθινός	agreeable to truth
ἀλήθω	
ἁλιεύω	to be a fisher
ἁλίζω	
ἀλίσγημα	a pollution
ἁλίσκομαι	to be taken, conquered
ἀλλ̓	
ἀλλά	otherwise, but
ἄλλαξις	
ἀλλάσσω	to make other than it is, to change, alter
ἀλλαχόθεν	from another place
ἀλλαχοῦ	elsewhere
ἀλληγορέω	to speak so as to imply something other than what is said, to interpret allegorically
Ἁλληλουιά	
ἀλλήλων	of one another, to one another, one another
ἀλλογενής	of another race, a stranger
ἅλλομαι	to spring, leap, bound
ἄλλος	alius, another, one besides
ἀλλοτριεπίσκοπος	
ἀλλότριος	of or belonging to another
ἀλλοτριόω	to estrange from
ἄλλου	
ἀλλόφυλος	of another tribe, foreign
ΑΛΛΩΣ	
ἄλλως	in another way or manner
ἀλοάω	to thresh, thresh out
ἄλογος	without λόγος
ἀλόη	
ἅλς	a lump of salt
ἁλυκός	
ἄλυπος	without pain
ἅλυσις	a chain
ἀλυσιτελής	unprofitable
ἄλφα	
Ἁλφαίου	
ἅλων	
ἀλώπηξ	a fox
ἅλωσις	a taking, capture, conquest, destruction
ἅμα	at once, at the same time
ἀμαθής	unlearned, ignorant, stupid, boorish
ἁμαρ	
ἀμαράντινος	of amaranth
ἀμάραντος	unfading, undecaying
ἁμαρτάνω	to miss, miss the mark
ἁμάρτημα	a failure, fault, sin
ἁμαρτία	a failure, fault, sin
αμαρτιῶν	
ἀμάρτυρος	without witness, unattested
ἁμαρτωλή	
ἁμαρτωλός	sinful
ἄμαχος	without battle
ἀμάω	
ἀμέθυστος	not drunken
ἀμέλει	never mind
ἀμελέω	to have no care for, be neglectful of
ἄμεμπτος	not to be blamed, blameless
ἀμέριμνος	free from care, unconcerned
ἀμετάθετος	
ἀμετακίνητος	immovable
ἀμεταμέλητος	not to be repented of
ἀμετανόητος	not to be repented of
ἄμετρος	without measure, immense, excessive, boundless
αμήν	
ἀμήν	verily, of a truth, so be it
ἀμήτωρ	without mother, motherless
ἀμίαντος	undefiled
Ἀμιναδάβ	
ἄμμος	sand
ἀμνός	a lamb
ἀμνοῦ	
ἀμοιβάς	for a change of raiment
ἀμοιβή	a requital, recompense, compensation, return, payment
ἁμός	
ἄμπελος	a vine
ἀμπελουργός	a vine-dresser
ἀμπελών	a vineyard
Ἀμπλιᾶτον	
ἀμύνω	to keep off, ward off
ἀμφιάζω	to clothe
ἀμφί-ἀμφιέννυμι	
ἀμφιβάλλω	to throw or put round
ἀμφίβληστρον	anything thrown round
ἀμφιέννυμι	to put round or on
ἀμφίπολις	encompassing a city
Ἀμφίπολις	
ἄμφοδον	a road round houses, a street
ἄμφοδος	
ἀμφότερος	each or both of two
ἀμώμητος	unblamed, blameless
ἄμωμον	
ἄμωμος	without blame, blameless
ἄν	
ἀν	
ἀνά	up, upon
ἀνά-ἀστατέω	
ἀναβαθμός	
ἀναβαίνω	to go up, mount, to go up to
ἀναβάλλω	to throw or toss up
ἀναβιβάζω	to make go up, cause to mount
ἀναβλέπω	to look up
ἀνάβλεψις	a looking up
ἀναβολή	that which is thrown up, a mound
ἀνάγαιον	
ἀναγγέλλω	to carry back tidings of, report
ἀναγελάω	to laugh loud
ἀναγεννάω	to beget anew, regenerate
ἀναγιγνώσκω	to know well, know certainly
ἀναγκάζω	to force, compel
ἀναγκαίη	
ἀναγκαῖον	a place of constraint, a prison
ἀναγκαῖος	with or by force
ἀναγκαστός	forced, constrained
ἀνάγκη	force, constraint, necessity
ἀνάγνωσις	recognition
ἀνάγω	to lead up
ἀναδείκνυμι	to lift up and shew
ἀνάδειξις	a proclamation
ἀναδέχομαι	to take up, catch, receive
ἀναδίδωμι	to hold up and give
ἀνά-ἔπειμι	
ἀνά-ἐπιέννυμι	
ἀνά-εὕω	
ἀνά-ἐφέζομαι	
ἀνά-ἐφίημι	
ἀναζάω	to return to life, be alive again
ἀναζητέω	to examine into, investigate
ἀναζώννυμι	to gird up
ἀναζωπυρέω	
ἀναθάλλω	to shoot up again
ἀνάθεμα	anything devoted to evil, an accursed thing
ΑΝΑΘΕΜΑ	
ἀνά-θεματίζω	
ἀνά-θεωρέω	
ἀνάθημα	a votive offering set up
ἀναιδίαν	
ἀναίρεσις	a taking up
ἀναιρέω	to take up, raise
ἀναίτιος	not being the cause
ἀνακαθίζω	to set up
ἀνακαινίζω	
ἀνακαινόω	to renew, restore:—
ἀνακαίνωσις	renewal
ἀνακαλύπτω	to uncover
ἀνακάμπτω	to bend back
ἀνάκαμψις	
ἀνάκειμαι	to be laid up
ἀνακεφαλαιόω	to sum up the argument:—
ἀνακλίνω	to lean
ἀνακράζω	to cry out, lift up the voice
ἀνακρίνω	to examine closely, to question, interrogate
ἀνάκρισις	examination of parties concerned in a suit, a preparation
ἀνά-κυλίνδω	
ἀνακύπτω	to lift up the head
ἀναλἁβών	
ἀναλάζομαι	to take again
ἀναλαμβάνω	to take up, take into one's hands
ἀναλημφθείς	
ἀνάληψις	a taking up
ἀναλίσκω	to use up, to spend, lavish or squander
ἀναλογία	proportion
ἀναλογίζομαι	to reckon up, sum up
ἄναλος	
ἀνάλυσις	a loosing, releasing
ἀναλύω	to unloose, undo
ἀναμάρτητος	without missing, unfailing, unerring
ἀναμένω	to wait for, await
ἀναμιμνήσκω	to remind
ἀνάμνησις	a calling to mind, recollection
ἀνανεόομαι	to renew
ἀνανήφω	to return to sobriety of mind
Ἁνανία	
Ἁνανίαν	
Ἁνανίας	
ἀναντιρήτως	
ἀνάξιος	unworthy, not deemed or held worthy of
ἀναπαήσονται	
ἀνάπαυσις	repose, rest
ἀναπαύω	to make to cease, to stop or hinder from
ἀναπείθω	to bring over, convince
ἀναπείρους	
ἀναπέμπω	to send up
ἀναπηδάω	to leap up, start up
ἀναπίπτω	to fall back
ἀναπληρόω	to fill up
ἀναπλήρωσις	a filling up
ἀναπολόγητος	
ἀνάπτω	to make fast on or to
ἀναρίθμητος	not to be counted, countless
ἀνασείω	to shake back, swing to and fro, move up and down
ἀνασκευάζω	to pack up the baggage
ἀνάσπασις	
ἀνασπάω	to draw up, pull up
ἀνάσσω	to be lord, master, owner, to rule, in
ἀνάστασις	a raising up
ἀνά-στατέω	
ἀνά-στατόω	
ἀνασταυρόω	to impale
ἀναστενάζω	didst thou groan forth
ἀναστρέφω	to turn upside down, upset
ἀναστροφή	a turning upside down, upsetting
ἀνά-τάσσω	
ἀνατέλλω	to make to rise up or to grow up
ἀνά-τήκω	
ἀνατίθημι	to lay upon
ἀνατολή	a rising, rise
ἀνατρέπω	to turn up or over, overturn, upset
ἀνατρέφω	to feed up, nurse up, educate
ἀναφαίνω	to make to give light, make to blaze up
ἀναφέρω	to bring or carry up
ἀνά-φωνέω	
ἀνάχυσις	effusion
ἀναχωρέω	to go back
ἀνάψυξις	
ἀναψύχω	to cool, to revive by fresh air, to refresh
ἁνδάνω	to please, delight, gratify
ἀνδραποδιστής	a slave-dealer, kidnapper
Ἀνδρέης	
Ἀνδρεύς	
ἀνδρίζω	to make a man of
ἀνδρίς	
Ἀνδρόνικον	
ἀνδροφόνος	man-slaying
ἀνδρόω	to rear up into manhood
ἀνέγκλητος	not accused, without reproach, void of offence
ἀνείλω	
ἀνεκδιήγητος	ineffable
ἀνεκλάλητος	unspeakable
ἀνέκλειπτος	
ἀνεκτός	bearable, sufferable, tolerable
ἀνελεήμων	merciless, without mercy
ἀνέλεος	unmerciful
ἀνελήμφθη	
ἀνεμίζομαι	to be driven with the wind
ἄνεμος	wind
ἀνεμόω	to expose to the wind:—
ἀνένδεκτος	impossible
ἀνεξεραύνητα	
ἀνεξίκακος	enduring evil, forbearing, long-suffering
ἀνεξιχνίαστος	not to be traced, unsearchable, inscrutable
ἀνεπαίσχυντος	having no cause for shame
ἀνεπίλημπτοι	
ἀνεπίλημπτον	
ἀνέρχομαι	to go up
ἄνεσις	a loosening, relaxing
ἀνετάζω	to examine closely
ἄνευ	without
ἀνεύθετος	inconvenient
ἀνευρίσκω	to find out, make out, discover
ἀνέχω	to hold up
ἀνεψιός	a first-cousin, cousin
ἀνεῳχθῆναι	
ἀνηγγέλη	
ἄνηθον	anise, dill
ἀνήκω	to have come up to
ἀνήμερος	not tame, wild, savage
ἀνήρ	a man
ἀνθίστημι	to set against
ἀνθομολογέομαι	to make a mutual agreement
ἄνθος	a blossom, flower
ἄνθρα	
ἀνθρακιά	a heap of charcoal, hot embers
ἄνθραξ	charcoal, coal
ἀνθρώ	
ἄνθρω	
ἀνθρωπάρεσκος	a man-pleaser
ἀνθρώπινος	of, from or belonging to man, human
ἀνθρωποκτόνος	murdering men, a homicide
ἄνθρωπος	man
ανθρώπου	
ἀνθρώπρυς	
ανθρώπων	
ἀνθρώτου	
ἀνθύπατος	a proconsul
ἀνιερόω	to dedicate, devote
ἀνίημι	to send up or forth
ἄνιπτος	unwashen
ἀνίστημι	to make to stand up, raise up
Ἅννα	
Ἅνναν	
Ἅννας	
ἀνόητος	not thought on, unheard of
ἄνοια	want of understanding, folly
ἀνοίγνυμι	to open
ἀνοικοδομέω	to build up
ἄνοιξις	an opening
ἀνομία	lawlessness
ἄνομος	without law, lawless
ἄνοος	without understanding, foolish, silly
ἀνορθόω	to set up again, restore, rebuild
ἀνόσιος	unholy, profane
άνου	
ἀνοχεύς	
ἀνοχή	a holding back, stopping
ἀνταγωνίζομαι	to struggle against, prove a match for
ἀντάλλαγμα	that which is given
ἀνταναπληρόω	to supply as a substitute or balance
ἀνταποδίδωμι	to give back, repay, tender in repayment or requital
ἀνταπόδομα	repayment, requital
ἀνταπόδοσις	a giving back in turn
ἀνταποκρίνομαι	to answer again
ἀντεικείμενοι	
ἀντεῖπον	to speak against or in answer, gainsay
ἀντέχω	to hold against
ἀντί	over against, opposite. c. gen.
ἀντιβάλλω	to throw against or in turn, return the shots
ἀντιδιατίθεμαι	to offer resistance
ἀντίδικος	an opponent in a suit, defendant
ἀντί-ἕζομαι	
ἀντί-ἥδομαι	
ἀντίθεσις	opposition, resistance
ἀντί-ἵημι	
ἀντικαθίστημι	to lay down or establish instead, substitute, replace
ἀντικαλέω	to invite in turn
ἀντίκειμαι	to be set over against, lie opposite
ἄντικρυς	straight on, right on
ἀντιλαμβάνω	to receive instead of
ἀντιλέγω	to speak against, gainsay, contradict
ἀντιλήμψεις	
ἀντιλογία	contradiction, controversy, disputation
ἀντιλοιδορέω	to rail at or abuse in turn
ἀντίλυτρον	a ransom
ἀντιμετρέω	to measure out in turn, to give in compensation
ἀντιμισθία	a requital, recompense
Ἀντιοχέα	
Ἀντιόχειαν	
Ἀντιόχειος	
ἀντιπαρέρχομαι	to pass by on the opposite side
Ἀντίπας	
ἀντιπατρίς	
ἀντίπερας	
ἀντιπίπτω	to fall against, resist
ἀντί-ῥέω	
ἀντιστρατεύομαι	to make war against
ἀντιτάσσω	to set opposite to, range in battle against
ἀντίτυπος	repelled
ἀντίχριστος	Antichrist
ἀντλέω	to bale out bilge-water, bale the ship
ἄντλημα	a bucket for drawing water
ἀντοφθαλμέω	to meet face to face, to face
ἄνυδρος	wanting water, waterless
ἀνυπόκριτος	without dissimulation
ἀνυπότακτος	not made subject
ἄνω	
ἄνωθεν	from above, from on high
ἀνωτερικός	upper, inland
ἀνώτερος	higher
ἀνωφελής	unprofitable, useless
ἀξία	the worth or value
ἀξίνη	an axe-head
ἄξιος	weighing as much, of like value, worth as much as
ἀξιόω	to think or deem worthy of
Ἀξίων	
ἀξίωσις	a thinking worthy
ἄξος	
ἄξων	an axle
ἀοιδή	song, a singing
ἄοιστον	
ἀόρατος	unseen, not to be seen, invisible
ΑΠ'	
ἀπ̓	
ἀπαγγελεύς	
ἀπαγγέλλω	to bring tidings, report, announce
ἄπαγε	away! begone! hands off!
ἀπάγχω	to strangle, throttle
ἀπάγω	to lead away, carry off
ἀπαίδευτος	uneducated
ἀπαίρω	to lift off, carry off, take away, to remove from
ἀπαιτέω	to demand back, demand
ἀπαλγέω	to feel no more pain at
ἀπαλλαγή	deliverance, release, relief from
ἀπάλλαξις	
ἀπαλλάσσω	to set free, release, deliver
ἀπαλλοτριόω	to estrange, alienate
ἁπαλός	soft to the touch, tender
ἀπαντάω	to move from
ἀπάντησις	
ἀπάντομαι	
ἅπαξ	once, once only, once for all
ἀπαράβατος	not passing over to
ἀπαρασκεύαστος	
ἀπαρνέομαι	to deny utterly, deny
ἀπάρνησις	
ἀπαρτισμός	completion
ἀπαρχή	the beginning of a sacrifice, the primal offering
ἅπας	quite all, the whole
ἀπατάω	to cheat, trick, outwit, beguile
ἀπάτη	a trick, fraud, deceit
ἀπάτωρ	without father, fatherless
ἀπαύγασμα	efflux of light, effulgence
ἀπε	
ἀπείθεια	disobedience
ἀπειθέω	to be disobedient, refuse compliance
ἀπειθής	disobedient
ἀπειθίᾳ	
ἀπειθίαν	
ἀπειθίας	
ἀπειλέω	
ἀπειλή	boastful promises, boasts
ἄπειμι	
ἀπεῖπον	to speak out, tell out, declare
ἀπείραστος	incapable of being tempted by
ἄπειρος	
ἀπεκατεστάθη	
ἀπεκατέστη	
ἀπεκδέχομαι	to expect anxiously, to look for, await
ἀπεκδύνω	to strip off from
ἀπέκδυσις	a putting off
ἀπεκεφάλισα	
ἀπεκεφάλισεν	
ἀπελαύνω	to drive away, expel from
ἀπελεγμός	refutation: disrepute
ἀπελεύθερος	an emancipated slave, a freedman
ἀπέναντι	opposite, against
ἀπερίσπαστος	
ἀπερίτμητος	uncircumcised
ἀπέρχομαι	to go away, depart from
Ἀπέσταλκαν	
Ἀπεσταλμένοσ̓	
ἀπέχω	to keep off or away from
ἀπηγγέλη	
ἀπῆλθα	
ἀπῆλθαν	
ἄπιος	
Ἀπίς	
ἀπιστέω	to be ἄπιστος
ἀπιστία	disbelief, distrust, mistrust
ἄπιστος	not to be trusted
ἁπλόος	single
ἁπλός	
ἁπλότης	singleness: simplicity, frankness
ἁπλόω	to make single, to unfold, stretch out
ἁπλῶς	singly, in one way
από	
ΑΠΟ	
ἀπο	
ἀπό	from, away from. c. gen.
ἀπό-ἀσπάζομαι	
ἀποβαίνω	to step off from
ἀποβάλλω	to throw off
ἀποβλέπω	to look away from
ἀπόβλητος	to be thrown away
ἀποβολή	a throwing away
ἀπογίγνομαι	to be away from, have no part in
ἀπογραφεύς	
ἀπογραφή	a writing off: a register, list
ἀπογράφω	to write off, copy: to enter in a list, register
ἀποδείκνυμι	to point away from
ἀπόδειξις	a shewing forth, exhibiting
ἀπό-δεκατεύω	
ἀποδεκατοῖν	
ἀποδεκατόω	to tithe, pay tithes of
ἀπόδεκτον	
ἀποδέχομαι	to accept from
ἀποδημέω	to be away from home, be abroad or on one's travels
ἀπόδημος	away from one's country, from home, abroad
ἀποδίδωμι	to give up or back, restore, return
ἀποδιορίζω	to mark off by dividing, to separate
ἀποδοκιμάζω	to reject on scrutiny, to reject for want of qualification
ἀποδοκιμάω	to reject
ἀπόδοτος	
ἀποδοχεύς	
ἀποδοχή	a receiving back, having restored to one
ἀποδὥσει	
ἀπό-ἔδω	
ἀπό-ἐλπίζω	
ἀπό-ἔπειμι	
ἀπό-ἐπιέννυμι	
ἀπό-ἐφέζομαι	
ἀπό-ἐφίημι	
ἀπόθεσις	a laying up in store
ἀποθέω	to run away
ἀποθήκη	any place wherein to lay up
ἀποθησαυρίζω	to store, hoard up
ἀποθλίβω	to press upon, press, squeeze out
ἀποθνήσκω	to die off, die
ἀπό-καθιστάνω	
ἀποκαθίστημι	to re-establish, restore, reinstate
ἀποκαλύπτω	to uncover
ἀποκάλυψις	an uncovering, a revelation
ΑΠΟΚΑΛΥΨΙΣ	
ἀποκαραδοκία	earnest expectation
ἀποκαταλλάσσω	to reconcile again
ἀποκατάστασις	
ἀπόκειμαι	to be laid away
ἀπόκλεισις	a shutting up
ἀποκλείω	to shut off from or out of, debar
ἀποκόπτω	to cut off, hew off
ἀπόκριμα	a judicial sentence
ἀποκρίνω	to separate, set apart
ἀπόκρισις	a separating
ἄποκρισλς	
ἀποκρύπτω	to hide from, keep hidden from
ἀπόκρυφος	hidden, concealed
ἀποκτείνω	to kill, slay
ἀποκτέννεσθαι	
ἀποκτέννυντες	
ἀποκυέω	to bear young, bring forth
ἀπό-κυλίνδω	
ἀπολαμβάνω	to take or receive from
ἀπολάπτω	to lap up
ἀπόλαυσις	enjoyment, fruition
ἀπολείπω	to leave over or behind
ἀπολήμψεσθε	
ἀπόλλυμι	to destroy utterly, kill, slay
Ἀπολλώ	
Ἀπολλών	
Ἀπολλώνιος	of or belonging to Apollo
Ἀπολλώς	
ἀπολογέομαι	to speak in defence, defend oneself
ἀπολογία	a speech in defence, defence
ἀπολούω	to wash off
ἀπόλυσις	release, deliverance from
ἀπολύτρωσις	a ransoming
ἀπολύω	to loose from
ἀπομάσσω	to wipe clean
ἀπονέμω	to portion out, impart, assign
ἀπονίζω	wash off
ἀποπίνω	to drink up, drink off
ἀποπλανάω	to lead astray
ἀποπλέω	to sail away, sail off
ἀποπνίγω	to choke, throttle
ἀπορέω	to be without means or resource
ἀπορία	difficulty of passing
ἀπορρέω	to flow or run off, stream forth
ἀπορρίπτω	to throw away, put away
ἀπορφανίζομαι	to be orphaned or bereaved
ἀποσκίασμα	
ἀποσπάω	to tear or drag away from
ἀποστάζω	to let fall drop by drop, distil
ἀποστασία	defection
ἀποστάσιον	
ἀποστασίου	ἀποστασίου δίκη an action against a freedman for having forsaken or slighted his προστάτης
ἀποστεγάζω	to uncover: to take off
αΠοστέλλει	
ἀποστέλλω	to send off or away from
ἀποστερέω	to rob, despoil, bereave or defraud
ἀποστολεύς	a magistrate who had to fit out
ἀποστολή	a sending off or away, despatching
ἀπόστολος	a messenger, ambassador, envoy
ΑΠΟΣΤΟΛΩΝ	
ἀποστοματίζω	to dictate by word of mouth, teach by dictation
ἀποστρέφω	to turn
ἀποστυγέω	to hate violently, abhor, loathe
ἀποσυνάγωγος	put out of the synagogue
ἀποτάσσω	to set apart, assign specially
ἀποτελέω	to bring quite to an end, complete
ἀποτίθημι	to put away, stow away
ἀποτινάσσω	to shake off
ἀποτίνω	to pay back, repay, return
ἀποτολμάω	to make a bold venture
ἀποτομία	
ἀπότομος	cut off, abrupt, precipitous
ἀποτρέπω	to turn
ἀπουσία	a being away, absence
ἀπό-ὑστερέω	
ἀποφέρω	to carry off or away
ἀποφεύγω	to flee from, escape
ἀποφθέγγομαι	to speak one's opinion plainly
ἀπό-φορτίζω	
ἀποχέω	to pour out or off, shed, let fall
ἀπόχρησις	
ἀποχωλόομαι	to be made quite lame
ἀποχώννυμι	to bank up
ἀποχωρέω	to go from or away from
ἀποχωρίζω	to part or separate from
ἀποψύχω	to leave off breathing, to faint, swoon
Ἄππιος	
ἀπρόσιτος	unapproachable
ἀπρόσκεπτος	unforeseen
ἀπρόσκοπος	not stumbling, void of offence
ἀπροσωπολήμπτως	
ἄπταιστος	not stumbling
ἅπτεξθε	
ἅπτω	to fasten, bind fast
Ἀπφίᾳ	
ἀπωθέω	to thrust away, push back
ἀπώλεια	destruction
ἄρα	
ἀρά	a prayer
ἆρα	particle introducing a question
Ἄραβες	
Ἀραβία	Arabia
Ἀράβιος	Arabian
ἄραγε	
Ἄραγε	
Ἀράμ	
ἀράομαι	to pray to
ἀραρίσκω	to join, join together, fasten
Ἄρας	
Ἄρατος	
ἄραφος	
ἀργέω	to lie idle, be unemployed, do nothing
ἀργός	
ἀργύρεος	silver, of silver
ἀργύριον	a piece of silver, a silver coin
ἀργυροκόπος	a silver-smith
ἄργυρος	white metal
ἀργυρόω	
ἄρδω	to water
Ἄρειος	
ἄρειος	devoted to Ares, warlike, martial
Ἀρείων	
ἀρείων	better, stouter, stronger, braver, more excellent
Ἀρεοπαγίτης	a member of the Areopagus
ἄρεσις	
ἀρεσκίαν	
ἄρεσκος	pleasing
ἀρέσκω	to make good, make up
ἀρεστής	
ἀρεστός	acceptable, pleasing
Ἁρέτα	
ἀρετάω	to be fit or proper, to thrive, prosper
ἀρετή	goodness, excellence
ἀρή	
Ἄρης	Ares
ἀριθμέω	to number, count or reckon up
ἀριθμός	number
Ἁριμαθαίας	
ἀρίσταρχος	best-ruling
Ἀρίσταρχος	
ἀριστάω	to take breakfast or luncheon
ἀριστερός	left, on the left
ἀριστόβουλος	best-advising
ἄριστον	the morning meal, breakfast
ἄριστος	best
ἄρκεσις	help, aid, service
ἀρκετός	sufficient
ἀρκέω	to ward off, keep off
ἄρκος	
ἅρμα	a chariot
ἁρμή	
ἁρμόζω	to fit together, join
ἁρμός	the fastenings
Ἀρνεί	
ἀρνέομαι	to deny, disown
ἄρνησις	denial
ἀρνίον	a sheep-skin
ἀρνός	a lamb
ἄρον	
ἄρος	
ἀροτριάω	
ἄροτρον	a plough
ἀρόω	to plough
ἁρπαγεύς	
ἁρπαγή	seizure, rapine, robbery, rape
ἁρπαγμός	a seizing, booty, a prize
ἁρπάζω	to snatch away, carry off
ἅρπαξ	rapacious
ἅρπασις	
ἀρραβών	earnest-money, caution-money
ἄρρητος	unspoken, unsaid
ἄρρωστος	weak, sickly
ἀρσενοκοίτης	lying with men
ἄρσην	male
ἄρσις	a raising
ἄρσος	
ἀρτάω	to fasten to or hang
Ἀρτεμᾶν	
Ἄρτεμις	Artemis
ἀρτέμωνα	
ἄρτι	just, exactly
ἀρτιγέννητος	just born
ἄρτιος	complete, perfect of its kind, suitable, exactly fitted
ἄρτος	a cake or loaf of wheat-bread
ἀρτύω	to arrange, devise, prepare
Ἀρφαξάδ	
ἀρχάγγελος	an archangel
ἀρχαῖος	from the beginning
Ἀρχέλαος	
ἀρχέλαος	leading the people, a chief
ἀρχή	a beginning, origin, first cause
ΑΡΧΗ	
ἀρχηγός	beginning, originating
ἀρχήν	
ΑΡΧΗΣ	
ἀρχιερατικοῦ̓	
ἀρχιερεύς	an arch-priest, chief-priest
ἀρχιέρεως	
ἀρχιποίμην	a chief shepherd
Ἄρχιππος	
ἀρχισυνάγωγος	the ruler of a synagogue
ἀρχιτέκτων	a chief-artificer, master-builder, director of works, architect, engineer
ἀρχιτελώνης	a chief toll-collector, chief-publican
ἀρχιτρίκλινος	the president of a banquet (triclinium)
ἄρχω	to be first
ἄρχων	a ruler, commander, chief, captain
ἄρωμα	
ἀσάλευτος	not agitated, tranquil
Ἀσάφ	
ἄσβεστος	unquenchable, inextinguishable
ἀσέβεια	ungodliness, impiety, profaneness
ἀσεβέω	to be impious, to act profanely, sin against the gods
ἀσεβής	ungodly, godless, unholy, profane
ἀσέλγεια	licentiousness
ἄσημος	without mark or sign
Ἀσήρ	
ἀσθένεια	want of strength, weakness, feebleness, sickliness
ἀσθενέω	to be weak, feeble, sickly
ἀσθένημα	
ἀσθενής	without strength, weak, feeble, weakly
ἀσθενόω	to weaken
Ἀσία	Asia
Ἀσιανός	Asiatic
Ἀσιάρχης	an Asiarch
Ἀσίης	
ἄσιος	
Ἄσιος	Asian
ἀσιτία	want of food
ἄσιτος	without food, fasting
ἀσκέω	to work curiously, form by art, fashion
ἀσκός	a leathern-bag, a wine-skin
ἄσμενος	well-pleased, glad
ἄσοφος	unwise, foolish, silly
ἀσπάζομαι	to welcome kindly, bid welcome, greet
ἀσπασμός	a greeting, embrace, salutation
ἄσπιλος	without spot, spotless
ἀσπίς	a round shield
ἄσπονδος	without drink-offering
ἀσσάριον	
ἆσσον	nearer, very near
Ἄσσον	
̄αστ	
ἀστατέω	to be unstable
ἀστεῖος	of the town
ἀστήρ	a star
ἀστήρικτος	not steady, unstable
ἄστοργος	without natural affection
ἀστοχέω	to miss the mark, to miss, fail
ἀστραπή	a flash of lightning, lightning
ἀστράπτω	to lighten, hurl lightnings
ἄστρον	the stars
ἀσύμφωνος	not agreeing in sound
ἀσύνετος	void of understanding, stupid
ἀσύνθετος	uncompounded
Ἀσύνκριτον	
ἀσφάλεια	security against stumbling or falling
ἀσφάλειος	
ἀσφαλής	not liable to fall, immoveable, steadfast, firm
ἀσφαλίζομαι	to make safe, secure
ἀσχημονέω	to behave unseemly, disgrace oneself, to be put to shame
ἀσχημοσύνη	want of form, ungracefulness
ἀσχήμων	misshapen, unseemly, shameful
ἀσωτία	prodigality, wastefulness
ἄσωτος	having no hope of safety, abandoned, profligate
ἀτακτέω	to be undisciplined, disorderly
ἄτακτος	not in battle-order
ἄτεκνος	without children, childless
ἀτενίζω	to look intently, gaze earnestly
ἀτενισασα	
ἄτερ	without
ἀτιμάζω	to hold in no honour, to esteem lightly, dishonour, slight
ἀτιμάω	to dishonour, treat lightly
ἀτιμία	dishonour, disgrace
ἄτιμος	unhonoured, dishonoured
ἀτμἰδα	
ἀτμίς	
ἄτομος	uncut, unmown
ἄτοπος	out of place
Ἀτταλίαν	
αὐ	
αὐγάζω	to view in the clearest light, see distinctly, discern
αὐγή	the light of the sun, sunlight
αὐγής	
Αὔγουστος	
αὐθάδης	self-willed, wilful, dogged, stubborn, contumacious, presumptuous
αὐθαίρετος	self-chosen, self-elected
αὐθεντέω	to have full power over
αὐλέω	to play on the flute
αὐλή	the court-yard
αὐλητής	a flute-player
αὐλήτης	
αὐλίζομαι	to lie in the court-yard
αὐλός	a flute
αὐξάνω	to make large, increase, augment
αὔξησις	growth, increase
αὖξις	
αὔριον	to-morrow
αὐστηρός	making the tongue dry and rough, harsh, rough, bitter
αὐτα	
αὐτάρκεια	sufficiency in oneself, independence
αὐτάρκης	sufficient in oneself, having enough, independent
αὐτη	
αὐτῆ	
αυτό	
αὐτοῖ	
αὐτοι	
αύτοι	
αύτοῖς	
αὐτοκατάκριτος	self-condemned
αὐτόματος	acting of one's own will, of oneself
αυτόν	
ἀὐτόν	
αὐτόπτης	seeing oneself, an eyewitness
αὐτός	self
αυΤός	
αυτοῦ	
άὐτοῦ	
αὐτου	
αὐτοῦ	at the very place, just here, just there
αὐτού	
αὐτόφωρος	self-detected, caught in the act of theft
αὐτόχειρ	with one's own hand
αύτῶν	
αὐχέω	to boast, plume oneself
αὐχμηρός	dry, dusty, rough, squalid
αὐῷ	
ἀφ̓	
ἀφαιρέω	to take from, take away from
ἀφανής	unseen, invisible, viewless
ἀφανίζω	to make unseen, hide from sight
ἀφανισμός	
ἄφαντος	made invisible, blotted out, forgotten
ἁφάω	to handle, rub, polish
ἄφε	
ἀφεδρών	a privy
ἀφειδία	profuseness
ἀφεῖς	
ἀφελής	without a stone, even, smooth
ἀφελότης	simplicity
ἄφεσις	a letting go, dismissal
ἄφετος	let loose, at large, ranging at will
ἁφή	a lighting, kindling
ἀφήκω	to arrive at
ἀφθαρσία	incorruption
ἄφθαρτος	uncorrupted, incorruptible
ἀφθορία	incorruption
ἀφίδω	
ἀφίημι	to send forth, discharge
ἀφικνέομαι	to come to
ἀφιλάγαθος	not loving the good
ἀφιλάργυρος	not loving money
ἄφιξις	an arrival
ἀφίομεν	
ἀφίουσιν	
ἀφίστημι	to put away, remove
ἀφνίδιος	unforeseen, sudden
ἄφνω	unawares, of a sudden
ἄφοβος	without fear
ἀφομοιόω	to make like
ἀφοράω	to look away from
ἀφορίζω	to mark off by boundaries
ἀφόρισις	
ἀφορμή	a starting-point
ἀφρέω	to befoam, cover with foam
ἀφρίζω	to foam
ἀφρός	foam
ἀφροσύνη	folly, thoughtlessness, senselessness
ἄφρων	without sense
ἀφυπνόω	to wake from sleep
ἄφωνος	voiceless, speechless, dumb, silent
Ἀχαία	Achaia
Ἀχαϊκός	
ἀχάριστος	ungracious, unpleasant, unpleasing
Ἄχας	
Ἀχείμ	
ἀχειροποίητος	not wrought by hands
ἀχλύς	a mist
ἀχρεῖος	useless, unprofitable, good for nothing
ἄχρηστος	useless, unprofitable, unserviceable
ἀχρί	
ἄχρι	to the uttermost, utterly
ἄχυρον	husks, chaff, bran
ἄχυρος	
ἀχυρός	a chaff-heap
ἀψευδής	without lie and deceit, truthful, sincere, trusty
ἄψινθος	wormwood
ἅψις	
ἄψυχος	lifeless, inanimate
Β	
Βάαλ	
ΒΑΒΥΛΩΝ	
Βαβυλών	
Βαβψλών	
βάζω	to speak, say
βαθέως	
βαθμός	a step
βάθος	depth or height
βαθύνω	to deepen, hollow out
βαθύς	deep or high
βαία	
βαίνω	to walk, step
Βαλαάμ	
Βαλάκ	
βαλλάντιον	a bag, pouch, purse
βάλλις	
βάλλω	to throw
βαπτίζω	to dip in or under water
βάπτισις	
βάπτισμα	baptism
βαπτισμός	a dipping in water, ablution
βαπτιστής	one that dips: a baptizer
βάπτω	to dip in water
Βαραββᾶν	
Βαραββᾶς	
Βαράκ	
Βαραχίου	
βάρβαρος	barbarous
βαρέω	to weigh down, depress
Βαρθολομαῖον	
Βαρθολομαῖος	
Βαριησοῦς	
βᾶρις	a flat-bottomed boat
Βαριωνᾶ	
Βαρνάβᾳ	
Βαρνάβα	
Βᾳρνάβα	
Βαρνάβαν	
Βαρνάβας	
βάρος	weight
Βαρσαββᾶν	
Βαρτίμαιος	
βαρύς	heavy
βαρύτιμος	very costly
βασανίζω	to rub
βασανισμός	
βασανιστής	questioner, torturer, tormentor
βάσανος	the touch-stone
βασι	
βασίλεια	a queen, princess
βασιλεία	a kingdom, dominion
βασιλειαν	
βασίλειον	a kingly dwelling, palace
βασίλειος	of the king, kingly, royal
ΒΑΣΙΛΕΥΣ	
βασιλεύς	a king, chief
βασιλεύω	to be king, to rule, reign
ΒΑΣΙΛΕΩΝ	
βασίλη	
βασιλίζω	to be of the king's party
βασιλικός	royal, kingly
βασίλισσα	
βάσις	a stepping, step
βασκαίνω	to slander, malign, belie, disparage
βασΛικός	
βαστάζω	to lift, lift up, raise
βάτης	
βάτον	
βάτος	
βάτραχος	a frog
βατταλογήσητε	
βάψις	
βδέλυγμα	an abomination
ΒΔΕΛΥΓΜΑΤΩΝ	
βδελυκτός	disgusting, abominable
βδελύσσομαι	to feel nausea, to be sick
βέβαιος	firm, steady, steadfast, sure, certain
βεβαιόω	to make firm, confirm, establish, secure, warrant, make good
βεβαίωσις	confirmation
βεβη	
βέβηλος	allowable to be trodden, permitted to human use
βεβηλόω	to profane
Βεεζεβούλ	
Βελίαρ	
βελόνη	any sharp point, a needle
βέλος	a missile
βελτίων	better
Βενιαμείν	
Βερνίκη	
Βερνίκης	
Βεροία	
Βεροιαῖος	
Βεώρ	
Βηθανία	
Βηθανιά	
Βηθανίᾳ	
Βηθανίαν	
Βηθανίας	
Βηθζαθά	
Βηθλεέμ	
Βηθλεἐμ	
Βηθσαιδά	
Βηθσαιδάν	
Βηθφαγή	
βῆμα	a step, pace, stride
βήρυλλος	
βησαν	
βία	bodily strength, force, power, might
βιάζω	to constrain
βίαιος	forcible, violent
βιαστής	one who uses force, a violent man
βιαστός	
βιάω	to constrain
βιβλαρίδιον	
βιβλάριον	
βιβλίον	a paper, scroll, letter
ΒΙΒΛΟΣ	
βίβλος	the inner bark of the papyrus
βιβρώσκω	to eat, eat up
Βιθυνίη	
βίος	life
βιόω	to live, pass one's life
βίωσις	manner of life
βιωτικός	of or pertaining to life
βλα	
βλαβερός	hurtful, noxious, disadvantageous
βλάπτω	to disable, hinder, stop
βλαστᾷ	
βλαστάνω	to bud, sprout, grow
βλασφημέω	to drop evil or profane words, speak lightly or amiss of sacred things
βλασφημία	a profane speech
βλάσφημος	evil-speaking
βλάψις	a harming, damage
βλέμμα	a look, glance
βλέποντεξ	
βλέπος	a look
βλέπω	to see, have the power of sight
βλητέον	
βλητέος	one must put
βόα	
Βοανηργές	
βοάω	to cry aloud, to shout
βόειος	of an ox or oxen
Βοές	
βοή	a loud cry, shout
βοήθεια	help, aid, rescue, support
βοηθέω	to come to aid, to succour, assist, aid
βοηθός	assisting, auxiliary
βόηξον	
βόθυνος	
βολή	a throw, the stroke or wound
βολίζω	to heave the lead, take soundings
βόρβορος	mud, mire
Βορέας	the North wind
βος	
βόσκω	to feed, tend
βοτάνη	grass, fodder
βότρυς	a cluster or bunch of grapes
βου	
βουλεύς	
βουλευτής	a councillor, senator
βουλεύω	to take counsel, deliberate, concert measures
βουλή	will, determination
βούλημα	
βούλομαι	to will, wish, be willing
βουνός	a hill, mound
βοῦς	cow
βραβεῖον	a prize in the games
βραβεύω	to act as a judge or umpire
βραδύνω	to make slow, delay
βραδυπλοέω	to sail slowly
βραδύς	slow
βραδυτής	slowness
βράχεα	shallows
βραχίων	the arm
βραχύς	short
βρέφος	the babe in the womb
βρέχω	to be wetted, get wet
βροντάω	to thunder
βροντή	thunder
Βροντῆσ̓	
βρόντης	
βροχή	rain
βρόχος	a noose or slip-knot, for hanging or strangling
βρυγμός	
βρύκω	to eat with much noise, to eat greedily
βρύω	to be full to bursting
βρῶμα	that which is eaten, food, meat
βρώσιμος	eatable
βρῶσις	meat
βύζω	
βυθίζω	to sink
βυθός	the depth
βυρσεύς	a tanner
βύσσινος	made of βύσσος, σινδών β. a fine linen bandage, used for mummy-cloths,
βύσσος	a fine flax
βωμός	any raised platform, a stand
Γ	
Γαββαθά	
Γαβριήλ	
γάγγραινα	
Γάδ	
Γαδαρηνός	
γάζα	
γαζοφυλάκιον	a treasury
Γαῖα	
Γαῖον	
Γαῖ̈ος	
γάιος	on land
Γαῖος	
γαίω	to exult
γάλα	milk
Γαλάται	
ΓΑΛΑΤΑΣ	
Γαλάτης	
Γαλατίη	
Γαλατικός	
γαλήνη	stillness of the sea, calm
Γαλιλαία	
Γαλιλαίᾳ	
Γαλιλαίαν	
Γαλιλαίας	
Γαλιλαῖοι	
Γαλιλαῖος	
Γαλιλαίου	
Γαλιλαίους	
Γαλιλαίων	
Γαλλίων	
Γαλλίωνι	
Γαλλίωνος	
Γαμαλιήλ	
γαμέω	to marry
γαμίζω	to give in marriage
γαμίσκονται	
γάμος	a wedding, wedding-feast
γάρ	for
γ̓άρ	
γαστήρ	the paunch, belly
γε	at least, at any rate
Γέγοναν	
γέγοναν	
γέγω	
Γεδεών	
γέεννα	ge-hinnom
Γεθσημανεί	
γει	
γείτων	one of the same land, a neighbour
γελάω	to laugh
γέλως	laughter
γεμίζω	to fill full of, to load or freight with
γέμος	a load, freight
γέμω	to be full
γενεά	race, stock, family
γενεαλογέω	to trace by way of pedigree
γενεαλογία	the making a pedigree
γενέσιος	a day kept in memory of the dead
γένεσις	an origin, source, productive cause
γενετή	the hour of birth
γένημα	
γεννάω	to beget, engender
γέννημα	that which is produced or born, a child
Γεννησαρέτ	
γέννησις	an engendering, producing
γεννητός	begotten
γεννώ	
γένος	race, stock, family
Γερασηνῶν	
γερουσία	a Council of Elders, Senate
γερούσιας	
γερούσιος	for or befitting the seniors or chiefs
γἐρων	
γεῦσις	
γεύω	to give a taste of
γεωργέω	to be a husbandman, farmer
γεώργιον	
γεωργός	tilling the ground
γῆ	earth
γῆξ	
γηράσκω	to grow old, become old
γῆρος	
ΓΗΣ	
γίγνομαι	to come into being
γιγνώσκω	to learn to know, to perceive, mark, learn
γινώ	
Γἱός	
γλεῦκος	
γλυκύς	sweet
γλῶσσα	the tongue
γλωσσόκομον	a case for the mouthpiece of a pipe
γλωσσόκομος	
γλωσσός	
γναφεύς	
γνήσιος	of or belonging to the race
γνοῖ	
γνόφος	
γνώμη	a means of knowing, a mark, token
γνωρίζω	to make known, point out, explain
γνώρισις	acquaintance
γνωσαν	
γνῶσις	a judicial inquiry
γνώστης	one that knows
γνωστός	known, to be known
γογγύζω	to mutter, murmur
γογγυσμός	a murmuring
γογγυστής	a murmurer
γόης	one who howls out enchantments, a sorcerer, enchanter
Γολγοθά	
Γολγοθάν	
Γόμορρα	
Γομόρρας	
Γομόρρων	
γόμος	a ship's freight, burden, tonnage
γονεύς	a begetter, father
γονή	produce, offspring
γοντες	
γόνυ	the knee
γονυπετέω	to fall on the knee, to fall down before
γονυπετής	falling on the knee
γραμ	
γράμμα	that which is drawn
γραμματεύς	a secretary, clerk
γραπτός	marked as with letters
γραφεύς	a painter
γραφή	representation by means of lines
γραφής	
γράφος	
γράφω	to scratch, scrape, graze
γραώδης	like an old woman
γρηγορέω	to be awake or wakeful
γυμνάζω	to train naked, train in gymnastic exercise
γυμνάς	fem. of γυμνός, naked
γυμνασία	exercise
γυμνιτεύω	to be naked
γυμνός	naked, unclad
γυμνότης	nakedness
γυμνόω	to strip naked
γυναικάριον	
γυναικεῖος	of or belonging to women, like women, befitting them, feminine
γυνή	a woman
Γώγ	
γωνία	a corner, angle
δαιμονάω	to be under the power of a δαίμων, to suffer by a divine visitation
δαιμονίζομαι	to be possessed by a demon or evil spirit
δαιμόνιον	the Deity
δαιμόνιος	of or belonging to a δαίμων
δαιμονιώδης	demoniacal, devilish
δαίμων	a god, goddess
δάκνω	to bite
δάκρυον	a tear
δακρύω	to weep, shed tears
δακτύλιον	
δακτύλιος	a ring, seal-ring
δάκτυλος	a finger
Δαλμανουθά	
Δαλματία	
δαμάζω	to overpower
δάμαλις	a heifer
Δάμαρις	
Δαμασκηνόν	
Δαμασκός	
δανείζω	to put out money at usury, to lend
δάνειον	a loan
Δανιήλ	
δανιστῇ	
δαπα	
δαπανάω	to spend
δαπάνη	outgoing, cost, expense, expenditure
Δαυείδ	
ΔΕ	
δέ	but
δε	
δέησις	an entreating, asking: a prayer, entreaty
δεῖ	it is binding on
δεῖγμα	a sample, pattern, proof, specimen
δειγματίζω	to make a show of
δείκνυμι	to bring to light, display, exhibit
δειλία	cowardice
δειλιάω	to be afraid
δειλός	cowardly, craven
δεῖνα	such an one, a certain one
δεινός	fearful, terrible, dread, dire
δεινόω	to make terrible: to exaggerate
δεῖξις	
δείξις	
δειπνέω	to make a meal
δεῖπνον	the principal meal
δεῖπνος	
δεισιδαιμονία	fear of the gods, religious feeling
δεισιδαίμων	fearing the gods
δέκα	ten
δεκαπέντε	
δεκάπολις	a ten-city land, Decapolis
δεκατέσσαρες	
δεκατεσσάρων	
δεκάτη	
δέκατος	tenth
δεκατόω	to take tithe of
δεκτός	acceptable
δελεάζω	to entice or catch by a bait
δένδρον	a tree
δεξιά	the right hand
δεξιᾶ	
δεξιολάβος	a spearman
δεξιόομαι	to greet with the right hand, welcome, greet
δεξιός	on the right hand or side
δέον	that which is binding, needful, right, proper
δέος	fear, alarm, affright
Δερβαῖος	
Δέρβην	
δέρμα	the skin, hide
δερμάτινος	of skin, leathern
δέρος	
δέρω	to skin, flay
δεσμεύω	to fetter, put in chains
δέσμη	
δέσμιον	
δέσμιος	binding
δεσμός	anything for binding, a band, bond
δεσμοφύλαξ	a gaoler
δεσμωτήριον	a prison
δεσμώτης	a prisoner, captive
δεσποτέω	to be despotically ruled
δεσπότης	a master, lord, the master of the house
δεῦρο	hither
δεῦτε	hither! come on! come here!
δευτεραῖος	on the second day
δεύτερος	second
δέχομαι	to take, accept, receive
δέω	
δή	exactness
δῆλος	visible, conspicuous
δηλόω	to make visible or manifest, to show, exhibit
δήλωσις	a pointing out, manifestation, explaining, shewing
Δημᾶς	
δημηγορέω	to speak in the assembly
Δημήτριος	
δημιουργός	one who works for the people, a skilled workman, handicraftsman
δῆμος	a country-district, country, land
δημοσίᾳ	
δημόσιος	belonging to the people or state
δηνάριον	a denary
δἰ	
διά	through c. gen. through, by means of c. acc.
διᾴ	
διά-ἀγείρω	
διαβαίνω	to make a stride, walk or stand with the legs apart
διαβάλλω	to throw over or across, to carry over or across
διαβεβαιόομαι	to maintain strongly
διαβλέπω	to look straight before one
διάβολος	slanderous, backbiting
διαγγελῆ	
διαγγέλλω	to give notice by a messenger, to send as a message
διαγίγνομαι	to go through, pass
διαγιγνώσκω	to distinguish, discern
διάγνωσις	a distinguishing, discernment
διαγογγύζω	to murmur among themselves
διά-γρηγορέω	
διάγω	to carry over or across
διαδείκνυμι	to shew clearly, shew plainly
διαδέχομαι	to receive one from another
διάδημα	a band or fillet
διά-δίδημι	
διαδίδωμι	to give from hand to hand, to pass on, hand over
διάδοχος	succeeding
διά-ἐγείρω	
διά-ἐνθυμέομαι	
διαζώννυμι	to gird round the middle
διαθήκη	a disposition
διαίρεσις	a dividing, division
διαιρέω	to take one from another, to cleave in twain, to divide into parts
διακαθᾶραι	
διακαθαρίζω	
διακατελέγχομαι	to confute thoroughly
διακονέω	to minister, serve, do service
διακόνησις	
διακονία	the office of a διάκονος
διάκονος	a servant, waiting-man
διακόσιοι	two hundred
διακούω	to hear through, hear out or to the end
διακρίνω	to separate one from another
διάκρισις	separation, dissolution
διακωλύω	to hinder, prevent
διαλαλέω	to talk over
διαλέγω	to pick out one from another, to pick out
διαλείπω	to leave an interval between
διάλεκτος	discourse: discussion, debate, arguing
διαλλάγηθι	
διαλογίζομαι	to balance accounts
διαλογισμός	a balancing of accounts
διαλύω	to loose one from another, to part asunder, undo
διαμαρτύρομαι	to protest solemnly
διαμάχομαι	to fight or strive with, struggle against
διαμένω	to remain by, stand by
διαμερίζω	to distribute
διαμερισμός	division, dissension
διανέμω	to distribute, apportion
διά-νεύω	
διανόημα	a thought, notion
διάνοια	a thought, intention, purpose
διανοίγω	to open
διανυκτερεύω	to pass the night
διανύω	to bring quite to an end, accomplish, finish
διαπαρατριβή	violent contention
διαπεράω	to go over or across
διαπλέω	to sail across
διαπονέω	to work out with labour
διαπορεύω	to carry over, set across
διαπορέω	to be quite at a loss
διαπραγματεύομαι	to examine thoroughly
διαπρίω	to saw quite through, saw asunder
διαρπάζω	to tear in pieces
διάρπασις	
διαρρήγνυμι	to break through, cleave asunder
διασαφέω	to make quite clear, shew plainly
διασείω	to shake violently
διασκορπίζω	to scatter abroad
διασπάω	to tear asunder, part forcibly
διασπείρω	to scatter abroad, throw about
διασπορά	dispersion
διασπορεύς	
διάστασις	a standing aloof, separation
διαστέλλω	to put asunder, tear open
διάστημα	an interval
διαστολή	a notch or nick
διαστρεφοντα	
διαστρέφω	to turn different ways, to twist about, distort
διασῴζω	
διαταγή	an ordinance
διάταγμα	
διαταράσσω	to throw into great confusion, confound utterly
διατάσσω	to appoint or ordain severally, dispose
διατελέω	to bring quite to an end, accomplish
διατήκω	to melt, soften by heat
διατηρέω	to watch closely, observe
διατίθημι	to place separately, arrange
διατρίβω	to rub between, rub hard, rub away, consume, waste
διατροφή	sustenance, support
διαυγάζω	to shine through
διαυγής	transparent
διαφέρω	to carry over or across
διαφεύγω	to flee through, get away from, escape
διαφημίζω	to spread abroad
διαφθείρω	to destroy utterly
διαφθορά	destruction, ruin, blight, death.
διάφορος	different, unlike
διαφυλάσσω	to watch closely, guard carefully
διαχειρίζω	to have in hand, conduct, manage, administer
διαχλευάζω	
διαχωρίζω	to separate
διδακτικός	apt at teaching
διδακτός	taught, learnt
δίδαξις	teaching, instruction
ΔιδάσΑλε	
Διδάσκαλἐ	
διδασκαλία	teaching, instruction, education
διδάσκαλος	a teacher, master
διδάσκω	to teach
διδαχή	
δίδημι	to bind, fetter
δίδραχμος	worth two drachms: with pay of two drachms a day
δίδυμος	double, twofold, twain
δίδωμι	to give
διέξοδος	a way out through, an outlet, passage, channel
διερμηνευτής	an interpreter
διερμηνεύω	to interpret, expound
διέρχομαι	to go through, pass through
διερωτάω	to cross-question
διετής	of or lasting two years
διετία	a space of two years
Δίη	
διηγέομαι	to set out in detail, describe in full
διήγησις	narrative, statement
διηνεκής	continuous, unbroken
διηνοιγμένους	
διθάλασσος	between two seas, where two seas meet
διικνέομαι	to go through, penetrate
διίστημι	to set apart, to place separately, separate
διισχυρί	
διισχυρίζομαι	to lean upon, rely on
δικαία	
δικαιοκρισία	righteous judgment
Δίκαιος	
δίκαιος	observant of custom and social rule, well-ordered, civilised
δικαιοσύνη	righteousness, justice
δικάιοσυνην	
δικαιόω	to set right
δικαίωμα	an act by which wrong is set right
δικαίωσις	a setting right, doing justice to: punishment
δικαστής	a judge
δίκη	custom, usage
δίκτυον	a casting-net, a net
δίκτυς	
δίλογος	double-tongued, doubtful
διό	wherefore, on which account
διοδεύω	to travel through
Διονύσιος	
διόπερ	
διοπετοῦς	
διόρθωμα	a making straight, amendment
διόρθωσις	a making straight, restoration, reform
διορύσσω	to dig through or across
δῖος	god-like, divine
Διόσκοροι	the sons of Zeus
Διόσκουροι	
διότι	for the reason that, since
Διοτρέφης	
διπλάζω	to double
διπλόος	twofold, double
διπλός	
διπλόω	to double
δίς	twice, doubly
διστάζω	to be in doubt, hesitate
δίστομος	double-mouthed, with two entrances
δισχίλιοι	two thousand
διυλίζω	to strain off
διχάζω	to divide in two
διχοστασία	a standing apart, dissension
διχοτομέω	to cut in two, cut in twain
διχοτόμησις	
διψᾷ	
δίψα	thirst
διψάω	to thirst
δίψησις	
δίψος	
δίψυχος	double-minded
διωγμός	the chase
διωκτήρ	a pursuer
διώκτης	
διώκω	to pursue
δόγμα	that which seems to one, an opinion, dogma
δογματίζω	to decree
δοῖ	
δοκεύς	
δοκέω	videor mihi, to think, suppose, imagine, expect
δοκή	a vision, fancy
δοκιμάζω	to assay or test
δοκιμασία	an assay, examination, scrutiny
δοκιμεῖον	a test, means of testing
δοκιμή	a proof, test: tried character
δοκίμιος	
δόκιμος	assayed, examined, tested
δοκόν	
δοκός	a bearing-beam
δοκώ	
δόλιος	crafty, deceitful, treacherous
δόλος	a bait
δολόω	to beguile, ensnare, take by craft
δόμα	
δόξα	a notion
δοξάζω	to think, imagine, suppose, fancy, conjecture
δόξασις	
δόξις	
δορκάς	a kind of deer
δοσιν	
δόσις	a giving
δότης	
δουλαγωγέω	to make a slave, treat as such
δουλαγωγός	
δουλεία	servitude, slavery, bondage
δούλειος	slavish, servile
δούλευσις	
δουλεύω	to be a slave
δούλη	
δοῦλος	a born bondman or slave
δουλόω	to make a slave of, enslave
δουλων	
δοχή	a receptacle
δράκων	a dragon
δράσσομαι	to grasp
δραχμή	a handful
δρέπανον	a scythe
δρόμος	a course, running, race
Δρουσίλλῃ	
δύναμαι	to be able, capable, strong enough
δυναμέ	
δύναμις	power, might, strength
δυναμόω	to strengthen
δυνάστης	a lord, master, ruler
δυνατέω	to be powerful, mighty
δυνατός	strong, mighty, able
δύο	two
δυσβάστακτος	grievous to bear
δυσεντέριον	
δυσερμήνευτος	hard to interpret
δύσις	a setting of the sun or stars
δύσκολος	hard to satisfy with food;
δυσμή	setting
δυσνόητος	
δυσφημέω	to use ill words
δυσφημία	ill language, words of ill omen
δύω	to strip off
δώδεκα	twelve
δωδέκατος	the twelfth
δωδεκάφυλος	of twelve tribes
δῴη	
δῶμα	a house
δωματόω	
δωμάω	to build
δωρεά	a gift, present
δωρέω	to give, present
δώρημα	that which is given, a gift, present
δῶρον	a gift, present
Δῶρος	
δώσων	always going to give
ἕ	sui.
ἐ	
ἔα	ha! oho!
ἐάν	if haply
ἑαντόν	
ἔαρ	spring
ἑαυ	
ἑαυτοῦ	itself, absolutely
ἐάω	to let, suffer, allow, permit
ἑβδομήκοντα	seventy
ἑβδομηκοντάκις	
ἕβδομος	seventh
Ἔβερ	
Ἐβραΐδι	
Ἐβραῖοι	
Ἐβραῖος	
Ἐβραίους	
ΕΒΡΑΙΟΥΣ	
Ἐβραϊστί	
Ἐβραίων	
ἐγγίζει	
ἐγγίζειν	
ἐγγίζομεν	
ἐγγίζοντες	
ἐγγίζοντι	
ἐγγίζοντος	
ἐγγιζόντων	
ἐγγίζουσαν	
ἐγγίζουσιν	
ἐγγίσαι	
ἐγγίσαντος	
ἐγγίσας	
ἐγγίσατε	
ἐγγίσει	
ἐγγράφω	to mark in or on, to paint on
ἔγγυος	giving security
ἐγγύς	near, nigh, at hand
ἐγγύτερος	
ἐγέ	
ἐγείρω	to awaken, wake up, rouse
ΕΓΕΝΕΤΟ	
ἐγενη	
ἐγενήοη	
ἔγερσις	a waking
ἐγκαινίζω	to renovate, consecrate
ἐγκακέω	to lose heart, grow weary
ἐγκαλέω	to call in
ἐγκαταλείπω	to leave behind
ἔγκλημα	an accusation, charge, complaint
ἐγκομβόομαι	to bind a thing
ἐγκόπτω	to hinder, thwart
ἐγκράτεια	mastery over
ἐγκρατεύεται	
ἐγκρατεύονται	
ἐγκρατής	in possession of power
ἐγκρίνω	to reckon in or among
ἐγκρύπτω	to hide or conceal in
ἔγνωκαν	
ἐγνώκειτε	
έγνωρισθη	
ἐγχρίω	to rub, anoint
ἐγώ	ego
Εγώ	
ἐδαφίζω	to dash to the ground
ἔδαφος	the bottom, foundation, base
ἐδι	
ἐδολιοῦσαν	
ἑδραῖος	sitting, sedentary
ἑδραίωμα	a foundation, base
ἔδω	to eat
ἐΈκοψεν	
ἐζ	
Ἑζεκίαν	
Ἑζεκίας	
ἐζώννυες	
ἐθελοθρησκίᾳ	
ἐθέλω	to will, wish, purpose
ἐθερά	
ἐθηριομάχησα	
ἐθίζω	to accustom, use
ἐθνάρχης	an ethnarch
ἔθνεξιν	
ἐθνικός	foreign, heathen, gentile
ἔθνος	a number of people accustomed to live together, a company, body of men
ἔθος	custom, habit
ἔθω	to be accustomed
εἰ	whether.
Εἴδαμεν	
εἴδαμεν	
εἶδαν	
εἰδέα	
εἰδοί	Idus
εἴδομαι	are visible, appear
εἶδον	to see, perceive, behold
εἶδος	that which is seen, form, shape, figure
εἰδώλιον	
εἰδωλόθυτος	sacrificed to idols
εἰδωλολάτρης	an idol-worshipper, idolater
εἰδωλολατρία	
εἴδωλον	an image, a phantom
εἰκάζω	to make like to, represent by a likeness, portray
εἰκῇ	without plan or purpose, heedlessly, rashly, at random, at a venture
εἴκοσι'	
εἴκοσι	twenty
εἴκω	to yield, give way, draw back, retire
εἰκών	a likeness, image, portrait
εἴληφες	
εἰλικρινής	unmixed, without alloy, pure
εἰλικρινίᾳ	
εἰλικρινίας	
εἱλκωμένος	
εἰμί	to be, to exist
εἶμι	to go
εἰξ	
εἰ̈πεν	
εἰπεν	
εἴπεν	
εἴπερ	strengthd. for
εἶπον	to speak, say
εἶπος	
εἴρηκαν	
εἰρηνεύω	to bring to peace, reconcile
εἰρήνη	peace, time of peace
Εἰρήνη	
εἰρηνικός	of or for peace, peaceful
εἰρηνοποιήσας	
εἰρηνοποιός	a peace-maker
εἴρω	
εἰς	into, to c. acc.
εἷς	
εἰσάγω	to lead in or into, to introduce
εἰσακούω	to hearken or give ear to one
εἰσδέχομαι	to take into, admit
εἰσ-δυάω	
εἴσειμι	to go into
εἰσελήλυθαν	
Εἰσέλθατε	
εἰσελθάτω	
εἰσέρχομαι	to go in or into, enter
εἰσήλθαμεν	
εἰσήλθατε	
εἰσθέω	to run into, run up
εἰσίημι	to send into
εἰσκαλέω	to call in
εἴσοδος	a way in, entrance
εἴσοπτρον	a mirror
εἰσπηδάω	to leap into
εἰσπορεύω	to lead into
εἰστίθημι	to put into, place in
εἰσ-τιτρώσκω	
εἰστρέχω	to run in
εἰσφέρω	to carry into or to
εἰσωθέω	to thrust into
εἶτα	then, next
εἴτε	
εἶτεν	
εἴτῃ	
εἴχαμεν	
εἶχαν	
εἰχεν	
εἴχοσαν	
ἐκ	from out of
ἐκαθερίσθη	
ἐκ-ἀκολουθέω	
ἐκάμμυσαν	
ἔκαστος	
ἕκαστος	every, every one, each, each one
ἑκάστοτε	each time, on each occasion
ἑκατόν	a hundred
ἑκατονταετής	
ἑκατονταπλασίων	a hundred times as much or many
ἑκατοντάρχης	leader of a hundred
ἑκατόνταρχος	
ἐκβαίνω	to step out of or off from
ἐκβάλλω	to throw or cast out of
ἔκβασις	a way out, egress
ἐκβολή	a throwing out
ἔκγονος	born of, sprung from
ἐκ-δαπανάω	
ἐκδέχομαι	to take or receive from
ἐκδέω	to bind so as to hang from, to fasten to or on
ἐκδημέω	to be abroad, to be on one's travels
ἐκδίδωμι	to give up, surrender
ἐκ-διηγέομαι	
ἐκδικέω	to avenge, punish
ἐκδίκησις	an avenging
ἔκδικος	without law, lawless, unjust
ἐκδιώκω	to chase away, banish
ἔκδοτος	given up, delivered over, surrendered
ἐκδοχή	a receiving from another, succession
ἐκ-δύω	
ἐκδύω	to take off, strip off
ἐκ-ἔδω	
ἐκεῖ	there, in that place
ἐκεῖθεν	from that place, thence
έκεινας	
ἐκεῖνος	the person there, that person or thing
ἑκεῖνος	
ἐκεῖσε	thither, to that place
ἐκέκραξα	
ἐκ-ἐπιέννυμι	
ἐκεφαλίωσαν	
ἐκ-ἐφέζομαι	
ἐκζητέω	to seek out, enquire
ἐκζήτησις	
ἐκθαμβέομαι	to be amazed
ἐκ-θαμβέω	
ἔκθαμβος	amazed, astounded
ἐκ-θαυμάζω	
ἔκθετος	exposed
ἐκ-ἱστάνω	
ἐκκαθάρατε	
ἐκκαθάρῃ	
ἐκκαίω	to burn out
ἐκ-κεντέω	
ἐκ-κλάω	
ἐκκλείω	to shut out from
ἐκκλησία	an assembly of the citizens regularly summoned, the legislative assembly
ἐκκλησιάζω	to hold an assembly, debate therein
ἐκκλίνω	to bend out of the regular line
ἐκκολυμβάω	to swim out of
ἐκκομίζω	to carry out
ἐκκόπτω	to cut out, knock out
ἐκ-λάζομαι	
ἐκλαλέω	to speak out, blab, divulge
ἐκλάμπω	to shine or beam forth
ἐκλανθάνω	to escape notice utterly: —
ἐκλέγω	to pick or single out
ἐκ-λέγω	
ἐκλεζαμένους	
ἐκλείπω	to leave out, omit, pass over
ἐκλεκτός	picked out, select
ἐκλέπω	to bring
ἐκλογεύς	
ἐκλογή	a picking out, choice, election
ἐκλύω	to loose, release, set free, from
ἐκμάσσω	to wipe off, wipe away
ἐκμυκτηρίζω	to turn up one's nose at, mock at
ἐκνεύω	to turn the head aside
ἐκνέω	to swim out, swim to land, escape by swimming
ἐκνήφω	to sleep off a drunken fit, become sober again
ἐκνίζω	to wash out, purge away
ἑκούσιος	voluntary
ἔκπαλαι	
ἐκπάλλω	to shake out
ἐκπειράζω	to tempt
ἐκπειράομαι	to make trial of, prove, tempt
ἐκπέμπω	to send out or forth from
ἐκπερισσῶς	more exceedingly
ἐκπετάννυμι	to spread out
ἐκπηδάω	to leap out
ἐκπίπτω	to fall out of
ἐκπλέω	to sail out, sail away, weigh anchor
ἐκπλήγνυμι	
ἐκπληρόω	to fill quite up
ἐκπλήρωσις	
ἐκπνέω	to breathe out or forth
ἐκπορεύω	to make to go out, fetch out
ἐκπορνεύω	to commit fornication
ἐκπτύω	to spit out of
ἐκραίνω	to scatter out of, make to fall in drops from
ἐκρήγνυμι	to break off, snap asunder
ἐκρι	
ἐκριζόω	to root out
ἔκρινομεθα	
fεκροί	
fεκρῶν	
ἔκστασις	any displacement: entrancement, astonishment
ἐκστρέφω	to turn out of, root up from
ἐκσῴζω	
ἐκταράσσω	to throw into great trouble, to agitate
ἐκτείνω	to stretch out
ἐκτελέω	to bring quite to an end, to accomplish, achieve
ἐκτένεια	intensity, zeal, earnestness
ἐκτενής	intense, zealous, instant
ἕκτη	
ἐκτίθημι	to set out, place outside
ἐκτινάσσω	to shake out
ἐκτίνω	to pay off, pay in full
ἐκτός	outside
ἕκτος	sixth
ἐκτρέπω	to turn out of the course, to turn aside
ἐκτρέφω	to bring up from childhood, rear up
ἔκτρωμα	a child untimely born, an abortion
ἐκύκλευσαν	
ἐκφέρω	to carry out of
ἐκφεύγω	to flee out or away, escape
ἔκφευξις	
ἐκφοβέω	to frighten away, affright
ἔκφοβος	affrighted
Ἐκφοβός	
ἐκφύω	to generate from
ἐκχέω	to pour out
ἐκχυννόμενον	
ἐκχωρέω	to go out and away, depart, emigrate
ἐκψύχω	to give up the ghost, expire
ἑκών	willing, of free will, readily
ἐλαία	the olive-tree
Ἐλαίη	
ἔλαιον	olive-oil
ἔλαιος	the wild olive
Ἐλαιός	
ἐλαιόω	
ἐλαιών	an olive-yard
Ἐλαμεῖται	
ἐλασσόω	to make less or smaller, to lessen, diminish, lower
ἐλάσσων	smaller, less
ἐλατόμησεν	
ἐλαύνω	to drive, drive on, set in motion
ἐλαφρία	lightness: levity
ἐλαφρός	lightly, buoyantly
ἐλάχιστος	the smallest, least
ἔλαχος	
ἐλέα	
Ἐλεάζαρ	
ἐλεᾶς	a kind of owl
ἐλεᾶτε	
ἐλεγμός	
ἔλεγξις	a conviction
ἔλεγος	a song of mourning, a lament
ἔλεγχος	a cross-examining, testing
ἐλέγχω	to disgrace, put to shame
ἐλεεινός	finding pity, pitied or moving pity, pitiable, piteous
ἐλεέω	to have pity on, shew mercy upon
ἐλεημοσύνη	pity, mercy: a charity, alms
ἐλεήμων	pitiful, merciful, compassionate
Ἐλεισάβετ	
ἐλεός	a kitchen-table, a board on which meat was cut up, a dresser
ἔλεος	pity, mercy, compassion
Ελεος	
Ἔλεος	
ἐλευθερία	freedom, liberty
ἐλεύθερος	free
ἐλευθερόω	to free, set free
ἐλευθέρωσις	a setting free
ἐλεύκαναν	
ἔλευσις	a coming:—the Advent
ἐλεφάντινος	of ivory, ivory
ἐλεῶντος	
ἐλθάτω	
ἐλθῃ	
Ἐλιακείμ	
ἕλιγμα	a curl, lock
Ἐλιέζερ	
Ἐλιούδ	
Ἐλισαίου	
ἑλίσσω	to turn round, to turn
ἑλκέω	to drag about, tear asunder
ἕλκος	a wound
ἑλκόω	to wound sorely, lacerate
ἐλκύσῃ	
ἕλκω	to draw, drag
Ἑλλάς	Hellas
Ἕλλη	
Ἕλλην	Hellen
Ἑλληνικός	Hellenic, Greek
Ἑλληνίς	a Grecian woman
Ἑλληνιστής	one who uses the Greek language;
Ἑλληνιστί	in Greek fashion
ἐλλόγα	
ἐλλογᾶται	
Ἐλμαδάμ	
ἑλπίδι	
ἐλπίζω	to hope for, look for, expect
ἐλπίς	hope, expectation
Ἐλύμας	
ἐλύω	to roll round
ἐλωί	
Ἐλωί	
ἐματαιώθησαν	
ἐμαυτοῦ	of me, of myself
ἐμβαίνω	to step in
ἐμβάλλω	to throw in, put in
ἐμβάπτω	to dip in
ἐμβάς	a felt-shoe
ἐμβατεύω	to step in or on, to frequent, haunt
ἐμβιβάζω	to set in or on
ἐμβλέπω	to look in the face, look at
ἐμβριμάομαι	to snort in
ἑμέ	
ἐμέω	to vomit, throw up
ἐμμαίνομαι	to be mad at
Ἐμμανουήλ	
Ἐμμαούς	
ἐμμένω	to abide in
Ἑμμώρ	
ἐμός	mine
ἔμπαιγμα	mockery
ἐμπαιγμονή	
ἐμπαιγμός	
ἐμπαίζω	to mock at, mock
ἐμπαίκτης	a mocker, deceiver
ἐμπίμπρημι	to kindle, burn, set on fire
ἐμπίπλημι	to fill quite full
ἐμπίπτω	to fall in or upon or into
ἐμπλέκω	to plait or weave in
ἐμπλοκή	
ἐμπνέω	to blow or breathe upon
ἐμπορεύομαι	to travel
ἐμπορία	commerce, trade, traffic
ἐμπόριον	the Exchange
ἐμπόριος	
ἔμπορος	one who goes on shipboard as a passenger
ἐμπρήθω	to blow up, inflate
ἔμπροσθεν	before, in front
ἐμπτύω	to spit into
ἐμφανής	shewing in
ἐμφανίζω	to make manifest, exhibit
ἔμφοβος	terrible
ἐμφυσάω	to blow in: to play the flute
ἔμφυτος	implanted, innate, natural
ἐμφύω	to implant
ἐμωράνθησαν	
ἐν	in, among. c. dat.
ΕΝ	
ἐναγκαλίζομαι	to take in one's arms
ἐνάλιος	in, on, of the sea
ἔναντι	in the presence of
ἐναντίον	
ἐναντίος	opposite
ἐναρξαμενοι	
ἐνάρχομαι	to begin the offering
ἔνατος	ninth
ἐνδεής	in need of
ἔνδειγμα	a proof, token
ἐνδείκνυμι	to mark, point out
ἔνδειξις	a pointing out
ἕνδεκα	eleven
ἑνδέκατος	the eleventh
ἐνδέχομαι	to take upon oneself
ἐνδημέω	to live in
ἐνδιδύσκω	to put on
ἔνδικος	according to right, right, just, legitimate
ἐν-δοξάζω	
ἔνδοξος	held in esteem or honour, of high repute
ἔνδυμα	a garment
ἐνδυματος	
ἐνδυναμόω	to strengthen
ἐνδύναμώσαντι	
ἐνδύνοιτες	
ἔνδυσις	a putting on
ἐνδύω	to go into
ἐν-δύω	
ἐνδώμησις	
ἐνέδρα	a sitting in: a lying in wait, ambush
ἐνεδρεύω	to lie in wait for
ἐνείλλω	
ἐν-εἰμί	
ἕνεκα	on account of, for the sake of, because of, for
ἐνενήκοντα	ninety
ἐνεός	dumb, deaf and dumb
ἐνέργεια	action, operation, energy
ἐνεργέω	to be in action, to operate
ἐνέργημα	
ἐνεργής	productive
ἐνεργός	at work, working, active, busy
ἐν-ἐρῶ	
ἐνετείλα	
ἐνευλογέομαι	to be blessed in
ἐνέχω	to hold within
ἐνθάδε	thither, hither
ἔνθεν	on the one side
ἐνθυμέομαι	to lay to heart, consider well, reflect on, ponder
ἐνθύμησις	consideration, esteem
ἐν-θυμόω	
ἐνι	
ἐνιαυτός	any long period of time, a cycle, period
ἐνιδρόω	to sweat in, labour hard in
ἐνίπτω	to reprove, upbraid
ἐνίστημι	to put, set, place in
ἐν-ἰσχύω	
ἐνκαθέτους	
ἐνκαίνια	
ἐνκαταλείψεις	
ἐνκατελείφθη	
ἐνκατοικῶν	
ἐν-καυχάομαι	
ἐν-κεντρίζω	
ἐνκοπήν	
ἐνκύῳ	
ἐν-λάω	
ἐννέα	nine
ἐννεύω	to make signs to, to ask by signs
ἔννοια	a thought in the mind, notion, conception
ἔννομος	within the law, lawful, legal
ἔννυχος	
ἐνοικέω	to dwell in
ἐν-ὁρκίζω	
ἕνος	belonging to the former of two periods, last year's
ἑνότης	
ἐνοχλέω	to trouble, disquiet, annoy
ἔνοχος	held in
ἐνπεριπατήσω	
ἔνταλμα	
ἐνταφιάζω	to prepare for burial
ἐνταφιασμός	burial
ἔντεα	fighting gear, arms, armour
ἐντέλλω	to enjoin, command
ἐντεῦθεν	hence or thence
ἔντευξις	a lighting upon, meeting with, converse, intercourse
ἔντιμος	in honour, honoured, prized
ἐντολεύς	
ἐντολή	an injunction, order, command, behest
ἐντόπιος	
ἐντός	within, inside
ἐντρέπω	to turn about
ἐντρέφω	to bring up in
ἔντρομος	trembling
ἐντροπή	a turning towards
ἐντρυφάω	to revel in
ἐντυγχάνω	to light upon, fall in with, meet with
ἐντυλίσσω	to wrap up
ἐντυπόω	to cut in intaglio
ἐνυβρίζω	to insult or mock
ἐνυπνιαζόμενοι	
ἐνυπνιασθήσονται	
ἐνύπνιον	a thing seen in sleep
ἐνύπνιος	in dreams appearing
ἐνώπιος	face to face
Ἐνώς	
ἐνωτίζομαι	to hearken to
Ἑνώχ	
ἕξ	six
ἐξαγαγέτωσαν	
ἐξαγγέλλω	to send out
ἐξαγοράζω	to buy up
ἐξάγω	to lead out
ἐξαιρέω	to take out of
ἐξαίρω	
ἐξαιτέω	to demand or ask for from
ἐξαίφνης	on a sudden
ἑξακόσιοι	six hundred
ἐξαλείφω	to plaster or wash over
ἐξάλειψις	
ἐξαλιφθῆναι	
ἐξάλλομαι	to leap out of or forth from
ἐξανάστασις	a rising up from, resurrection
ἐξανατέλλω	to spring up from
ἐξανίστημι	to raise up: to make one rise
ἐξαπατάω	to deceive or beguile thoroughly
ἐξαπάτησις	
ἐξάπινα	
ἐξαπορέω	to be in great doubt or difficulty
ἐξαποστέλλω	to send quite away:—Pass.
ἐξαράομαι	to utter curses
ἐξαράσσω	to dash out, shatter
ἐξαρτίζω	to complete, finish
ἐξάρχω	to begin with, make a beginning of
ἐξαστράπτω	to flash as with lightning
ἐξαυτῆς	at the very point of time, at once
ἐξεγείρω	to awaken
ἐξείλλω	to disentangle
ἔξειμι	to go out, come out
ἐξεκρέμετο	
ἐΞέλθατε	
ἐξέλθατε	
ἐξέλκω	to draw or drag out
ἐξέραμα	a vomit, thing vomited
ἐξέρχομαι	to go or come out of
ἔξεστι	it is allowed, it is in one's power, is possible
ἐξετάζω	to examine well or closely, inquire into, scrutinise, review
ἐξεφίημι	to enjoin, command
ἐξέφνης	
ἐξεχύννετο	
ἐξέχω	to stand out or project from
ἐξέψυξͅεν	
ἐξηγέομαι	to be leader of
ἑξήκοντα	sixty
ἐξῆλθαν	
ἐξήλθατε	
Ἕξἡμεραι	
ἐξηραύνησαν	
ἑξῆς	one after another, in order, in a row
ἐξηχέω	to sound forth
ἐξίημι	to send out, let
ἕξις	a having, possession
ἐξίστημι	to put out of its place, to change or alter utterly
ἐξισχύω	to have strength enough, to be quite able
ἔξοδος	
ἐξολεθρευθήσεται	
ἐξομολογέομαι	to confess in full
ἐξομολογησομαί	
ἔξονται	
ἐξορκίζω	to adjure
ἐξορκισ́τῶν	
ἐξορύσσω	to dig out
ἐξουδενηθῇ	
ἐξουθενέω	
ἐξουσία	power or authority
ἐξουσιάζω	to exercise over
ἐξοχή	prominence
ἐξυπνίζω	to awaken from sleep
ἔξυπνος	awakened out of sleep
ἔξω	out
ἔξωθεν	from without
ἐξωθέω	to thrust out, force out, wrench out
ἐξώτερος	outer, utter
ἔοικα	to be like
fέον	
ἑόρακαν	
ἑορτάζω	to keep festival or holiday
ἑορτή	a feast or festival, holiday
ΕΟΡΤΗΣ	
ἐπ̓	
ἐπαγγελία	a public denunciation
ἐπαγγέλλω	to tell, proclaim, announce
ἐπάγγελμα	a promise, profession
ἐπαγείρω	to gather together, collect
ἐπάγνυμι	to break
ἐπάγω	to bring on
ἐπαγωνίζομαι	to contend with
ἐπαείδω	to sing to or in accompaniment
ἐπαθροίζομαι	to assemble besides
Ἐπαίνετον	
ἐπαινέω	to approve, applaud, commend
ἔπαινος	approval, praise, commendation
ἐπαίρω	to lift up and set on
ἐπαισχύνομαι	to be ashamed at or of
ἐπαιτέω	to ask besides
ἐπαίτης	
ἐπακολουθέω	to follow close upon, follow after
ἐπακούω	to listen or hearken to, to hear
ἐπάν	
ἐπανάγκης	it is necessary
ἐπανάγω	to bring up: to stir up, excite
ἐπαναμιμνήσκω	to remind
ἐπαναπαήσεται	
ἐπαναπαύομαι	to rest upon, depend upon
ἐπανέρχομαι	to go back, return
ἐπανίστημι	to set up again
ἐπανόρθωσις	a correcting, revisal
ἐπάνω	above, atop, on the upper side or part
ἐπαραρίσκω	to fit to or upon, fasten to
ἐπάρατος	accursed, laid under a curse
ἐπάρκεσις	aid, succour
ἐπαρκέω	to ward off
ἐπαρχεία	
ἔπαυλις	a fold
ἐπαυρέω	to partake of, share
ἐπαύριον	
ἐπαύω	to shout over
Ἐπαφρᾶ	
Ἐπαφρᾶς	
ἐπαφρίζω	to foam up or on the surface
ἐπαφρόδιτος	lovely, charming
ἐπέ	
ἐπεγείρω	to awaken, rouse up
ἐπεί	after that, after (postquam), since, when (quum)
Επειδή	
ΕΠΕΙΔΗΠΕΡ	
ἐπεῖδον	to look upon, behold
ἔπειμι	to be upon
ἐπεισαγωγή	a bringing in besides, a means of bringing or letting in
ἐπεισέρχομαι	to come in besides
ἔπειτα	thereupon
ἐπέκεινα	on yonder side, beyond
ἐπεκτείνω	to extend
ἐ̂πεν	
ἐπενδύνω	to put on
ἐπενδύτης	
ἐπέρχομαι	to come upon, come near, come suddenly upon
ἐπερωτάω	to inquire of, question, consult
ἐπερώτημα	a question
ἐπέχω	to have or hold upon
ἐπη	
Ἐπῆλθαν	
ἐπηρεάζω	to threaten abusively
ἐπί	on, upon with gen., dat., and acc.
ἐπι	
ἐπί-ἀκροάομαι	
ἐπιβαίνω	to go upon
ἐπιβάλλον	
ἐπιβάλλω	to throw or cast upon
ἐπί-βαρέω	
ἐπιβιβάζω	to put
ἐπιβλέπω	to look upon, look attentively
ἐπίβλημα	that which is thrown over, tapestry, hangings
ἐπιβουλή	a plan against
ἐπιγάμβρευσις	
ἐπιγαμβρεύω	to marry as the next of kin
ἐπίγειος	terrestrial
ἐπιγίγνομαι	to be born after, come into being after
ἐπιγιγνώσκω	to look upon, witness, observe
ἐπίγνωσις	full knowledge
ἐπιγραφή	an inscription
ἐπιγράφω	to mark the surface, just pierce, graze
ἐπιδείκνυμι	to exhibit as a specimen
ἐπιδέχομαι	to admit besides or in addition
ἐπιδημέω	to be at home, live at home
ἐπιδιατάσσομαι	to add an order
ἐπιδίδωμι	to give besides
ἐπιδιορθόομαι	to set in order also
ἐπιδιόρθωσις	
ἐπιδύω	to set upon
ἐπιεικής	fitting, meet, suitable
ἐπιεικίᾳ	
ἐπιεικίας	
ἐπιέννυμι	to put on besides or over
ἐπί-ἔπειμι	
ἐπί-ἐπιέννυμι	
ἐπί-ἐφέζομαι	
ἐπί-ἐφίημι	
ἐπιζητέω	to seek after, wish for, miss
ἐπιθανάτιος	
ἐπίθεσις	a laying on
ἐπιθέω	to run at or after
ἐπιθυμέω	to set one's heart upon
ἐπιθύμησις	
ἐπιθυμητής	one who longs for or desires
ἐπιθυμητός	
ἐπιθυμία	desire, yearning, longing
ἐπιθυμιάω	to offer incense
ἐπικαθίζω	to set upon
ἐπικαλέω	to call upon
ἐπικάλυμμα	
ἐπικαλύπτω	to cover over, cover up, shroud
ἐπικατάρατος	yet more accursed
ἐπίκειμαι	to be laid upon
ἐπικέλλω	to bring to shore
ἐπικέλομαι	to call upon
ἐπικουρία	aid, succour
ἐπικούριος	
ἐπικραίνω	to bring to pass, accomplish, fulfil
ἐπικρίνω	to decide, determine
ἐπιλαμβάνω	to lay hold of, seize, attack
ἐπιλέγω	to choose, pick out, select
ἐπιλείβω	to pour
ἐπιλείπω	to leave behind
ἐπί-λείχω	
ἐπίλειψις	a deficiency, lack
ἐπιλήθω	to cause to forget
ἐπιλησμονή	forgetfulness
ἐπίλοιπος	still left, remaining
ἐπίλυσις	release from
ἐπιλύω	to loose, untie
ἐπιμαρτυρέω	to bear witness to
ἐπιμέλεια	care, attention
ἐπιμελέομαι	to take care of, have charge of, have the management of
ἐπιμελής	careful or anxious about, put in charge of
ἐπιμένω	to stay on, tarry or abide still
ἐπινεύω	to nod
ἐπινέω	
ἐπίνοια	a thinking on or of
ἔπιον	
ἐπιορκέω	to swear falsely, forswear oneself
ἐπίορκος	sworn falsely
ἐπιούσιος	for the coming day, sufficient for the day
ἐπιπίνω	to drink afterwards or besides
ἐπιπίπτω	to fall upon or over
ἐπιπλήσσω	to strike at, strike smartly
ἐπιπόθειαν	
ἐπιποθέω	to yearn after
ἐπιπόθησις	a longing after
ἐπιπόθητος	longed for, desired
ἐπιπορεύομαι	to travel, march to, march over
ἐπιρράπτω	to sew or stitch on
ἐπιρρίπτω	to cast at
ἐπίσημον	any distinguishing mark, a device or badge, the bearing
ἐπίσημος	having a mark on
ἐπισιτισμός	a furnishing oneself with provisions, foraging
ἐπισκέ	
ἐπισκέπτης	
ἐπισκέπτομαι	
ἐπισκευάζω	to get ready, to equip, fit out
ἐπί-σκηνάω	
ἐπί-σκηνόω	
ἐπισκιάζω	to throw a shade upon, overshadow
ἐπισκοπέω	to look upon or at, inspect, observe, examine, regard
ἐπισκοπή	a watching over, visitation
ἐπίσκοπος	
ἐπισπάω	to draw or drag after
ἐπισπείρω	to sow with seed
ἐπίσταμαι	to know
ἐπίστασις	a stopping, halting, a halt
ἐπιστάτη	
ἐπιστάτης	one who stands near or by, a suppliant
ἐπιστέλλω	to send to, send as a message or letter
ἐπίστημος	
ἐπιστήμων	knowing, wise, prudent
ἐπιστηρίζω	to make to lean on
ἐπιστολεύς	secretary
ἐπιστολή	a message, command, commission
ἐπιστομίζω	to curb in
ἐπιστρέφω	to turn about, turn round
ἐπίστρεψις	
ἐπιστροφή	a turning about, twisting
ἐπισυνάγω	to collect and bring to
ἐπισυναγωγή	a gathering or being gathered together
ἐπισυντρέχω	to run together to
ἐπισφαλής	prone to fall, unstable, precarious
ἐπισχύω	to make strong or powerful
ἐπί-σωρεύω	
ἐπιταγή	
ἐπίταξις	an injunction
ἐπιτάσσω	to put upon
ἐπιτέλεσις	
ἐπιτελέω	to complete, finish, accomplish
ἐπιτέλλω	to lay upon, enjoin, prescribe, ordain, command
ἐπιτέρπομαι	to rejoice or delight in
ἐπιτήδειος	made for an end or purpose, fit or adapted for it, suitable, convenient
ἐπιτήκω	to melt upon, pour when melted over
ἐπιτίθημι	to lay, put or place upon
ἐπιτιμάω	to lay a value upon
ἐπιτιμή	
ἐπιτιμία	the condition of an ἐπίτιμος
ἐπιτίμιος	
ἐπιτρέπω	to turn towards
ἐπιτροπή	a reference
ἐπίτροπος	one to whom a charge is entrusted, a trustee, administrator
ἐπιτυγχάνω	to hit the mark
ἐπιφαίνω	to shew forth, display, shew off
ἐπιφάνεια	manifestation
ἐπιφανής	coming to light, appearing
ἐπιφαύω	to shine upon
ἐπιφέρω	to bring, put or lay upon
ἐπιφωνέω	to mention by name, tell of
ἐπιφώσκω	to draw towards dawn
ἐπιχειρέω	to put one's hand on
ἐπιχέω	to pour water over
ἐπιχορηγέω	to supply besides
ἐπιχορηγία	additional help
ἐπιχρίω	to anoint, besmear
ἐπλη	
ΕΠΛΗΡΩΘΗ	
ἐποικοδομέω	to build up
ἐπονομάζω	to give a surname: to name or call
ἐποπτεύω	to look over, overlook, watch
ἐπόπτης	an overseer, watcher
ΕΠΟΡΕΥΘΗΣΑΝ	
ἔπος	a word
ἐπουράνιος	in heaven, heavenly
ἐπόυρανιων	
ἐπροφήτευον	
ἐπροφητεύσαμεν	
ἐπροφήτευσαν	
Ἐπροφήτευσεν	
ἐπροφήτευσεν	
ἑπτά	seven
ἑπτάκις	seven times
ἑπτακισχίλιοι	seven-thousand
ἑπτάς	
ἐπύ	
ἐραβδίσθην	
Ἔραστον	
Ἔραστος	
ἐραυνᾷ	
ἐραυνᾶτε	
ἐραύνησον	
ἐραυνῶν	
ἐραυνῶντες	
ἐράω	
ἐργάζομαι	to work, labour
ἐργασία	work, daily labour, business
ἔργασις	
ἐργάτης	a workman
ἔργνυμι	to confine
ἔργον	work
ἔρδω	to do
ἐρεθίζω	to rouse to anger, rouse to fight, irritate
ἐρείδω	
ἐρέσσω	to row
ἐρεύγομαι	to spit or spew out, to disgorge
ἐρέω	to ask, enquire
ἐρημία	a solitude, desert, wilderness
ἐρῆμος	desolate, lone, lonely, lonesome, solitary
ἐρημόω	to strip bare, to desolate, lay waste
ἐρήμωσις	
ἐρίζω	to strive, wrangle, quarrel
ἐριθία	
ἐριθίαι	
ἐριθίαν	
ἐριθίας	
ἐριμμένοι	
ἔριον	wool
ἔρις	strife, quarrel, debate, contention
ἐρίφιον	a kid
ἔριφος	a young goat, kid
ἑρμηνεύω	to interpret
ἑρμηνία	
ἑρμηνίαν	
Ἑρμῆς	Hermes
Ἑρμογένης	
ἔρομαι	to ask, enquire
ἑρπετόν	a walking animal, quadruped
Ἐρυθραί	
ἐρυθρός	red
ἐρύω	to drag along the ground, drag, draw
ἐρχεται	
ἔρχομαι	to come or go
ἐρῶ	I will say or speak
ἐρωτάω	to ask
ἐρώτησις	a questioning
ἐσεσθε	
ἐσθής	dress, clothing, raiment
ἔσθησις	clothing, raiment
ἐσθίω	to eat
ἔσθος	
ἔσθω	to eat
Ἐσλεί	
ἔσληκεν	
ἐσμ	
ἔσοπτρον	
ἔσοπτρος	
ἑσπέρα	evening, eventide, eve
Ἑσρώμ	
Ἑσρών	
ἐσφαγμενην	
ἐσχατάω	to be at the edge, on the border
ἔσχατος	outermost
ἔσω	to the interior
ἔσωθεν	from within
ἐσώτερος	interior
ἔτ	
ἐτάζω	to examine, test
ἔται	
ἑταῖρος	a comrade, companion, mate
ΕΤΕΙ	
ἐτεκνοτρόφησεν	
ἑτερόγλωσσος	of other tongue
ἑτεροδιδασκαλέω	to teach differently, to teach errors
ἑτεροζυγέω	to be yoked in unequal partnership
ἕτερος	one of the
ἑτέρως	in one or the other way
ἔτης	clansmen
ἔτι	yet, as yet, still
ἐτἵθεσαν	
ἑτοιμάζω	to make or get ready, prepare, provide
ἑτοιμασία	
ἑτοῖμος	at hand, ready, prepared
ἑτοίμᾠ	
ἔτος	a year
Εῦ	
εὖ	well
Εὕα	
εὐαγγελίζομαι	to bring good news, announce them
εὐαγγέλιον	the reward of good tidings
εὐαγγελίσαι	
εὐαγγελιστής	the bringer of good tidings, an evangelist, preacher of the gospel
Εὕαν	
εὐαρεστεῖται	
εὐαρεστηκέναι	
εὐαρεστῆσαι	
εὐάρεστος	well-pleasing, acceptable
Εὔβουλος	
εὖγε	well, rightly
εὐγενής	well-born, of noble race, of high descent
εὐδία	fair weather
εὐδοκέω	to be well pleased
εὐδοκία	satisfaction, approval
εὐεργεσία	well-doing
εὐεργετέω	to do well, do good
εὐεργέτης	a well-doer, benefactor
εὐηγγελισάμεθα	
εὐηγγελισάμην	
εὐηγγελίσατο	
εὐηγγέλισεν	
εὐηγγελίσθη	
εὐθεῖα	
εὔθετος	well-arranged or easily stowed
εὐθέως	
εὐθής	
εὐθυδρομήσαμεν	
εὐθυδρομήσαντες	
εὐθυμέω	to be of good cheer
εὔθυμος	bountiful, generous
εὐθύνω	to guide straight, direct
εὐθύς	
εὐθύτης	
εὐκαιρέω	to devote one's leisure
εὐκαιρία	good season, opportunity
εὔκαιρος	well-timed, in season, seasonable
εὔκοπος	with easy labour, easy
εὐλάβεια	discretion, caution, circumspection
εὐλαβέομαι	to behave like the
εὐλαβής	taking hold well, holding fast: —
εὐλογέω	to speak well of, praise, honour
εὐλόγηκεν	
Εὐλογημένη	
εὐλογημένοι	
Εὐλογημένος	
εὐλογημένος	
εὐλογητός	blessed
εὐλογία	good or fine language
εὐμετάδοτος	readily imparting, generous
Εὐνίκη	
εὐνοέω	to be well-inclined
εὔνοια	good-will, favour, kindness
εὐνούχισαν	
εὐνουχίσθησαν	
εὐνοῦχος	a eunuch
εὐοδία	a good journey, wishes for a good journey
εὐοδόω	to help on the way
εὐπάρεδρος	constantly attending
εὐπειθής	ready to obey, obedient
εὐπερίστατος	easily besetting
εὐποιία	beneficence
εὐπορέω	to prosper, thrive, be well off
εὐπορία	an easy way
εὐπρέπεια	goodly appearance, dignity, comeliness
εὐπρόσδεκτος	acceptable.
εὐπροσωπέω	to make a fair show
εὐρακύλων	
εὑρεθῆ	
εὐρήσετε	
εὕρησις	
εὑρίσκω	to find
εὐροκλύδων	a storm from the East;
εὐρύχωρος	roomy, wide
εὐσέβεια	reverence towards the gods, piety, religion
εὐσεβέω	to live or act piously and religiously
εὐσεβής	righteous
εὔσημος	of good signs or omens
εὔσπλαγχνος	with healthy bowels
εὔσχημος	with decency
εὐσχημοσύνη	gracefulness, decorum
εὐσχήμων	elegant in figure, mien and bearing, graceful
ἑΥτοῖς	
εὔτονος	well-strung, vigorous
εὐτραπελία	wit, liveliness
Εὔτυχος	
εὐφημία	the use of words of good omen
εὔφημος	uttering sounds of good omen
εὐφόρησεν	
εὐφραίνω	to cheer, delight, gladden
Εὐφράτης	
εὐφροσύνη	mirth, merriment
εὐφρόσυνος	in good cheer
εὐχαριστέω	to be thankful, return thanks
εὐχαριστία	thankfulness, gratitude
εὐχάριστος	winning
εὐχή	a prayer, vow
εὔχομαι	to pray, offer prayers, pay one's vows, make a vow
εὔχρηστος	easy to make use of, useful, serviceable
εὐψυχέω	to be of good courage
εὐωδία	a sweet smell
εὐώνυμος	of good name, honoured
ἐφ̓	
ἐφάλλομαι	to spring upon, assail
ἐφάπαξ	once for all
ἐφέζομαι	to sit upon
Ἐφέσια	the feast of Ephesian Artemis
Ἐφέσιος	
ΕΦΕΣΙΟΥΣ	
ἔφεσις	a throwing or hurling at, a shooting
Ἔφεσος	
ἐφευρετής	an inventor, contriver
ἐφήδομαι	to exult over
ἐφήκω	to have arrived
ἐφημερία	for the daily service of the temple
ἐφημέριος	on, for or during the day, the day through
ἐφήμερον	
ἐφήμερος	living but a day, short-lived
ἐφίζω	to set upon
ἐφίημι	to send to
ἐφικνέομαι	to reach at, aim at
ἐφίστημι	to set or place upon
ἐφνίδιος	
ἐφοβή	
ἐφορέ	
ἐφορεύω	to be ephor
Ἐφραίμ	
Ἐφφαθά	
ἐχέτης	a man of substance
Ἔχετος	
ἔχης	
ἐχθές	yesterday
ἐχθέω	
ἔχθρα	
ἔχθρη	hatred, enmity
ἐχθρός	hated, hateful
ἔχιδνα	an adder, viper
ἔχις	an adder, viper
ἐχούξηξ	
ἔχω	to have or to hold
ἑώρακαν	
ἐώρακεν	
ἑωρακεν	
ἕως	until, till
ἔως	
Ζαβουλών	
Ζακχαῖε	
Ζακχαῖος	
Ζαρά	
Ζαχαρία	
Ζαχαρίαν	
Ζαχαρίας	
Ζαχαρίου	
ζάω	to live
Ζεβεδαῖον	
Ζεβεδαίου	
ζει	
ζεστός	
ζετο	
ζεῦγος	a yoke of beasts, a pair of mules, oxen or horses
ζευκτήριος	fit for joining or yoking
Ζεύς	Zeus
ζέω	to boil, seethe
ζήλευε	
ζῆλος	eager rivalry, zealous imitation, emulation
ζηλόω	to rival, vie with, emulate
ζηλωτής	an emulator, zealous admirer or follower
ζηλωτός	to be emulated, worthy of imitation
ζημία	loss, damage
ζημιόω	to cause loss or do damage to
ζῇν	
ζῆνος	
ζῆσις	
ζητέω	to seek, seek for
ζήτημα	that which is sought
ζήτησις	a seeking, seeking for, search for
ζιζάνιον	
Ζοροβάβελ	
ζόφος	the gloom of the world below, nether darkness
ζοφόω	to darken
ζυγόν	anything which joins two
ζυγός	
ζύμη	leaven
ζυμόω	to leaven
ζωγρέω	to take alive, take captive
ζωή	a living
ζωθήσεται	
ζώιον	
ζώνη	a belt, girdle
ζώννυμι	to gird
ζωογονεῖσθαι	
ζωογόνησις	
ζωογονοῦντος	
ζῷον	a living being, animal
ζωοποιέω	
ζωοποίησις	
ζωός	alive, living
ζῶσις	
ή	
ᾗ	which way, where, whither, in or at what place
ἤ	
Η	
η	
ἠγά	
ΗΓΓΙΖΕΝ	
ἤγγιζεν	
ἤγγικεν	
Ἤγγικεν	
ἤγγισαν	
ἤγγισεν	
ἡγεμονεύω	to be or act as
ἡγεμονία	a leading the way, going first
ἡγεμών	one who leads
ἡγέομαι	to go before, lead the way
ἠγευθέρωσεν	
ἡγίασεν	
ἡγιάσθη	
ἡγιάσθητε	
ἡγιασμένη	
ἡγιασμένοι	
ἡγιασμένοις	
ἡγιασμένον	
ἡγίασται	
Ἡδέ	
ἤδειτε	
ἡδέως	
ἤδη	by this time, before this, already
ἥδομαι	to enjoy oneself, take delight, take one's pleasure
ἡδονά	
ἡδονή	delight, enjoyment, pleasure
ἦδος	delight, enjoyment, pleasure
ἠδυνάσθη	
ἠδυνατο	
ἡδύοσμον	
ἡδύοσμος	
ἡδύς	sweet
ἠθέω	to sift, strain
ἦθος	an accustomed place
Ἤιδει	
ᾐκολούθει	
ἠκυρώ	
ἥκω	to have come, be present, be here
ἠλαττόνησεν	
Ἡλεί	
Ἠλεῖος	
ἤλθαμεν	
ἦλθαν	
ἤλθατε	
ἤλθεν	
ῆλθεν	
ἠλθον	
ἡλικία	time of life, age
ἡλίκος	as big as
ἥλιος	the sun
ἧλος	a nail
ἡμας	
ἤμεθα	
ἡμέρα	day
ᾑμέρᾳ	
ΗΜΕΡΑΙΣ	
ήμερας	
ἥμερος	tame, tamed, reclaimed
ἡμερόω	to tame, make tame
ἡμέτερος	our
ἠμί	I say
ἡμιθανής	half-dead
ἡμ́ῖν	
ἡμίσια	
ἥμισυς	half
ἡμίωρον	
ἡμός	
ΗΝ	
ῆν	
ἠνεῳγμένη	
ἠνεῳγμένην	
ἠνεῳγμένον	
ἡνίκα	at which time, when
ἤπειρος	terra-firma, the land
ἠπειρωτικός	continental
ἤπιος	gentle, mild, kind
Ἤρ	
ἤρεμος	
ἤρεν	
ἦρος	
Ἡρῴδῃ	
Ἡρῴδην	
Ἡρῴδης	
Ἡρῳδιάδα	
Ἡρῳδιάδος	
Ἡρῳδιανῶν	
Ἡρῳδιάς	
Ἡρῳδίωνα	
Ἡρῴδου	
Ἠσαίᾳ	
Ἠσαίαν	
Ἠσαίας	
Ἠσαίου	
η̂Σαν	
Ἠσαῦ	
ήσῃ	
ἡσσάομαι	to be less than another, inferior to
ἥσσων	less, weaker, less brave
ἡσυχάζω	to be still, keep quiet, be at rest
ἡσυχία	stillness, rest, quiet
ἡσύχιος	still, quiet, at rest, at ease
ἦτε	surely, doubtless
ἤτοι	now surely, truly, verily
ἥττημα	
ἠχέω	to sound, ring, peal
ἠχή	a sound or noise
ἦχος	
ἠχρεώθησαν	
ἠχώ	a sound
ἤὯδε	
ἠώς	the morning red, daybreak, dawn
Θαδδαῖον	
Θαδδαῖος	
θάλασσα	the sea
θάλπος	warmth, heat
θάλπω	to heat, soften by heat
Θάμαρ	
θαμβέω	to be astounded, amazed
θάμβος	astonishment, amazement
θανάσιμος	deadly
θανατάω	to desire to die
θανατήφορος	
θανατηφόρος	death-bringing, mortal
θάνατος	death
Θάνατος	
θανατόω	to put to death
θανΤου	
θάομαι	to wonder at, admire
θάπτω	to pay the last dues to a corpse, to honour with funeral rites
Θαρά	
θαρσέω	to be of good courage, take courage
θάρσος	courage, boldness
θαῦμα	whatever one regards with wonder, a wonder, marvel
θαυμάζω	to wonder, marvel, be astonied
θαυμάσιος	wondrous, wonderful, marvellous
θαυμαστής	an admirer
θαυμαστός	wondrous, wonderful, marvellous
θεά	a goddess
θεάομαι	to look on, gaze at, view, behold
θεατρίζω	to bring on the stage:—
θέατρον	a place for seeing
θεία	
θείνω	to strike, wound
θεῖος	
θειότης	divine nature, divinity
θειόω	to smoke with brimstone, fumigate and purify thereby
θειώδης	
θέλημα	will
θέλησις	a willing, will
θεμέλιος	of or for the foundation
θεμελιόω	to lay the foundation of, found firmly
θεοδίδακτος	taught of God
θεομάχος	fighting against God
θεον	
θεόπνευστος	inspired of God
θεός	God
θεοσέβεια	the service or fear of God, religiousness
θεοσεβής	fearing God, religious
θεοστυγής	hated of the gods
θεότης	divinity, divine nature
Θεόφιλος	
θεραπεία	a waiting on, service
θεραπείη	
θεράπευσις	
θεραπεύω	to be an attendant, do service
θεράπων	a waiting-man, attendant
θέραψ	
θερίζω	to do summer-work, to mow, reap
θερισμός	reaping-time, harvest
θεριστής	a reaper, harvester
θεριστός	
θέρμα	
θερμαίνω	to warm, heat
θέρμη	heat, feverish heat
θέρος	summer, summertime
ΘΕΣΣΑΛΟΝΙΚΕΙΣ	
Θεσσαλονικέως	
Θεσσαλονίκη	
Θευδᾶς	
ΘΕΩ	
θέω	to run
θεωρέω	to look at, view, behold
θεώρησις	
θεωρία	a looking at, viewing, beholding
θεωρός	a spectator
θη	
θήκη	a case to put anything in, a box, chest
θηλάζω	to suckle
θῆλυς	female
θήρα	a hunting of wild beasts, the chase
θηράω	to hunt or chase
θηρεύω	to hunt, go hunting
θηρίον	a wild animal, beast
θηριόω	to make into a wild beast.
θησαν	
θησαυρίζω	to store or treasure up
θησαυρός	
θιγγάνω	to touch, handle
θλίβω	to press, squeeze, pinch
θλίψιν	
θλῖψις	
θνήσκω	to die, be dying
θνητός	liable to death, mortal
θορυβάζομαι	to be troubled
θορυβέω	to make a noise or uproar
θόρυβος	a noise, uproar, clamour
θραύω	to break in pieces, shatter, shiver
θρέμμα	a nursling, creature
θρηνέω	to sing a dirge, to wail
θρησκεία	religious worship or usage
θρησκός	
θριαμβεύω	to triumph
θρίξ	the hair of the head
θροέω	to cry aloud
θρόμβος	a lump, piece
θρόνον	flowers embroidered on cloth, patterns
θρόνος	a seat, chair
θρύπτω	to break in pieces, break small
θρωπε	
θρωπον	
θρώπου	
Θυάτειρα	
Θυατείροις	
Θυατείρων	
θυγάτηρ	a daughter
θυγάτριον	
θύελλα	a furious storm, hurricane
θύινος	of the tree
θυμίαμα	that which is burnt as incense
θυμιατήριον	a vessel for burning incense, a censer
θυμιάω	to burn so as to produce smoke, burn
θυμομαχέω	to fight desperately
θυμός	the soul
θυμόω	to make angry
θύρ	
θύρα	a door
θύραντοῦ	
θυρεός	a stone put against a door
θυρίς	a window
θυρόω	to furnish with doors, shut close
θυρωρός	a door-keeper, porter
θυσία	an offering or mode of offering
θυσιάζω	to sacrifice
θυσιαστη	
θυσιαστήριον	an altar
θυσιαστήριος	
θύσις	
θῦσις	
θύω	
θῴρακας	
θώραξ	a breastplate, cuirass, corslet
θῶς	
Ἰάειρος	
Ἰακός	
Ἰάκω	
Ἰακώβ	
Ἰάκωβον	
ΙΑΚΩΒΟΣ	
Ἰάκωβος	
ΙΑΚΩΒΟΥ	
Ἰακώβου	
Ἰακώβῳ	
ἴαμα	a means of healing, remedy, medicine
Ἰαμβρῆς	
Ἰανναί	
Ἰαννῆς	
ἰάομαι	to heal, cure
Ἰάρετ	
ἴασις	healing, a mode of healing, cure, remedy
Ἴασος	
ἴασπις	jasper
Ἰάσων	
ἴαται	
ἰατρός	one who heals, a mediciner, physician or surgeon
ἱβριστήν	
ἰδέ	and
ἴδη	a timber-tree
ἰδιόομαι	to appropriate to oneself
ἴδιος	one's own, pertaining to oneself
ἰδίω	to sweat
ἰδιώτης	a private person, an individual
ἶδος	violent heat
ἰδού	lo! behold! see there!
Ἰδουμαίας	
ἱδρώς	sweat
Ἰεζάβελ	
ἱερά	
ἱεραί	
ἱεράομαι	to be a priest or priestess
ἱεράτευμα	a priesthood
ἱερατεύω	to be a priest
ἱερατίαν	
ἱερατίας	
ἱέρεια	a priestess
Ἰερειχώ	
Ἰερεμίαν	
Ἰερεμίου	
ἱερεύς	a priest, sacrificer
ἱερή	
Ἱερή	
ἱερόθυτος	offered to a god
ἱερόν	
ἱεροπρεπής	beseeming a sacred place, person or matter, holy, reverend
ἱερός	super-human, mighty, divine, wonderful
Ἰεροσόλυμα	
Ἰεροσολυμεῖται	
Ἰεροσολυμειτῶν	
Ἰεροσολύμοις	
Ἰεροσολύμων	
ἱεροσυλέω	to rob a temple, commit sacrilege
ἱερόσυλος	a temple-robber, sacrilegious person
ἱερουργέω	to perform sacred rites
Ἰερουσαλήμ	
ἱερόω	to hallow, consecrate, dedicate
ἱερωσύνη	the office of priest, priesthood
ἱερώσυνος	
Ἰεσσαί	
Ἰεφθάε	
Ἰεχονίαν	
Ἰεχονίας	
Ἰη	
ἵημι	to set a going, put in motion
ΙΗΣΟΥ	
Ἰησοῦς	Joshua or Jehoshua, Saviour
ΙΗΣΟΥΣ	
Ἰησούς	
ἱκανός	becoming, befitting, sufficing
ἱκανότης	sufficiency, fitness
ἱκανόω	to make sufficient, qualify
ἱκετήριος	of or fit for suppliants
ἰκμάς	moisture, juice
Ἰκόνιον	
Ἰκονίου	
Ἰκονίῳ	
ἴλαος	propitious, gracious
ἱλαρός	cheerful, gay, merry, joyous
ἱλαρότης	cheerfulness
ἱλάσκομαι	to appease
ἱλασμός	a means of appeasing
ἱλαστήριος	propitiatory
Ἰλλυρικός	
ἱμᾶς	
ἱμάς	a leathern strap or thong
ἱματίζω	to clothe.
ἱμάτιον	an outer garment, a cloak or mantle
ἱματισμός	clothing, apparel
ἱμῶν	
ἵνα	in that place, there
ἱνα	
ἴνη	
Ἰξαάκ	
Ἰόππῃ	
Ἰόππην	
Ἰόππης	
Ἰορδάνῃ	
Ἰορδάνην	
Ἰορδάνου	
ἰός	
ἰού	ho!
Ἰούδα	
ΙΟΥΔΑ	
Ἰούδᾳ	
Ἰουδαίζω	to side with or imitate the Jews
Ἰουδαικός	Jewish.
Ἰουδαῖος	a Jew
Ἰουδαϊσμῷ	
ΙΟΥΔΑΙΩΝ	
Ἰούδαν	
ΙΟΥΔΑΣ	
Ἰούδας	
ΙΟΥΔΛΙΩΝ	
Ἰουλίαν	
Ἰούλιος	
Ἰουνίαν	
Ἰοῦστος	
Ἰούστου	
ἱππεύς	a horseman
ἱππικός	of a horse or horses
ἵππος	a horse, mare
Ἶρις	Iris
ἶρις	
Ἰσαάκ	
ἰσάγγελος	like an angel
Ἰσκαριώθ	
Ἰσκαριώτην	
Ἰσκαριώτης	
Ἰσκαριώτου	
ἴσος	equal to, the same as
ἰσότης	equality
ἰσότιμος	held in equal honour, having the same privileges
ἰσόψυχος	of equal spirit
ἰσόω	to make equal
Ἰσραήλ	
Ἰσραηλεῖται	
Ἰσραηλείτης	
Ἰσσαχάρ	
ἱστάνω	
ἱστήκει	
ἱστήκεισαν	
ἵστημι	to make to stand
ἱστορέω	to inquire into
ἰσχυρός	strong, mighty
ἰσχύς	strength
ἰσχύω	to be strong
ἴσως	equally, in like manner
Ἰταλία	
Ἰταλικός	
Ιτμηθῆτε	
Ἰτουραίας	
ἰχθύα	
ἰχθυάω	to fish, angle
ἰχθύδιον	a little fish
ἰχθύς	a fish
ἴχνος	a track, footstep
Ἰω	
Ἰωαθάμ	
Ἰωάνα	
Ἰωανάν	
Ἰωάνει	
Ἰωάνῃ	
ΙΩΑΝΗΝ	
Ἰωάνην	
Ἰωάνης	
Ἰώανης	
ΙΩΑΝΗΣ	
Ἰωάννην	
Ἰωάννης	
ΙΩΑΝΟΥ	
Ἰωάνου	
Ἰώβ	
Ἰωβήδ	
Ἰωβήλ	
Ἰωδά	
Ἰωήλ	
Ἰωνᾶ	
Ἰωνάμ	
Ἰωνᾶς	
Ἰωράμ	
Ἰωρείμ	
Ἰωσαφάτ	
Ἰωσείαν	
Ἰωσείας	
Ἰωσῆτος	
Ἰωσήφ	
Ἰωσήχ	
ἰῶτα	adscriptum
καθά	according as, just as
καθαίρεσις	a pulling down, rasing to the ground
καθαιρέω	to take down
καθαίρω	to make pure or clean, cleanse, clean, purge
καθάπτω	to fasten, fix or put upon
καθαρίζω	to make clean, to cleanse
καθάρισις	
καθαρισμός	
καθαρός	clear of dirt, clean, spotless, unsoiled
καθαρότης	cleanness, purity
καθέδρα	a seat
καθεξῆς	
καθεύδω	to lie down to sleep, sleep
καθέψω	to boil down
καθηγητής	
καθήκω	to have come or gone down
κάθημαι	to be seated
καθημερινός	
καθημέριος	day by day, daily
καθίζω	to make to sit down, seat
καθίημι	to send down, let fall
κάθισις	
καθιστάνω	
καθίστημι	to set down, place
καθό	in so far as, according as
καθόλου	on the whole, in general
καθοπλίζω	to equip or arm fully
καθοράω	to look down
καθότι	in what manner
κάθου	
Κάθου	
καθώς	how
καθώσπερ	
και	
καί	and
ΚΑΙ	
Καιάφα	
Καιάφαν	
Καιάφας	
Καίν	
Καινάμ	
καινός	new, fresh
καινότης	newness, freshness
καινόω	to make new, innovate
καίπερ	although, albeit
καιρός	due measure, proportion, fitness
Καιρός	
Καισάρης	
Καίσαρι	
Καισαρίᾳ	
Καισαρίαν	
Καισαρίας	
Καίσαρος	
καίτοι	and indeed, and further
καίω	to light, kindle
κάκη	wickedness, vice
κακία	badness
κακοηθία	
κακολογέω	to speak ill of, to revile, abuse
κακοπάΗσον	
κακοπάθεια	ill plight, distress
κακοπαθέω	
κακοπαθής	suffering ill, in ill plight;
κακοπαθία	
κακοποιέω	to do ill, play the knave
κακοποιός	ill-doing, mischievous
κακός	bad
κάκουργος	
κακοῦργος	doing ill, mischievous, knavish, villanous
κακουχούμενοι	
κακουχουμένων	
κακόω	to treat ill, maltreat, afflict, distress
κάκωσις	ill-treatment
καλάμη	the stalk or straw of corn
κάλαμος	a reed
καλέω	to call, summon
κάλη	
καλλιέλαιος	
κάλλιον	
καλοδιδάσκαλος	a teacher of virtue
καλοποιέω	to do good
καλός	beautiful, beauteous, fair
κάλυμμα	a head-covering
καλύπτω	to cover with
κάλυψις	
κάμηλος	a camel
κάμινος	an oven, furnace, kiln
κάμνω	to work
κάμπτω	to bend, curve
κάμψη	
κάμψις	
κἀν	and if, even if, although
Κανά	
Καναναῖον	
Καναναῖος	
Κανδάκης	
κανών	any straight rod or bar
καπηλεύω	to be a retail-dealer
καπνόομαι	to be turned into smoke, burnt to ashes
καπνός	smoke
Καππαδοκία	
Καππαδοκίη	
καρδί	
καρδία	the heart
καρδιογνώστης	knower of hearts
καρπός	
καρποφορέω	to bear fruit
καρποφόρος	fruit-bearing, fruitful
καρπόφορος	
καρπόω	to bear fruit or bear as fruit
Κάρπῳ	
καρτερέω	to be steadfast, patient, staunch
κάρφος	a dry stalk
ΚΑΤΑ	
κατά	down, downwards, with gen. or acc.
κατα	
κατά-ἀντάω	
καταβαίνω	to step down, go or come down
καταβάλλω	to throw down, overthrow
καταβαρέω	to weigh down, overload
κατά-βαρύνω	
κατάβασις	a going down, way down, descent
καταβάτης	
καταβολεύς	
καταβολή	a throwing or laying down
καταβραβεύω	to give judgment against
καταγγελεύς	
καταγγέλλω	to denounce, betray
καταγελάω	to laugh at, jeer or mock at
καταγιγνώσκω	to remark, discover
κατάγνυμι	to break in pieces, shatter, shiver, crack
καταγράφω	to scratch away, lacerate
κατάγω	to lead down
καταγωνίζομαι	to struggle against, prevail against, conquer
καταδέομαι	
καταδέω	
κατάδηλος	quite manifest, plain, visible
καταδικάζω	to give judgment against
καταδίκη	judgment given against one: the damages awarded
καταδιώκω	to pursue closely
καταδουλόω	to reduce to slavery, enslave
καταδυναστεύω	to exercise power over
κατά-ἕζομαι	
κατά-εὐλογέω	
κατάθεμα	
καταθεματίζω	to curse
καταιβάτης	as descending in thunder and lightning
καταίρω	to come down, make a swoop
καταισχύνω	to disgrace, dishonour, put to shame
κατά-καθέζομαι	
κατά-καθεύδω	
κατά-κάθημαι	
κατακαίω	to burn down, burn completely
κατακαλύπτω	to cover up
κατάκαυσις	
κατακαυχάομαι	to boast against
κατακείω	
κατακλάω	to break down, break short, snap off
κατακλείω	to shut in, inclose
κατακληρονομέω	to obtain by inheritance
κατακλίνω	to lay down
κατακλύζω	to dash over, flood, deluge, inundate
κατακλυσμός	a deluge, inundation
κατακολουθέω	to follow after, obey
κατακόπτω	to cut down, cut in pieces, cut up
κατακρημνίζω	to throw down a precipice
κατάκριμα	condemnation, judgment
κατακρίνω	to give as sentence against
κατάκρισις	
κατακύπτω	to bend down, stoop
κατακυριεύω	to gain dominion over
καταλαλέω	to talk loudly, to blab
καταλαλιά	evil report, slander
κατάλαλος	a slanderer
καταλαμβάνω	to seize upon, lay hold of
καταλέγω	to lay down
καταλείβω	to pour down;
καταλείπω	to leave behind
κατάλειψις	a leaving behind
καταλήγω	to leave off, end, stop
καταλιθάζω	
κατά-λίπτομαι	
καταλλαγή	exchange
καταλλάσσω	to change
κατάλοιπος	
κατάλυμα	an inn, lodging
κατάλυσις	a dissolving, dissolution
καταλύω	to put down, destroy
καταμανθάνω	to observe well, examine closely
καταμαρτυρέω	to bear witness against
καταμένω	to stay behind, stay
καταναλίσκω	to use up, spend, lavish
καταναρκάω	to be slothful towards, press heavily upon
κατανεύω	to nod assent
κατανοέω	to observe well, to understand
κατάνυξις	stupefaction, slumber
κατανύσσομαι	to be sorely pricked
καταξιόω	to deem worthy
καταπατέω	to trample down, trample under foot
κατάπαυσις	a putting to rest: a putting down, deposing
καταπαύω	to lay to rest, put an end to
καταπέτασμα	a curtain, veil
καταπίνω	to gulp or swallow down
καταπίπτω	to fall or drop down
καταπλέω	to sail down
καταπονέω	to subdue after a hard struggle
καταποντίζω	to throw into the sea, drown therein
κατάρα	a curse
καταράομαι	to call down curses upon, imprecate upon
καταργέω	to leave unemployed or idle
κατάργησις	
κατάρης	
καταριθμέω	to count or reckon among
καταρόω	to plough up
καταρτίζω	to adjust or put in order again, restore
κατάρτισις	restoration
καταρτισμός	
κατασείω	to shake down, throw down
κατασκάπτω	to dig down, destroy utterly, rase to the ground, overthrow
κατασκευάζω	to equip or furnish fully
κατασκηνοῖν	
κατασκηνόω	to pitch one's camp or tent, take up one's quarters, encamp
κατασκήνωσις	an encamping
κατασκιάζω	to overshadow, cover over
κατασκοπέω	to view closely, spy out
κατάσκοπος	one who keeps a look out, a scout, spy
κατασοφίζομαι	to conquer by sophisms or fallacies, to outwit
καταστέλλω	to put in order, arrange
κατάστημα	a condition or state
καταστολή	
καταστρέφω	to turn down, trample on
καταστρηνιάω	to behave wantonly towards
καταστροφεύς	
καταστροφή	an overturning
κατασύρω	to pull down, lay waste, ravage
κατασφάζω	to slaughter, murder
κατά-σφραγίζω	
κατάσχεσις	
καταταβαίνοντα	
κατατίθημι	to place, put
κατατομή	abscission, concision
κατατρέχω	to run down
καταφαγεῖν	to devour, eat up
καταφέρω	to bring down
καταφεύγω	to flee for refuge
καταφθείρω	to destroy or spoil utterly, bring to naught
καταφιλέω	to kiss tenderly, to caress
καταφρονέω	to think down upon
καταφρόνησις	contempt, disdain
καταφρονητής	a despiser
καταχεύω	
καταχθόνιος	subterranean
καταχράομαι	to make full use of, apply
κατά-χράω	
καταχώννυμι	to cover with a heap
κατάψυξις	
καταψύχω	to cool, chill
κατεάξει	
κατείδωλος	full of idols, given to idolatry
κατελήμφθην	
ΚΑΤΕΛΘΟΝΤΕΣ	
κατέναντι	
κατενώπιον	
κατεξουσιάζω	to exercise lordship over
κατέΠιστευω	
κατεργάζομαι	to effect by labour, to achieve, accomplish
κατέρχομαι	to go down from
κατεσθίω	to eat up, devour
κατέσθω	
κατευθύνω	to make or keep straight, to set right, guide aright
κατεφίσταμαι	to rise up against
κατέχω	to hold fast
κατηγγέλη	
κατ́ηγορεῖν	
κατηγορέω	to speak against, to accuse
κατηγορία	an accusation, charge
κατήγορος	an accuser
κατηγορού	
κατήγωρ	
κατήλθαμεν	
κατήφεια	dejection, sorrow, shame
κατηχέω	to sound
κατισχύω	to have power over, overpower, prevail against
κατίωται	
κατοικέω	to dwell in as a κάτοικος, to settle in, colonise
κατοίκησις	a settling in
κατοικητήριον	a dwelling-place, abode
κατοικητήριος	
κατοικία	a settlement, colony: the foundation of a colony
κατοικίζω	to remove to
κατοικουΝτες	
κατοπτρίζω	to shew as in a mirror
κάτος	
κάτω	down, downwards
κατώτερος	
Καῦδα	
καῦμα	burning heat
καυματίζω	to burn or scorch up
καῦσις	a burning
καυσόομαι	to burn with intense heat
καῦσος	burning heat.
καυστηριάζω	
καύσων	burning heat
καυχάομαι	to speak loud, be loud-tongued
καύχημα	a boast, vaunt
καύχησις	reason to boast
Καφαρναούμ	
καφίσατε	
κέδρον	
κέδρος	the cedar-tree
κεῖμαι	to be laid
κειρία	the cord or girth of a bedstead
κείρω	to cut
Κείς	
κεκοπίακες	
κέλευθος	a road, way, path, track
κελεύω	to urge or drive on, urge, exhort, bid, command, order
κέλλω	to drive on
κέλομαι	to urge on, exhort, command
κενοδοξία	
κενόδοξος	
κενός	empty
κενοφωνία	vain talking, babbling
κενοφωνιας	
κενόω	to empty out, drain
κέντρον	any sharp point
κεντυρίων	
Κενχρεαῖς	
κένωσις	an emptying
Κεραμεῖς	
κεράμεος	
κεραμεύς	a potter
κεραμικός	of or for pottery
κεράμιον	an earthenware vessel, a jar
κεράμιος	
κέραμος	potter's earth, potter's clay
κεράννυμι	to mix, mingle
κέρας	the horn of an animal
κεράτια	St. John's bread
κεράτιον	
κερδαίνω	to gain, derive profit or advantage
κέρδος	gain, profit, advantage
κερέαν	
κερεύς	
κέρμα	a slice
κερματιστής	a money-changer
κεφάλαιος	of the head
κεφαλαιόω	to bring under heads, sum up, state summarily
κεφαλή	the head
κεφαλίς	part of a shoe
κήλη	a tumor
κῆνσος	the tax
κῆπος	a garden, orchard, plantation
κηπουρός	keeper of a garden, a gardener.
κήρυγμα	that which is cried by a herald, a proclamation, public notice
κῆρυξ	a herald, pursuivant, marshal, public messenger
κηρὐξαι	
κηρύσσω	to be a herald, officiate as herald
κῆτος	any sea-monster or huge fish
Κηφᾷ	
Κηφᾶ	
Κηφᾶν	
Κηφεύς	
κιβωτός	a wooden box, chest, coffer
κιθάρα	guitar)
κιθαρίζω	to play the cithara
κιθαρῳδέω	to sing to the cithara
κιθαρῳδός	one who plays and sings to the cithara, a harper
Κιλίκιος	
Κίλιξ	a Cilician
κινδυνεύω	to be daring, to make a venture, take the risk, do a daring thing
κίνδυνος	a danger, risk, hazard, venture, enterprise
κινέω	to set in motion, to move
κιννάμωμον	cinnamon
κλάδος	a young slip or shoot broken off
κλαίω	to weep, lament, wail
κλάσις	a breaking
κλάσμα	that which is broken off, a fragment, morsel
Κλαυδία	
Κλαύδιος	
κλαυθμός	a weeping
κλαῦσις	
κλάω	to break, break off
κλείς	that which serves for closing
κλεῖσις	
κλείω	
κλέμμα	a theft
Κλεόπας	
κλέος	a rumour, report, news
κλεπτης	
κλέπτης	a thief
κλέπτω	to steal, filch, purloin
κλέω	to tell of, celebrate
κλῄζω	
κλῆμα	a vine-twig, vine-branch
Κλήμεντος	
κληρονομέω	to receive a share of an inheritance, to inherit a portion
κληρονομία	an inheritance
κληρόνομος	
κληρονόμος	one who receives a portion
κλῆρος	a lot;
κληρόω	to appoint
κλῆσις	a calling, call
κλητός	called, invited, welcome
κλίμα	an inclination, slope
κλινάριον	
κλίνη	that on which one lies, a couch or bed
κλινίδιον	
κλίνω	to make to bend, slope
κλισία	a place for lying down
κλοπή	theft
κλύδων	a wave, billow
κλυδωνίζομαι	to be tossed like waves
Κλωπᾶ	
κναφεύς	a fuller
κνήθω	to scratch, tickle
Κνίδος	
κοδράντης	
κοιλία	the large cavity of the body, the belly
κοιμάω	to lull or hush to sleep, put to sleep
κοίμησις	a lying down to sleep
κοινός	common, shared in common
κοινόω	to make common, communicate, impart
κοινωνει	
κοινωνέω	to have or do in common with, have a share of or take part in
κοινωνία	communion, association, partnership, fellowship
κοινωνικός	held in common, social
κοινωνός	a companion, partner
κοίτη	the marriage-bed
κοιτών	a bed-chamber
κόκκινος	scarlet
κόκκος	a grain, seed
κόκκων	a pomegranate-seed
κολάζω	to curtail, dock, prune
κολακίας	
κόλασις	chastisement, correction, punishment
ΚΟΛΑΣΣΑΕΙΣ	
κολαφίζω	to buffet
κολλάω	to glue, cement
κολλούριον	
κολλυβιστής	a small money-changer
κολοβόω	to dock, curtail, shorten
Κολοσσαῖς	
κόλπος	the bosom
κολυμβάω	to plunge into the sea
κολυμβήθρα	a swimming-bath
κολωνία	
κομάω	to let the hair grow long, wear long hair
κομέω	to take care of, attend to, tend
κόμη	the hair, hair of the head
κομίζω	to take care of, provide for
κομψός	well-dressed
κονιάω	to plaster or whiten over
κονιορτός	dust stirred up, a cloud of dust
κοπάζω	to grow weary
κοπετός	
κοπεύς	a chisel
κοπή	a cutting in pieces, slaughter
κοπιάτης	
κοπιάω	to be tired, grow weary
κόπος	a striking, beating
κοπρία	a dunghill
κοπρίας	
κόπριον	
κόπτω	to strike, smite, knock down
κόραξ	carrion-crow
κοράσιον	a girl, maiden
κορβᾶν	a gift or votive offering for the service of God
Κορβάν	
Κορέ	
κορέννυμι	to sate, satiate, satisfy
Κορίνθιος	Corinthian
ΚΟΡΙΝΘΙΟΥΣ	
Κόρινθος	Corinth
Κορνήλιος	
κόρος	
κοσμέω	to order, arrange
κοσμικός	of the world or universe
κόσμιον	
κόσμιος	well-ordered, regular, moderate
κοσμοκράτωρ	lord of the world
κόσμος	order
Κούαρτος	
κούμ	
κουστωδία	
κουφίζω	to be light
κόφινος	a basket
κραβάττοις	
κράβαττον	
κραβάττου	
κραβάττων	
κρᾶζον	
κράζω	to croak
κραίνω	to accomplish, fulfil, bring to pass
κρανίον	the upper part of the head, the skull
Κράνιος	
κράς	the head
κράσπεδον	the edge, border, skirt or hem
κραταιά	
κραταιόομαι	
κραταιός	strong, mighty, resistless
κρατέω	to be strong, mighty, powerful
κράτησις	
κράτιστος	strongest, mightiest
κράτος	strength, might
κρατύς	strong, mighty
κραυγάζω	to bay
κραυγή	a crying, screaming, shrieking, shouting
κρέας	flesh, meat, a piece of meat
κρείσσων	stronger, mightier, more powerful
κρεμάννυμι	to hang, hang up
κρεπάλῃ	
κρημνός	an overhanging bank
Κρής	a Cretan
Κρήσκης	
Κρήτη	Crete
κρίβανος	an earthen vessel, a pan
κριθάω	to be barley-fed, to wax wanton
κριθή	barley-corns, barley
κρίθινος	made of or from barley
κρῖμα	a decision, judgment
κρίμα	
κρίμͅα	
κρίνον	a lily
κρίνω	to pick out, choose
κρίσις	a separating, power of distinguishing
Κρίσπον	
Κρίσπος	
κριτήριον	a means for judging or trying, a criterion, standard, test
κριτής	a decider, judge, umpire
κριτικός	able to discern, critical
κριτός	picked out, chosen
κρούω	to strike, smite: to strike
κρυπτή	
κρύπτης	
κρυπτός	hidden, secret
κρύπτω	to hide, cover, cloak
κρυσταλλίζω	to be clear as crystal
κρύσταλλος	clear ice, ice
κρυφαῖος	hidden
κρυφῇ	
κτάομαι	to procure for oneself, to get, gain, acquire
κτείνω	to kill, slay
κτέομαι	
κτῆμα	anything gotten, a piece of property, a possession
κτῆνος	flocks and herds
κτήτωρ	a possessor, owner
κτίζω	to people
κτίσις	a founding, foundation
κτίσμα	anything created, a creature
κτίστης	a founder
Κύ	
κυβερνάω	to act as pilot or helmsman
κυβέρνησις	steering, pilotage
κυβερνήτης	a steersman, helmsman, pilot
κυβίᾳ	
κυκλέω	to move round and round, wheel along
κυκλόθεν	from all around
κύκλος	a ring, circle, round
κυκλόω	to encircle, surround
κυλισμός	
κυλίω	to roll along
κυλλός	crooked, crippled
κῦμα	anything swoln
κυματόω	to cover with waves
κύμβαλον	a cymbal
κύμινον	cummin
κυνάριον	a little dog, whelp
κυνάω	to play the Cynic
κύπριον	
Κύπριος	of Cyprus, Cyprian
Κύπρος	Cyprus
κύπτω	to bend forward, stoop down
κυρέω	to hit, light upon
Κυρηναῖος	
Κυρήνη	Cyrene
Κυρηνίου	
κυρία	
κυριακός	of or for a lord or master
κυριεύω	to be lord or master of
ΚΥΡΙΟΣ	
κύριος	a lord, master
κυριότης	dominion
Κυριῳ	
ΚΥΡΙΩΝ	
κῦρος	supreme power, authority
κυρόω	to make valid, confirm, ratify, determine
κύω	to conceive
κύων	a dog or bitch
κῶλον	a limb
κωλύω	to let, hinder, check, prevent
κώμη	country town
κωμόπολις	a village-town
κῶμος	a village festival: a revel, carousal, merry-making
κώνωψ	a gnat, mosquito
Κῶς	Cos
Κωσάμ	
κωφός	blunt, dull, obtuse
λαγχάνω	to obtain by lot, by fate, by the will of the gods
Λάζαρε	
Λάζαρον	
Λάζαρος	
λάζομαι	to take, seize, grasp
λάθρῃ	secretly, covertly, by stealth, treacherously
λαῖλαψ	a tempest, furious storm, hurricane
λακτίζω	to kick with the heel or foot, kick at, spurn
λαλέω	to talk, chat, prattle, babble
λαλῆ	
λάλη	
λάλησις	
λαλιά	talking, talk, chat
λαλιή	
λαλιός	
Λαλούν	
λαμά	what? why?
λαμβάνω	to take
Λάμεχ	
λαμπάς	
λαμπρός	bright, brilliant, radiant
λαμπρότης	brilliancy, splendour
λάμπω	to give light, shine, beam, be bright, brilliant, radiant
λάμψις	
λανθάνω	to escape notice, to be unknown, unseen, unnoticed
λαξευτός	hewn out of the rock
Λαοδίκη	
Λαοδικίᾳ	
Λαοδικίαν	
Λαοδικίας	
λαός	the people
λάπτω	to lap with the tongue
λάρυγξ	the larynx or upper part of the windpipe
Λασέα	
λάσκω	to ring, rattle, crash
λατρεία	the state of a hired workman, service, servitude
λάτρευσις	
λατρεύω	to work for hire or pay, to be in servitude, serve
λάχανον	garden-herbs, potherbs, vegetables, greens
λάω	
λέ	
λεγεις	
λέγεντες	
Λεγιών	
λεγιῶνα	
λεγιῶνας	
λεγόμε	
λέγος	
λέγω	
λεία	booty, plunder
λεῖος	smooth, plain, not embroidered
λείπω	to leave, quit
λειτουργέω	to serve public offices at one's own cost
λειτουργία	a liturgy
λειτουργικός	ministering
λειτουργός	one who performed a λειτουργία
λελατομημένον	
λελουσμένοι	
λεμά	
λέντιον	
λεπίς	a scale, husk
λέπρα	leprosy
λεπρός	scaly, scabby, rough, leprous
λεπτόν	a very small coin, a mite
λεπτός	peeled, husked, threshed out
λέπω	to strip off the rind or husks, to peel, bark
Λευεί	
Λευείν	
Λευείς	
Λευείτας	
Λευείτης	
Λευειτικῆς	
λευκᾶναι	
λευκάς	
λευκόν	white
λευκός	light, bright, brilliant
λευκόω	to make white
λέων	a lion
λήθη	a forgetting, forgetfulness
λῆθος	
ληιστής	
ληιστός	to be carried off as booty, to be won by force
ληκέω	to sound
λήμψεσθε	
λήμψεται	
λήμψεως	
λημψόμεθα	
λήμψονται	
ληνός	trough;
λῆρος	silly talk, nonsense, trumpery
λῃστής	a robber, plunderer
ληστῶν	
λίαν	very, exceedingly
λίβανος	the frankincense-tree
λιβανωτός	frankincense, the gum of the tree λίβανος
λιβερτῖνος	
λίβος	a drop or fleck
Λιβύη	Libya, the north part of Africa
λιθάζω	to fling stones
λιθάω	
λίθινος	of stone
λιθοβολέω	to pelt with stones, stone
λιθόομαι	
λίθος	a stone
λιθόστρωτος	paved with stones
λικμάω	to part the grain from the chaff, to winnow
λιμήν	a harbour, haven, creek
λίμμα	
λιμνει	
λίμνη	a pool of standing water
λιμός	hunger, famine
λίνον	anything made of flax
Λίνος	Linos
λίνος	
λιπαρός	oily, shiny with oil
λίτρα	a silver coin
λίψ	
λογεύς	
λογία	a collection for the poor
λογίζομαι	to count, reckon, calculate, compute
λογικός	
λόγιον	an announcement, oracle
λόγιος	versed in tales or stories
λογισμός	a counting, reckoning, calculation, computation
λογομαχέω	to war about words
λογομαχία	a war about words
ΛΟΓΟΝ	
λόγος	the word or that by which the inward thought is expressed
λόγΣ	
λόγχη	a spear-head, javelin-head
λοιδορέω	to abuse, revile
λοιδορία	railing, abuse
λοίδορος	railing, abusive
λοιμός	a plague, pestilence
λοιπάς	
λοιπός	remaining, the rest
λος	
ΛΟΥΚΑΝ	
Λουκᾶς	
Λούκιος	
λουτρόν	a bath, bathing place
λούω	to wash
Λύδδα	
Λύδδας	
Λυδία	Lydia
Λυδίης	
Λύδιος	of Lydia, Lydian
Λυκαονία	in Lycaonian
Λυκαονιστί	
Λυκία	Lycia.
Λύκιος	Lycian.
λύκος	a wolf
λυκόω	to tear like a wolf
λυμαίνομαι	to treat with indignity, to outrage, to maltreat
λυπέω	to give pain to, to pain, distress, grieve, vex, annoy
λύπη	pain of body
Λυσανίας	
λυσανίης	ending sorrow
Λυσίας	
λύσιος	releasing, delivering
λύσις	a loosing, setting free, releasing, ransoming
λυσιτελέω	to pay what is due
λυσιτελής	paying what is due
Λύστραν	
Λύστροις	
λύτρον	a price paid
λυτρόω	to release on receipt of ransom, to hold to ransom
λύτρωσις	ransoming
λυτρωτής	a ransomer, redeemer
λυτρωτός	
λυχνία	
λυχνίας	
λυχνίον	a lamp-stand
λύχνον	
λύχνος	a portable light, a lamp
λύω	to loose
Λωίδι	
Λώτ	
Μαάθ	
Μαγαδάν	
Μαγδαληνῇ	
Μαγδαληνή	
Μαγεδών	
μαγεύω	to be a Magus, use magic arts
μαγίαις	
Μάγος	a Magus, Magian
Μαγώγ	
Μαδιάμ	
μαθητεύω	to be pupil
μαθητής	a learner, pupil
μαθητός	learnt, that may be learnt
μαθήτρια	
ΜΑΘΘΑΙΟΝ	
Μαθθαῖον	
Μαθθαῖος	
Μαθθάν	
Μαθθάτ	
Μαθθίαν	
Μαθουσαλά	
μαίνη	maena
μαίνομαι	to rage, be furious
μακαρία	happiness, bliss
μακαρίζω	to bless, to deem or pronounce happy
Μακαρίη	
ΜΑΚΑΡΙΟΙ	
μακάριος	blessed, happy
Μακάριος	
μακαρισμός	a pronouncing happy, blessing
Μακεδονία	
Μακεδών	a Macedonian
μάκελλον	the meat-market, shambles
μάκελλος	
μακράν	a long way, far, far away
μακρόθεν	from afar
μακροθυμέω	to be long-suffering
μακροθυμία	
μακρόθυμος	longsuffering, patient
μακρός	long
μακροχρόνιος	
μαλακία	softness, delicacy, effeminacy
μαλακιάω	
μαλακός	a fresh-ploughed
Μαλελεήλ	
μάλιστα	
μα̈λλον	
μᾶλλον	
Μάλχος	
μάμμη	mamma, mammy
μαμωνᾶ	
μαμωνᾷ	
Μαναήν	
Μανασσῆ	
Μανασσῆς	
μανθάνω	to learn
μανία	madness, frenzy
μάννα	manna, a morsel, grain
μαντεύομαι	to divine, prophesy, presage
μαραίνω	to put out or quench
μαράν	
μαργαρίτης	a pearl
Μάρθα	
Μάρθαν	
Μάρθας	
Μαρία	
Μαρίᾳ	
Μαριάμ	
Μαρίαν	
Μαρίας	
ΜΑΡΚΟΝ	
Μάρκος	
μάρμαρον	
μάρμαρος	stone or rock
μαρτύ	
μαρτυρέω	to be a witness, to bear witness, give evidence, bear testimony
μαρτύρησις	
μαρτυρία	witness, testimony, evidence
μαρτύριον	a testimony, proof
μαρτύρομαι	to call to witness, attest, invoke
μάρτυρος	
μάρτυς	a witness
μασάομαι	to chew
μαστιγόω	to whip, flog
μαστίζω	to whip, flog
μάστιξ	a whip, scourge
μαστός	one of the breasts
ματαιολογία	
ματαιολόγος	talking idly, at random
μάταιος	vain, empty, idle, trifling, frivolous
ματαιότης	
ματάω	to be idle, to dally, loiter, linger
ματέω	
μάτη	a folly, a fault
μάτην	in vain, idly, fruitlessly
Ματθάτ	
μάτος	
Ματταθά	
Ματταθίου	
μάχαιρα	a large knife or dirk
μάχη	battle, fight, combat
μάχομαι	to fight
μεγαλεῖος	magnificent, splendid
μεγαλειότης	majesty
ΜΕΓΑΛΗ	
μεγαλοπρεπής	befitting a great man, magnificent
μεγαλύνω	to make great or powerful, to exalt, strengthen
μεγάλως	
μεγαλωσύνη	greatness, majesty
μέγας	big, great
μέγεθος	greatness, magnitude, size, height, stature
μεγιστᾶνες	great men, grandees
μέθη	strong drink
μέθημαι	to sit among
μεθίημι	to let go, let loose, release
μεθίστημι	to place in another way, to change
μεθό	after that.
μεθοδία	
μεθύσκω	to make drunk, intoxicate, inebriate
μέθυσος	drunken
μεθύω	to be drunken with wine
μείς	a month
μέλαινα	
μέλας	black, swart
Μελεά	
μελετάω	to care for, attend to
μελέτη	care, attention
μέλη	
μέλι	
Μελιτήνη	
μέλλω	to think of doing, intend to do, to be about to do
μέλος	a limb
Μελχεί	
Μελχισεδέκ	
μέλω	to be an object of care or thought
μεμβράνα	
μεμιαμμένοις	
μεμισήμενου	
μέμφομαι	to blame, censure, find fault with
μεμψίμοιρος	complaining of one's fate, repining, querulous
μέν	on the one hand, on the other hand
ΜΕΝ	
μεν	
Μεννά	
μενοι	
μενον	
μενος	
μένος	might, force, strength, prowess, courage
μενοῦνγε	
μέντοι	
μένω	to stay at home, stay where one is, not stir
μέρα	
μερίζω	to divide, distribute
μέριμνα	care, thought
μερίμνᾶτε	
μεριμνάω	to care for, be anxious about, think earnestly upon, scan minutely
μερίς	a part, portion, share, parcel
μερισμός	a dividing, division
μεριστής	a divider
μεριστός	divided, divisible
μέρος	a part, share
μέση	
μεσημβρία	mid-day, noon
μεσημβριάω	
μεσήμβριος	
μέσης	
μεσιτεύω	to act as mediator
μεσίτης	a mediator, umpire, arbitrator
μεσονύκτιον	
μεσονύκτιος	of or at midnight
Μεσοποταμία	
μεσοποτάμιος	between rivers
μέσος	middle, in the middle
μεσότοιχον	a partition-wall
μεσότοιχος	
μεσουράνημα	mid-heaven, mid-air
μεσόω	to form the middle, be in or at the middle
Μεσσίαν	
Μεσσίας	
μεστός	full, filled, filled full
μεστόω	to fill full of
μετ̓	
ΜΕΤΑ	
μετά	in the midst of, among with gen., dat., and acc.
μετα	
μετά-ἀμελέω	
μεταβαίνω	to pass over from one place to another
μεταβάλλω	to throw into a different position, to turn quickly
μετάγω	to convey from one place to another
μεταδίδωμι	to give part of, give a share of
μεταδότης	
μετά-ἐπιμελέομαι	
μετά-ἑρμηνεύω	
μετάθεσις	transposition
μεταί	
μεταίρω	to lift up and remove, to shift
μετά-ἱστάνω	
μετακαλέω	to call away to another place
μετακινέω	to transpose, shift, remove
μεταλαμβάνω	to have or get a share of, to partake of
μετάλημψιν	
μεταλλάσσω	to change, alter
μεταμέλει	it repents
μεταμορφόω	to transform
μετανοέω	to change one's mind or purpose
μετάνοια	after-thought, repentance
μεταξύ	betwixt, between
μεταπέμπω	to send after
μεταστρέφω	to turn about, turn round, turn
μετασχηματίζω	to change the form of
μετασχημάτισις	
μετατίθημι	to place among
μετατρέπομαι	to turn oneself round, turn round
μετέπειτα	afterwards, thereafter
μετέχω	to partake of, enjoy a share of, share in, take part in
μετεωρίζω	to raise to a height, raise
μετοικεσία	the Removal or Captivity
μετοικίζω	to lead settlers to another abode
μετοχή	participation, communion
μέτοχος	sharing in, partaking of
μετρέω	to measure in any way
μέτρησις	measuring, measurement
μετρητής	a measurer
μετρητός	measurable
μετριοπαθέω	to bear reasonably with
μέτριος	within measure
μέτρον	that by which anything is measured
μέτωπον	the space between the eyes, the brow, forehead
μέχρι	to a given point, even so far
μή	not
μήγε	
μηδαμός	none
μηδαμῶς	
μηδέ	but not or and not, nor
μηδείς	and not one
μηδέποτε	never
μηδέπω	nor as yet, not as yet
Μῆδος	a Mede, Median
μηκέτι	no more, no longer, no further
μῆκος	length
μηκύνω	to lengthen, prolong, extend
μηλωτή	
μήν	now verily, full surely
μήνυσις	
μηνύω	to disclose what is secret, reveal, betray
μήποτε	never, on no account
μήπω	not yet
μηρός	the thigh
μής	
μήτε	and not
μητερα	
μήτηρ	a mother
ΜΗΤΗΡ	
μήτιγε	
μῆτις	the faculty of advising, wisdom, counsel, cunning, craft
μήτις	lest any one, lest anything; that no one, that nothing
μήτρα	
μητρίς	
μητρολῴαις	
μιαίνω	to stain, dye
μἰαν	
μίασμα	stain, defilement, the taint of guilt
μιασμός	
μίγνυμι	to mix, mix up, mingle, properly of liquids
μικοότερος	
μικρός	small, little
Μίλητος	Miletus
μίλιον	a Roman mile, milliarium
μιμέομαι	to mimic, imitate, represent, portray
μιμητής	an imitator, copyist
μιμητός	to be imitated or copied
μιμνήσκω	to remind, put
μισέω	to hate
μισθαποδοσία	payment of wages, recompense
μισθαποδότης	one who pays wages, a rewarder
μίσθιος	salaried, hired
μισθός	wages, pay, hire
μισθόω	to let out for hire, farm out, let
μίσθωμα	the price agreed on in hiring, the contract-price
μισθωτής	one who pays rent, a tenant
μισθωτός	hired
μῖσος	hate, hatred
Μιτυλήνη	
Μιχαήλ	
μ̓̂ν	
μνᾶ	a weight, =
μνάομαι	to turn one's mind
Μνάσωνι	
μνεία	remembrance, memory
μνῆμα	a memorial, remembrance, record
μνημεῖον	a monument
μνήμη	a remembrance, memory, record
μνημονεύω	to call to mind, remember
μνημόσυνον	a remembrance, memorial, record
μνησθησομαι	
μνηστεύω	to woo, court, seek in marriage
μξίζονα	
μξυ	
μογιλάλος	hardly-speaking, dumb
μόδιος	
μοιχαλίς	an adulteress
μοιχάω	to have dalliance with
μοιχεία	adultery
μοιχεύω	to commit adultery with
μοιχός	an adulterer, paramour, debaucher
μόλις	not scarcely
Μολόχ	
μολύνω	to stain, sully, defile
μολυσμός	defilement
μόμον	
μομφή	blame, censure
μονή	a staying, abiding, tarrying, stay
μονογενής	only-begotten, single
μόνος	alone, left alone, forsaken solitary
μὀνος	
μονόφθαλμος	one-eyed
μονόω	to make single or solitary
μορφάζω	to use gesticulations
μορφάω	to shape, fashion, mould
μορφή	form, shape
μορφόω	to give form or shape to
μόρφωσις	form, semblance
μοσχοποιέω	to make a calf.
μόσχος	
μουσική	any art over which the Muses presided
μουσικός	of or for music, musical
μόχθος	toil, hard work hardship, distress, trouble
μυελός	marrow
μυέω	to initiate into the mysteries
μῦθος	anything, delivered by word of mouth, word, speech
μυκάομαι	to grate, creak
μυκτηρίζω	to turn up the nose or sneer at
μυλικός	of or for a mill
μύλινος	
μύλος	a millstone
μυριάς	a number of
μυρίζω	to rub with ointment or unguent, anoint
μυρίος	numberless, countless, infinite
μύρον	sweet juice extracted form plants, sweet-oil, unguent, balsam
μῦρος	
μύρρα	
μύρω	to flow, run, trickle
μυσία	
Μύσιος	a Mysian dirge
μυστήριον	a mystery or secret doctrine;
μυωπάζω	to be shortsighted, see dimly
μώλωψ	
μωμάομαι	to find, fault with, blame
μῶμος	blame, ridicule, disgrace
Μωνσῆς	
μωραίνω	to be silly, foolish
μωρανθ	
μωρανθῇ	
μωρία	silliness, folly
μωρολογία	silly talking
μωρός	dull, sluggish, stupid
Μωυξῇ	
Μωυσέα	
Μωυσεῖ	
Μωυσέως	
Μωυσῆν	
Μωυσῆς	
ν	
̔́Ν	
Ναασσών	
Ναγγαί	
Ναζαρά	
Ναζαρέθ	
Ναζαρέτ	
Ναζαρηνέ	
Ναζαρηνόν	
Ναζαρηνός	
Ναζαρηνοῦ	
Ναζωραῖον	
Ναζωραῖος	
ΝΑΖΩΡΑΙΟΣ	
Ναζωραι̂Ος	
Ναζωραίου	
Ναζωραίων	
Ναθάμ	
Ναθαναήλ	
ναί	yea, verily
Ναιμάν	
Ναίς	
ναός	the dwelling of a god, a temple
Ναούμ	
νάρδον	
νάρδος	nard, spikenard, nard-oil
Νάρκισσος	
νασίαν	
ναυαγέω	to suffer shipwreck, be shipwrecked
ναύκληρος	a shipowner, ship-master
ναῦς	a ship
ναύτης	a mate or companion by sea
Ναχώρ	
νάω	to flow
νέα	
νεανίης	a young man, youth
νεανίσκος	a youth
νεάω	to plough up anew
Νέη	
νεκρός	a dead body, corpse
νεκρόω	to make dead
νέκρωσις	a state of death, deadness: death
νεομηνία	
νέος	young, youthful
νεότης	youth
νεόφυτος	newly planted
νετο	
νεύω	to nod or beckon
νεφέλη	a cloud
Νεφθαλείμ	
Νεφθαλίμ	
νέφος	a cloud, mass or pile of clouds
νεφρός	the kidneys
νέω	
νεωκόρος	the custodian of a temple
νεῶτερας	
νεωτερικός	
νεώτερος	younger
νή	
νήθω	to spin
νηπιάζετε	
νήπιος	not yet speaking
Νηρεύς	Nereus
Νηρηίς	a daughter of Nereus, a Nereid or Nymph of the sea
νησίον	an islet
νῆσος	an island
νηστεία	a fast
νηστεύω	to fast
νῆστις	not eating, fasting
νηφάλιος	unmixed with wine, wineless
νήφω	to drink no wine
Νίγερ	
νίζω	to wash the hands or feet
Νικάνωρ	
νικάω	to conquer, prevail, vanquish
νίκη	victory in battle
Νικόδημος	
Νικολαϊτῶν	
Νικόλαος	
Νικόπολις	
νῖκος	
Νινευεῖται	
Νινευείταις	
νιπτήρ	a washing vessel, basin
νίφω	to snow
νοέω	mere sight
νόημα	that which is perceived, a perception, thought
νόθος	a bastard, baseborn child
νομένης	
νομή	a pasture, pasturage
νομίζω	to hold or own as a custom or usage, to use customarily, practise
νομικός	resting on law, conventional
νόμιμος	conformable to custom, usage
νόμισμα	anything sanctioned by usage, a custom, institution
νομοδιδάσκαλος	a teacher of the law
νομοθεσία	lawgiving, legislation
νομοθετέω	to make law
νομοθέτης	a lawgiver
νόμος	anything assigned, a usage, custom, law, ordinance
νον	
νόος	mind, perception
νος	
νοσέω	to be sick, ill, to ail
νόσος	sickness, disease, malady
νοσσία	
νοσσιάν	
νοσσούς	
νοσφίζομαι	to turn one's back upon
νότος	the south or south-west wind
νου	
νουθεσία	
νουθετέω	to put in mind, to admonish, warn, advise
νουνεχής	with understanding, sensible, discreet
νύμφη	a young wife, bride
Νύμφης	
νυμφίος	
νυμφών	the bridechamber
νῦν	now at this very time
νὖν	
νυνί	now, at this moment
νύξ	the night-season or a night
νύσσω	to touch with a sharp point, to prick, spur, pierce
νυστάζω	to nod in sleep, to nap, slumber
νυχθήμερον	a night and a day
νυχθήμερος	
Νῶε	
νωθρός	sluggish, slothful, torpid
νωτίζω	to turn one's back
νῶτον	the back
νῶτος	
ξένη	a female guest: a foreign woman
ξενία	the rights of a guest, hospitality, friendly entertainment or reception
ξενίζω	to receive or entertain strangers, to receive as a guest
ξένιος	belonging to a friend and guest, hospitable
ξενοδοκέω	to entertain guests or strangers
ξένος	
ξενόω	to make one's friend and guest
Ξένων	
ξέστης	pint
ξεστός	smoothed, polished, wrought
ξηρά	dry land
ξηραίνω	to parch up, dry up
ξηρός	dry
ξἰκίᾳ	
ξἰσίν	
ξου	
ξπέρμα	
ξύλινος	of wood, wooden
ξύλον	wood
ξυλόω	to make of wood.
ξυρέω	to shave
ο	
ό	
Ο	
ὁ	the, that
ὀγδοήκοντα	eighty
ὄγδοος	eighth
ὄγκος	
ὁδάω	to export and sell;
ὅδε	this
ὁδεύω	to go, travel
ὁδηγέω	to lead
ὁδήγησις	
ὁδηγός	a guide
ὁδοιπορέω	to travel, walk
ὁδοιπορία	a journey, way
ὁδός	
ὁδού	
ὀδούς	
ὁδόω	to lead by the right way
ὀδυνάω	to cause
ὀδύνη	pain of body
ὀδυρμός	a complaining, lamentation
ὁδῳ	
ὀδών	
οεοῦ	
Ὀζείαν	
Ὀζείας	
ὄζω	to smell
ὅθεν	from whom
ὀθόνη	fine linen
ὀθόνιον	a piece of fine linen
οἰ	
οῖ	
οἶδα	to know
οἰκ	
οἰκεῖος	in or of the house, domestic
οἰκειόω	to make one's own
οἰκείω	
οἰκετεία	the household
οἰκέτης	a house-slave, menial
οἰκεύς	an inmate of one's house
οἰκέω	to inhabit, occupy
οἴκημα	any inhabited place, a dwellingplace
οἰκητήριον	a dwelling-place, habitation
οἰκητήριος	
οἰκία	a building, house, dwelling
οἰκιακός	of or belonging to a house
οίκιαν	
οἰκίζω	to found as a colony or new settlement
οἰκίον	
οἶκο	
οἰκοδεσποτέω	to be master of the house, to rule the household
οἰκοδεσπότης	the master of the house, the good man of the house
οἰκοδομεύς	
οἰκοδομέω	to build a house
οἰκοδομή	
οἰκόδομος	
οἰκοδόμος	a builder, an architect
οἰκοδουάς	
οἰκον	
οἷκον	
οἰκονομέω	to manage as a house steward, to manage, order, regulate
οἰκονομία	the management of a household or family, husbandry, thrift
οἰκονόμος	one who manages a household
οἰκόνομος	
οἶκοξ	
οἶκος	a house, abode, dwelling
οἰκουμένη	the inhabited world
οἰκουργός	a house-steward
οἰκτειρέω	
οἰκτείρω	to pity, feel pity for, have pity upon
οἰκτιρμός	pity, compassion
οἰκτιρμων	merciful
οἰκτίρμων	
οἴμη	a song, lay
οἶνον	
οἰνοπότης	
οἶνος	wine
οἰνοφλυγία	drunkenness
οἰνόω	to intoxicate
οἴομαι	to suppose, think, deem, imagine
οἷος	such as, what sort or manner of nature, kind
ὄις	ram
οἶσις	
ὀκνηρός	shrinking, hesitating, backward, unready, timid
ὀκνησῃς	
ὀκταήμερος	on the eighth day
ὀκτώ	
ὁλάω	
ὄλεθρος	ruin, destruction, death
ὀλιγοπιστίαν	
ὀλιγόπιστος	of little faith
ὀλίγος	few, little, scanty, small
ὀλιγόψυχος	faint-hearted
ὀλιγωρέω	to esteem little or lightly, make small account of
ὀλοθρευτής	a destroyer
ὀλοθρεύω	to destroy utterly
ὁλοκαύτωμα	a whole burnt-offering, holocaust
ὁλοκληρία	completeness or soundness in all its parts
ὁλόκληρος	complete in all parts, entire, perfect
ὀλολύζω	to cry to the gods with a loud voice, cry aloud
οΛον	
ὅλοξ	whole, entire, complete
ὅλος	
ὁλοτελής	
Ὀλυμπᾶν	
ὄλυνθος	a winter-fig
ὄμβρος	
ό̓μβρος	heavy rain
ὀμειρόμενοι	
ὁμιλέω	to be in company with, consort with
ὁμιλία	a being together, communion, intercourse, converse, company
ὁμίχλη	a mist, fog
ὄμμα	the eye
ὀμματόω	to furnish with eyes
ὄμνυμι	to swear
ὁμο	
ὁμοθυμαδόν	with one accord
ὁμοιοπαθέω	to have similar feelings or affections, to sympathise
ὁμοιοπαθής	having like feelings or affections, sympathetic
ὅμοιος	like, resembling
ὁμοῖος	
ὁμοιότης	likeness, resemblance
ὁμοιόω	to make like
ὁμοίωμα	a likeness, image, resemblance, counterfeit
ὁμοίωσις	a becoming like, assimilation
ὁμολογέω	to speak together
ὁμολόγησις	
ὁμολογία	agreement
ὁμολογουμένως	conformably with
ὁμός	one and the same, common, joint
ὁμότεχνος	
ὁμοῦ	at the same place, together
ὁμόφρων	
ὁμόω	to unite
ὅμως	all the same, nevertheless, nothwithstanding, still
ὄναρ	a dream, vision in sleep
ὀνάριον	
ὀνειδίζω	to throw a reproach upon
ὀνειδισμός	
ὄνειδος	reproach, censure, blame
ὀνήσιμος	useful, profitable, beneficial
ὀνησιφόρος	
ὀνικός	of or for an ass
ὀνίνημι	to profit, benefit, help, assist
ὄνομα	by name
ὀνομάζω	to name or speak of by name, call or address by name
ὄνος	an ass
ὄντα	existing things, the present
ὄντως	really, verily
ὄξος	poor wine, vin-de-pays
ὀξύς	sharp, keen
ὀπάζω	to make to follow, send with
ὀπέλθῃ	
ὀπή	an opening, hole
ὄπισθεν	behind, at the back
ὀπίσω	backwards
ὁπλίζω	to make or get ready
ὅπλον	a tool, implement
ὁποῖος	of what sort or quality
ὅπου	in some places
ὀπτάζομαι	to be seen
ὀπτασία	a vision
ὀπτάω	to roast, broil
ὀπτός	roasted, broiled
ὀπώρα	the part of the year between the rising of Sirius and of Arcturus
ὅπως	as, in such manner as
ὅραμα	that which is seen, a sight, spectacle
ὅρασις	seeing, the act of sight
ὁρατής	
ὁρατός	to be seen, visible
ὁράω	To see
ὀργάζω	to soften, knead, temper
ὀργάω	to swell with moisture
ὀργή	natural impulse or propension: one's temper, temperament, disposition, nature
ὀργίζω	to make angry, provoke to anger, irritate
ὀργίλος	prone to anger, irascible
ὄργυια	the length of the outstretched arms
ὀρέγω	to reach, stretch, stretch out
ὄρεξις	desire, appetite
ὀρεύς	a mule
ὀρθοποδέω	to walk uprightly
ὀρθός	straight
ὀρθοτομέω	to cut in a straight line
ὀρθόω	to set straight
ὀρθρίζω	
ὀρθρινός	
ὄρθρος	day-break, dawn, cock-crow
Ὄρθρος	
ὁρίζω	to divide or separate from, as a boundary
ὀρινήν	
ὀρίνω	to stir, raise, agitate
ὅριον	a boundary, limit
ὅριος	of boundaries
ὁρκίζω	to make
ὅρκος	the object by which one swears, the witness of an oath
ὁρκόω	to bind by oath
ὁρκωμοσία	a swearing, an oath
ὁρμάω	to set in motion, urge
ὁρμέω	to be moored, lie at anchor
ὁρμή	a violent movement onwards, an assault, attack, onset
ὅρμημα	stir, impulse
ὄρνεον	a bird
ὀρνεόω	
ὄρνις	a bird
ὁροθεσία	
ὄρομαι	to watch, keep watch and ward
ὄρος	a mountain, hill
Ορος	
ὀρύσσω	to dig
ὀρφανός	an orphan
ὀρχέομαι	to dance in a row
ὅς	this, that;
ὁσάκις	as many times as, as often as
ὅσιος	hallowed, sanctioned by the law of God
ὁσιότης	piety, holiness
ὁσιόω	to make holy, purify, set free from guilt by offerings
ὀσμή	a smell, scent, odour
ὅσος	quantus
ὅστε	who, which
ὀστέον	the
ὅστις	any one who, anything which
ὀστράκινος	earthen, of clay
ὄσφρησις	the sense of smell, smell
ὀσφύς	the loin or loins, the lower part of the back
ὅταν	whenever
ὅτε	when
οΤε	
ὁΤι	
οΤι	
ὄτι	
ὅτι	
οὗ	where
οὐ	not
ου	
οὐά	ha! ah!
οὐαί	woe
οὐδ̓	
οὐδαμός	not even one, no one
οὐδαμῶς	in no wise
οὐδέ	but not
οὐδείς	and not one
οὐδέποτε	and not ever or nor ever, not even ever, never
οὐδέπω	and not yet, not as yet
οὐδός	
οὐκέτι	no more, no longer, no further
οὐκοῦν	therefore, then, accordingly
οῦμεν	
ου̂Ν	
οὖν	really, at all events
οῦν	
ουνέδρια	
οὔπω	not yet
οὐρά	the tail
οὐράνη	
οὐράνιος	heavenly, of or in heaven, dwelling in heaven
οὐρανόθεν	from heaven, down from heaven
οὐρανον	
οὐρανός	heaven
Οὐρβανόν	
οὔριον	
οὔριος	with a fair wind
οὐριόω	to give to the winds
οὖς	auris, the ear
ουΣα	
οὐσία	that which is one's own, one's substance, property
οὖσον	
οὔτε	and not
οὗτος	this
ΟΥΤΟΣ	
οὕτως	in this way or manner, so, thus
ὀφειλέτης	a debtor
ὀφειλή	a debt
ὀφείλημα	that which is owed, a debt
ὀφείλω	to owe, have to pay or account for
ὀφέλλω	to increase, enlarge, strengthen
ὄφελος	furtherance, advantage, help
ὀφθαλμοδουλίαις	
ὀφθαλμοδουλίαν	
οφθαλμοῖς	
ὀφθαλμός	the eye
ὀφθαλμούξ	
ὄφις	a serpent, snake
ὀφρύς	the brow, eyebrow
ὀχλέω	to move, disturb
ὀχλοποιέω	to make a riot
ὄχλος	a moving crowd, a throng, mob
ὀχύρωμα	a stronghold, fortress
ὀψάριον	
ὀψέ	after a long time, late
ὀψία	the latter part of day, evening
ὄψιμος	late, slow
ὀψίον	
ὄψιος	late
ὄψις	look, appearance, aspect
ὀψωνέω	to buy fish and dainties
ὀψώνιον	provisions or provision-money
παγιδεύω	to lay a snare for, entrap
παγίς	a trap
πᾶγος	
Πάγος	
πάθη	a passive state
πάθημα	anything that befals one, a suffering, calamity, misfortune
παθητός	one who has suffered: subject to passion
πάθος	anything that befalls one, an incident, accident
παιδαγωγός	a boy-ward;
παιδάριον	a young, little boy
παιδεία	the rearing of a child
παιδευτής	a teacher, instructor, preceptor
παιδευτός	to be gained by education
παιδεύω	to bring up or rear a child
παιδία	
παιδιόθεν	from a child
παίδιον	
παιδίον	a little or young child
παίδιος	
παιδίσκη	a young girl, maiden
παίζω	to play like a child, to sport, play
παῖς	a child
παίω	
πάλα	
πάλαι	long ago, in olden time, in days of yore, in time gone by
παλαιός	old in years
παλαιότης	antiquity, obsoleteness
παλαιόω	to make old
παλέω	to be disabled
πάλη	wrestling
πάλιν	back, backwards
παλινγενεσίᾳ	
παλινγενεσίας	
πάλλω	to poise or sway
Παμ	
Παμφυλία	
Παμφυλίη	
πανδοχεῖ	
πανδοχεῖον	
πανήγυρις	a general or national assembly
πανοικεί	
πανοπλία	the full armour of an ὁπλίτης
πανουργία	knavery, roguery, villany
πανοῦργος	ready to do anything wicked, knavish, villanous
πανπληθεί	
πανταχῆ	everywhere
πανταχοῦ	everywhere
παντελής	all-complete, absolute, complete, entire
παντες	
πάντῃ	
πάντοθεν	from all quarters, from every side
παντοκράτωρ	almighty
πάντοτε	at all times, always
πάντως	altogether;
πάομαι	to get, acquire
παρά	from the side of, c. gen., beside, alongside of, c. dat., to the side of, motion alongside of, c. acc.
παρα	
παραβαίνω	to go by the side of
παραβαλήν	
παραβάλλω	to throw beside or by, throw to
παράβασις	a going aside, deviation
παραβάτης	one who stands beside
παραβιάζομαι	to use violence to
παραβολεύομαι	to run hazard
παραβολή	juxta-position, comparison
παραγγελία	a command or order
παραγγέλλω	to transmit as a message
παραγίγνομαι	near, attend upon
παράγω	to lead by or past
παραδειγματίζω	to make an example of
παραδείκνυμι	to exhibit side by side
παράδεισος	a park
παραδέχομαι	to receive from
παρά-δίδημι	
παραδίδωμι	to give or hand over to another, transmit
παραδοῖ	
παράδοξος	contrary to opinion, incredible, paradoxical
παράδοσις	a handing down, transmission
παρ̂αδωσουσιν	
παρά-ἐπικραίνω	
παρά-ζηλόω	
παραθαλάσσιος	beside the sea, lying on the sea-side, maritime
παραθεωρέω	to examine
παραθήκη	anything entrusted to
παραινέω	to exhort, recommend, advise
παραιτέομαι	to beg from
παρακαλέω	to call to
παρακαλύπτω	to cover by hanging something beside, to cloak, disguise
παράκειμαι	to lie beside or before
παράκλησις	a calling to one's aid, summons
παράκλητος	called to one's aid
παρακοή	unwillingness to hear, disobedience
παρακολουθέω	to follow beside, follow closely
παράκουσις	
παρακούω	to hear beside
παρακύπτω	to stoop sideways
παραλαμβάνω	to receive from
παραλέγω	to lay beside
παραλημφθήσεται	
παραλήμψομαι	
παράλιον	
παράλιος	by the sea
παραλλαγή	a passing from hand to hand, transmission
παραλογίζομαι	to misreckon, miscalculate
παραλυτικός	paralytic
παραλύω	to loose from the side, take off, detach
παραμένω	to stay beside or near, stand by
παραμυθέομαι	to encourage or exhort
παραμυθία	encouragement, exhortation, persuasion
παραμύθιον	an address, exhortation
παρανομέω	to transgress the law, act unlawfully
παρανομία	transgression of law, decency or order
παραπαθημάτων	
παραπικρασμός	provocation
παραπίπτω	to fall beside
παραπλέω	to sail by or past
παραπλήσιος	coming near, nearly resembling, such-like
παραπορεύομαι	to go beside or alongside
παράπτωμα	a false step, a transgression, trespass
παραρρέω	to flow beside or past
παράσημον	a side-mark: a mark of distinction, the ensign of a ship
παράσημος	falsely stamped
παρασκευάζω	to get ready, prepare
παρασκευή	preparation
παρατείνω	to stretch out along or beside, to extend the line
παρατηρέω	to watch closely, observe narrowly, to watch one's opportunity
παρατήρησις	observation
παρατίθημι	to place beside
παρατυγχάνω	to happen to be near, be among
παραυτίκα	immediately, forthwith, straightway
παραφέρω	to bring to
παραφρονέω	to be beside oneself, be deranged or mad
παραφρονία	
παραχειμάζω	to winter in or at
παραχειμασία	a wintering in a place
παραχρῆμα	on the spot, forthwith, straightway
πάρδαλις	the pard
παρεδρεύω	to sit constantly beside, attend constantly, be always near
παρέζομαι	to sit beside
πάρειμι	to be by or present
παρεισάγω	to lead in by one's side, bring forward, introduce
παρείσακτος	introduced privily
παρεισέρχομαι	to come or go in beside or secretly
παρεισφέρω	to bring in beside
παρεῖχαν	
παρεκτός	besides or except for
παρελθάτω	
παρεμβάλλω	to put in beside, insert, interpolate, interpose
παρεμβολή	insertion, interpolation
παρενοχλέω	to trouble greatly
παρεξίημι	to let out beside
πάρεξις	
παρεπίδημος	
παρέρχομαι	to go by, beside or past, to pass by, pass
πάρεσις	a letting go, remission
παρέχω	to hold beside, hold in readiness, to furnish, provide, supply
παρηγορία	exhortation, persuasion
παρηκολοίθησας	
παρθενία	
παρθενίας	
παρθενίης	the son of a concubine
παρθένιος	of a maiden or virgin, maiden, maidenly
παρθένος	a maid, maiden, virgin, girl
Πάρθοι	the Parthians
παρίημι	to let drop beside or at the side, let fall
παριστάνω	
παριστήκεισαν	
παρίστημι	to make to stand or to place beside
Παρμενᾶν	
πάροδος	a by-way, passage
παροικέω	to dwell beside
παροικία	a sojourning
πάροικος	dwelling beside or near
παροιμία	a by-word, common saying, proverb, maxim, saw
πάροινος	
παροίχομαι	to have passed by
παρομοιάζω	to be much like
παρόμοιος	much like, nearly like, closely resembling
παροξύνω	to urge, prick or spur on, stimulate
παροξυσμός	irritation, exasperation
παροργίζω	to provoke to anger
παροργισμός	provocation; anger
παροτρύνω	to urge
παρουσία	a being present, presence
παροψίς	a dainty side-dish
παρρησία	freespokenness, openness, frankness
παρρησιάζομαι	to speak freely, openly, boldly
παρών	
πᾶς	all, the whole
πᾶσις	
πάσσω	to sprinkle
ΠΑΣΧΑ	
πάσχα	Passover
πάσχειν̓	
πάσχω	to receive an impression from without, to suffer
Πάταρα	
πατάσσω	to beat, knock
πατέομαι	to eat
Πατέρα	
πατέρα	
πατέρας	
πατέρες	
πατέω	to tread, walk
πατῆρ	
πατήρ	a father
πατήρμου	
Πάτμῳ	
πατριά	lineage, pedigree, by the father's side
πατριάρχης	the father or chief of a race, a patriarch
πατρικός	derived from one's fathers, paternal, hereditary
πατρίς	of one's fathers
Πατρόβαν	
πατρολῴαις	
πατροπαράδοτος	
πατρῷος	of or from one's father, coming or inherited from him
ΠΑΥΛΟΣ	
Παῦλος	
παῦσις	
παύω	to make to cease
Πάφος	Paphos
παχύνω	to thicken, fatten
Πέ	
πεδάω	to bind with fetters, to bind fast, make fast
πέδη	a fetter
πεδινός	flat, level
πεζεύω	to go or travel on foot, walk
πεζός	on foot
πει	
πειθαρχέω	to obey one in authority
πείθω	to prevail upon, win over, persuade
Πειλᾶτον	
Πειλᾶτος	
Πειλάτου	
Πειλάτῳ	
πεῖν	
πεινᾷ	
πεινᾷν	
πεινάω	to be hungry, suffer hunger, be famished
πεῖρα	a trial, attempt, essay, experiment
πειράζω	to make proof or trial of
πειρασμός	trial, temptation
πειράω	to attempt, endeavour, try
πείρω	to pierce quite through, fix
πεῖσα	obedience
πεισμονή	persuasion
πέλαγος	the sea
πελεκίζω	to cut off with an axe
πέμπτος	the fifth, oneself with four others
πέμπω	to send, despatch
πέμψις	a sending, mission, dispatch
πένης	one who works for his daily bread, a day-labourer, a poor man
πενθερά	a mother-in-law
πενθερός	a father-in-law
πενθέω	to bewail, lament, mourn for
πένθος	grief, sadness, sorrow
πενιχρός	poor, needy
πένομαι	to work for one's daily bread
πεντάκις	five times
πεντακισχίλιοι	five thousand
πεντακόσιοι	five hundred
πέντε	five
πεντεκαιδέκατος	the fifteenth
πεντήκοντα	fifty
πεντηκοστή	
πεντηκοστός	fiftieth
Πεόφιλε	
πεποίθησις	trust, confidence, boldness
πέπτωκαν	
πέπτωκες	
πέρα	beyond, across or over, further
περαίνω	to bring to an end, finish, accomplish, execute
περαίτερος	beyond
πέραν	on the other side, across, beyond
πέρας	an end, limit, boundary
πέρατος	on the opposite side
περάω	
Πέργαμον	
Πέργαμος	Pergamus
Πέργῃ	
Πέργην	
Πέργης	
πέρθω	to waste, ravage, sack, destroy
περί	around, round about with gen., dat., and acc.
περιάγω	to lead or draw round
περιαιρέω	to take off something that surrounds, take off an outer coat, take away, strip off
περιάπτω	to tie, fasten, hang about or upon, apply to
περιαστράπτω	to flash around
περιβάλλω	to throw round
περιβλέπω	to look round about, gaze around
περιβόλαιον	that which is thrown round, a covering
περιδέω	to bind, tie round or on
περιεπατουν	
περιεργάζομαι	to take more pains than enough about
περίεργος	careful overmuch
περιέρχομαι	to go round, go about
περιέχω	to encompass, embrace, surround
περιζώννυμαι	to gird round oneself, gird oneself with
περίθεσις	a putting on
περιιάπτω	to wound all round
περιίστημι	to place round
περικάθαρμα	an off-scouring, refuse
περικαλύπτω	to cover all round
περικε	
περίκειμαι	to lie round about
περικεφαλαία	a covering for the head, a helmet, cap
περικεφάλαιος	
περικρατής	having full command over
περικρύπτω	to conceal entirely
περικυκλόω	to encircle, encompass
περιλάμπω	to beam around
περιλείπομαι	to be left remaining, remain over, survive
περίλυπος	deeply grieved
περιμένω	to wait for, await
πέριξ	round about, all round
περιοικέω	to dwell round
περίοικος	dwelling round
περιούσιος	having more than enough: especial, peculiar
περιοχή	compass, extent:—a mass, body
περιπατέω	to walk up and down, to walk about
περιπάτησις	
περιπείρω	to pierce as with a spit
περιπίτνω	
περιποιέω	to make to remain over and above, to keep safe, preserve
περιποίησις	a keeping safe, preservation
περιρρήγνυμι	to rend from round
περισπάω	to draw off from around, to strip off
περισσεία	surplus, abundance
περίσσευμα	that which remains over, abundance
περίσσευσις	
περισσεύω	to be over and above
περισσός	beyond the regular number or size, prodigious
περισσῶς	
περιστερά	the common pigeon or dove
περιστερεών	a dovecote
περιστερός	
περιτέμνω	to cut or clip round about
περιτίθημι	to place round
περιτομεύς	
περιτομή	circumcision
περιτρέπω	to turn and bring round
περιτρέχω	to run round and round, run round
περιφέρω	to carry round
περιφρονέω	to compass in thought, speculate about
περιχέω	to pour round or over
περιχώρον	
περίχωρος	round about a place
περίψημα	anything wiped off, an offscouring
περπερεύομαι	to boast or vaunt oneself
Περσίς	Persian
πέρυσι	a year ago, last year
Πέσατε	
πέσσω	to soften, ripen or change
πετεινός	able to fly, full fledged
πετο	
πέτομαι	to fly
πέτρα	a rock, a ledge or shelf of rock
ΠΕΤΡΟΝ	
πέτρος	a stone
Πέτροσ̓	
ΠΕΤΡΟΣ	
ΠΕΤΡΟΥ	
πετρόω	to turn into stone, petrify
πετρώδης	like rock or stone, rocky, stony
πευσεν	
πη	in some way, somehow
πηγάζω	to spring or gush forth
πήγανον	rue
πηγάς	anything congealed, hoarfrost, rime
πηγή	running waters, streams
πήγνυμι	to make fast
πηγός	well put together, compact, strong
πηδάλιον	a rudder or an oar used for steering
πηλίκος	how great or large?
πηλόομαι	to wallow in mire
πηλός	clay, earth
πήρα	a leathern pouch, a wallet, scrip
πῆρος	
πηρός	disabled in a limb, maimed
πησαν	
πῆχυς	the fore-arm
πι	
πιέζω	to press, squeeze, press tight
πιητε	
πιθανολογία	the use of probable arguments
πιθοῖς	
πικραίνω	to make sharp or bitter
πικρία	bitterness
πικρός	pointed, sharp, keen
πίμπλημι	to fill full of
πίμπρημι	to burn, burn up
πινακίδιον	
πίναξ	a board, plank
πίνη	
πῖνον	
πίνος	dirt, filth
πίνω	to drink
πῖον	
πῖος	unctuous
πιότης	
πιπράσκω	to sell
πίπτω	to fall, fall down
Πισιδίαν	
πιστεύ	
πίστευσις	
πιστεύω	to trust, trust to or in, put faith in, rely on, believe in
πιστικός	
πίστις	trust
πιστόν	
πιστός	
πιστόω	to make trustworthy
πλανάω	to make to wander, lead wandering about
πλάνη	a wandering, roaming
πλάνης	a wanderer, roamer, rover
πλάνησις	a making to wander, a dispersing
πλανήτης	wandering, roaming
πλάνος	leading astray, cheating, deceiving
πλάξ	a flat surface, flat land, a plain
πλάσμα	anything moulded, an image, figure
πλάσσω	to form, mould, shape
πλαστός	formed, moulded
πλατεῖα	
πλατειάζω	to speak or pronounce broadly
πλατεῖον	a tablet
πλάτος	breadth, width
πλατύνω	to widen, make wide
πλατύς	wide, broad
πλέγμα	plaited work, wicker-work
πλεῖστος	most, largest
πλείων	more, larger
πλέκω	to plait, twine, twist, weave, braid
πλεονάζω	to be more
πλεόνασις	
πλεονεκτέω	to have or claim more than one's due, to get or have too much, to be greedy, grasping, arrogant
πλεονέκτης	one who has or claims more than his due, greedy, grasping, arrogant
πλεονεξία	the character and conduct of a πλεονέκτης, greediness, grasping, assumption, arrogance
πλέος	full.
πλευρά	a rib
πλέω	to sail, go by sea
πλέως	full of
πληγάς	
πληγή	a blow, stroke
πλῆθος	a great number, a throng, crowd, multitude
πληθύνω	to make full, increase, multiply
πλήθω	to be or become full of
πλήκτης	a striker, brawler
πλήμμυρα	the flood-tide
πλημμυρέω	to rise like the flood-tide, to overflow, be redundant
πλήν	more than
πλήξ	
πληοοφορίᾳ	
πλήρης	filled or infected by
πληροφορέω	to fulfil
πληροφορία	fulness of assurance, certainty
πληρόω	to make full
πλήρωμα	a full measure
πλήρωσις	a filling up, filling
πλησίος	near, close to
πλησμονή	a filling or being filled, satiety;
πλήσσω	to strike, smite
πλοιάριον	a skiff, boat
πλοῖον	a floating vessel, a ship, vessel
πλοός	
πλόος	a sailing, voyage
πλού	
πλούσιος	rich, wealthy, opulent
πλουτέω	to be rich, wealthy
πλουτίζω	to make wealthy, enrich
πλοῦτος	
πλύνω	to wash, clean
πνευμα	
πνεῦμα	a blowing
πνευματικός	of spirit, spiritual
πνευματος	
πνεύμΤος	
πνέω	to blow
πνίγω	to choke, throttle, strangle
πνικτός	strangled
πνοή	a blowing, blast, breeze
̓Πό	
πόα	grass, herb
ποδήρης	reaching to the feet
ποθεν	from some place or other
πόθεν	whence?
ποι	somewhither
Ποίας	
ποιέω	to make
ποίημα	anything made or done;
ποίησις	a making, fabrication, creation, production
ποιητής	one who makes, a maker
ποιητός	made
ποικίλλω	to work in various colours, to broider, work in embroidery
ποικίλος	many-coloured, spotted, mottled, pied, dappled
ποιμαίνω	to be shepherd
ποιμάνατε	
ποιμανεῖ	
ποιμήν	
ποίμνη	a flock
ποίμνιον	a flock
ποίμνιος	
ποιός	of a certain nature, kind or quality
ποῖος	of what nature? of what sort?
ποιῶσεν	
πολεμέω	to be at war or go to war, make war
πόλεμος	battle, fight, war
πολεμόω	to make hostile, make an enemy of
πολέω	to go about, range over
πὀλεως	
Πόλις	
πόλις	a city
πολιτάρχης	a civic magistrate
πολιτεία	the condition and rights of a citizen, citizenship
πολίτευμα	the business of government, an act of administration
πολιτεύω	to live as a citizen or freeman, live in a free state
πολίτης	a member of a city or state
πολλάκις	many times, often, oft
πολλαπλασίων	
ΠΟΛΛΟΙ	
πολυλογία	much talk, loquacity
ΠΟΛΥΜΕΡΩΣ	
πολυποίκιλος	much-variegated
πολύς	many
πολύσπλαγχνος	of great mercy
πολυτελής	very expensive, very costly
πολύτιμος	very costly
ΠΟΛΥΤΡΟΠΩΣ	
πόμα	
πον	
πονηρία	a bad state or condition, badness
πονηρός	toilsome, painful, grievous
πόνος	work
ποντίζω	to plunge in the sea
Ποντικός	from Pontus, Pontic
πόντιος	of the sea
Πόντις	
Πόντος	
Πόπλιος	
πορεία	a walking, mode of walking or running, gait
πορεύεσθαιἑως	
πορευό	
πόρευσις	
πορεύω	to make to go, carry, convey
πορθέω	to destroy, ravage, waste, plunder
πορισμός	a providing, procuring
Πόρκιον	
πορνεία	fornication, prostitution
πορνεύ	
πορνεύω	to prostitute
πόρνη	a harlot, prostitute
πόρνος	
ΠΟΡΝΩΝ	
πορφύρα	the purple-fish
πορφύρεος	darkgleaming, dark;
πορφυροπώλης	a dealer in purple
πορφυρόπωλις	
πορφύρω	gleams darkly
πος	
ποσάκις	how many times? how often?
πόσις	
ΠόσΝ	
πόσος	bulk)
ποσόω	to reckon up, count
ποταμός	a river, stream
ποταμοφόρητος	carried away by a river
ποταπαί	
ποταπή	
ποταπήν	
ποταποί	
Ποταπός	
ποταπός	
ποταπούς	
ποτέ	at some time or other, at some time
πότε	when? at what time?
πότερος	whether of the two?
ποτήριον	a drinking-cup, wine-cup
ποτίζω	to give to drink
Ποτιόλους	
πότος	drinking, a drinking-bout, carousal
ποτός	drunk, fit for drinking
πού	anywhere, somewhere
ποῦ	where?
Πούδης	
πούς	a foot
πρᾶγμα	that which has been done, a deed, act
πραγματεύομαι	to busy or exert oneself, take trouble
πραγματίας	
πραγματίη	
πραιτώριον	Castra Praetoriana
πράκτωρ	one who does or executes, an accomplisher
ΠΡΑΞΕΙΣ	
πρᾶξις	a doing, transaction, business
πρᾶος	Mild, soft, gentle, meek
πρασιά	a bed of leeks
πράσσω	to pass over
πραϋπαθίαν	
πραΰτης	
πραΰτητα	
πραΰτητι	
πραΰτητος	
πρε	
πρέπω	to be clearly seen, to be conspicuous
πρέπων	
πρεσβεία	age, seniority
πρεσβεύω	to be the elder or eldest
πρέσβυς	an old man
πρεσβυτέριον	a council of elders
ΠΡΕΣΒΥΤΕΡΟΣ	
πρεσβύτης	
πρεσβῦτις	an aged woman
πρηνής	with the face downwards, head-foremost
πρίν	comparative
Πρίσκα	
Πρίσκαν	
Πρίσκιλλα	
Πρίσκιλλαν	
πρίτος	
πρίω	to saw
ΠΡΟ	
πρό	before
προάγνυμι	to break before
προάγω	to lead forward, on, onward
προάγων	
προαιρέω	to bring forth, produce from one's stores
προαιτιάομαι	to accuse beforehand
προακούω	to hear beforehand
προαμαρτάνω	to fail or sin before
προαυλέω	to play a prelude on the flute
προαύλιον	a prelude on the flute
προβαίνω	to step on, step forward, advance
προβάλλω	to throw before, throw or toss to
προβατικός	of sheep or goats
προβάτιον	a little sheep
πρόβατον	anything that walks forward;
προβιβάζω	to make step forward, lead forward, lead on
προβλέπω	to foresee
προγίγνομαι	to come forwards
προγιγνώσκω	to know, perceive, learn
πρόγνωσις	a perceiving beforehand
πρόγονος	a forefather, ancestor
προγράφω	to write before or first
πρόδηλος	clear or manifest beforehand
προδίδωμι	to give beforehand, pay in advance
προδκαλεσάμενοι	
προδότης	a betrayer, traitor
πρόδρομος	running forward, with headlong speed
προεῖδον	to see beforehand, catch sight of
προεῖπον	to tell or state before
προελπίζω	to hope for before
προενάρχομαι	to begin before
προεπαγγέλλομαι	to promise before
προερέω	to say beforehand
προέρχομαι	to go forward, go on, advance
προετοιμάζω	to get ready before
προευηγγελίσατο	
προέχω	to hold before
προηγέομαι	to go first and lead the way, to be the leader
πρόθεσις	a placing in public
προθεσμία	
προθέσμιος	fore-appointed
προθέω	
προθυμία	readiness, willingness, eagerness, zeal
πρόθυμος	ready, willing, eager, zealous
πρόϊμον	
προίστημι	to set before or in front
προκαλέω	to call forth
προκαταγγέλλω	to announce or declare beforehand
προκαταρτίζω	to complete beforehand
πρόκειμαι	to be set before one
προκεχειρ̂οτονημενοις	
προκηρύσσω	to proclaim by herald, proclaim publicly
προκοπή	progress on a journey
προκόπτω	to cut away in front
πρόκριμα	prejudgment, prejudice
προκυρόομαι	to be confirmed before
προλαμβάνω	to take or receive before
προλέγω	
προλημφθῇ	
προμαρτύρομαι	to witness beforehand
προμελετάω	to practise beforehand
προμεριμνάω	to take thought before
προνο	
προνοέω	to perceive before, foresee
πρόνοια	foresight, foreknowledge
πρόξ	the roe-deer
προοράω	to see before one, see what is just before the eyes
προορίζω	to determine beforehand, to predetermine, pre-ordain
προπάσχω	to suffer first or beforehand
προπάτωρ	the first founder of a family, forefather
προπέμπω	to send before, send on or forward
προπετής	falling forwards, inclined forward
προπορεύομαι	to go before or forward
ΠΡΟΣ	
πρός	motion from
προσάββατον	the fore-sabbath, eve of the sabbath
προσαγορεύω	to address, greet, accost
προσάγω	to bring to or upon
προσαγωγή	a bringing to or up to, a bringing up
προσαιτέω	to ask besides
προσαίτης	a beggar
προσαναβαίνω	to go up or mount besides
προσαναπληρόω	to fill up or replenish besides
προσανατίθεμαι	to take an additional burthen on oneself
προσαπειλέω	to threaten besides
προσδαπανάω	to spend besides
προσδέχομαι	to receive favourably, accept
προσδέω	
προσδοκάω	to expect
προσδοκέω	to be thought besides
προσδοκία	a looking for, expectation
προσεάω	to suffer to go further
προσελθόιτες	
πρόσ-ἔπειμι	
πρόσ-ἐπιέννυμι	
προσεργάζομαι	to work in addition to
προσέρχομαι	to come or go to
προσεύξα	
προσευχή	prayer
προσεύχομαι	to offer prayers or vows
πρόσ-ἐφέζομαι	
πρόσ-ἐφίημι	
προσέχω	to hold to, offer
προσῆλθαν	
προσηλόω	to nail, pin
προσήλυτος	one that has arrived at
πρόσκαιρος	for a season, temporary
προσκαλέω	to call to, call on, summon
προσκαρτερέω	to persist obstinately in
προσκαρτέρησις	perseverance
προσκεφάλαιον	a cushion for the head, pillow
προσκληρόομαι	to be attached to, keep company with
προσκλίνω	to make to lean against, put against
πρόσκλισις	inclination, proclivity
προσκολλάω	to glue on or to
πρόσκομμα	a stumble, stumbling
προσκοπή	a looking out for
προσκόπτω	to strike
προσκυλίνδω	to roll to, roll up
πρόσ-κυνάω	
προσκυνέω	to make obeisance
προσκύνησις	adoration, obeisance, a salam
προσκυνητής	a worshipper
προσκυνητός	
προσλαλέω	to talk to or with
προσλαμβάνω	to take or receive besides, get over and above
πρόσλημψις	
προσμένω	to bide or wait still longer
προσορμίζομαι	to come to anchor near
προσοφείλω	to owe besides or still
πρόσπεινος	hungry, a-hungered
προσπήγνυμι	to fix to or on
προσπίπτω	to fall upon, strike against
προσποιέω	to make over to
πρόσ-πορεύω	
προσρήγνυμι	to dash or beat against
προστάσσω	to place or post at
προστάτις	
προστίθημι	to put to
προστρέχω	to run to or towards, come to
προσφάγιον	anything eaten with other food
πρόσφατος	lately slain, fresh-slain
προσφέρω	to bring to or upon, apply to
πρόσφημι	to speak to, address
προσφιλής	dear, beloved
προσφορά	a bringing to, applying, application
προσφωνέω	to call or speak to, address, accost
πρόσχυσις	a sprinkling
προσψαύω	to touch upon, touch
πρόσω	forwards, onwards, further
πρόσωθεν	from afar
προσωπολημπτεῖτε	
προσωπολήμπτης	
προσωπολημψία	
προσωπολημψίαις	
πρόσωπον	the face, visage, countenance
προσώχθισα	
προσώχθισεν	
προτείνω	to stretch out before, hold before
πρότερος	prae.
προτρέπω	to urge forwards
προτρέχω	to run forward
προυπάρχω	to be beforehand in
πρόφασις	that which is alleged as the cause, an allegation, plea
προφέρω	to bring before
προφητεία	the gift of interpreting the will of the gods
προφητεύω	to be an interpreter
προφήτης	one who speaks for a God and interprets his will
προφητικός	oracular
προφῆτις	
προφθάνω	to outrun, anticipate
προχειρίζω	to put into the hand, have ready at hand
Πρόχορον	
πρύμνα	the hindmost part of a ship, the stern, poop
πρωί	early in the day, early, at morn
πρωινός	
πρώιος	early
πρῷρα	the forepart of a ship, a ship's head, prow, bow
πρωτεύω	to be the first, hold the first place
πρωτοκαθεδρία	the first seat
πρωτοκλισία	the first seat at table
ΠΡΩΤΟΝ	
πρῶτος	
πρωτοστάτης	one who stands first, on the right, the right-hand man
πρωτοτόκια	the rights of the first-born, birthright
πρωτοτόκος	bearing her first-born
πρωτότοκος	first-born
πρώτως	
πταίω	to make to stumble or fall
πτέρνα	the heel
πτέρνη	
πτερύγιον	the wing
πτέρυξ	the wing
πτηνός	feathered, winged
πτοέω	to terrify, scare
πτόησις	passionate excitement
Πτολεμαίς	Acre
πτύον	a winnowing-shovel or fan
πτύρομαι	to be scared or frightened
πτύσμα	
πτύσσω	to fold
πτύω	to spit out or up
πτω	
πτῶμα	a fall
πτῶσις	a falling, fall
πτωχεία	beggary, mendacity
πτωχεύω	to be a beggar, go begging, beg
πτωχός	one who crouches or cringes, a beggar
πυγμή	a fist
πύθω	to make rot, to rot
πύθωνα	
πυκνός	close, compact
πυκνος	
πυκτεύω	to practise boxing, box, spar
πύλη	one wing of a pair of double gates
Πύλης	
πυλόω	to furnish with gates
πυλών	a gateway, gate-house
πυνθάνομαι	to learn by hearsay or by inquiry
πῦρ	fire
πύργος	a tower
πυρέσσω	to be ill of a fever
πυρετός	burning heat, fiery heat
πυρή	any place where fire is kindled
πύρινος	of fire, fiery, hot
πυρόε	
πυρός	wheat
πυρόω	to burn with fire, burn up
πυρράζω	to be fiery red
Πύρρος	
πυρρός	flame-coloured, yellowish-red
πύρωσις	
πω	up to this time, yet
πωλέομαι	to go up and down, go to and fro
πωλέω	to exchange or barter
πῶλος	a foal, young horse
πώποτε	ever yet
πωρόω	to petrify, turn into stone
πώρωσις	petrifaction
πως	in any way, at all, by any means
πῶς	how? in what way or manner?
Ῥαάβ	
Ῥαββεί	
ῥαββεί	
Ῥαββουνεί	
ῥαβδίζειν	
ῥάβδος	a rod, wand, stick, switch
ῥάβδουχος	
ῥαβδοῦχος	one who carries a rod or staff of office
Ῥαγαύ	
ῥᾳδιούργημα	a reckless act, crime
ῥᾳδιουργία	ease in doing, facility
ράζοντες	
ῥακά	
ῥάκος	a ragged garment, a rag
ῥακόω	to tear in strips
Ῥαμά	
ῥαντίζω	to purify
ῥαντισμός	a sprinkling
ράντοις	
ῥαπίζω	to strike with a stick, to cudgel, flog, bastinado
ῥάπισμα	a stroke, a slap on the face
ῥαφίς	a needle
Ῥαχάβ	
Ῥαχήλ	
Ῥεβέκκα	
ῥεδῶν	
ῤεραντισμενοι	
ῤεραντισμένον	
ῥέω	to flow, run, stream, gush
Ῥήγιον	
ῥῆγμα	a breakage, fracture
ῥήγνυμι	to break, break asunder or in pieces, rend, shiver, shatter
ῥῆμα	that which is said or spoken, a word, saying
ῥῆξις	a breaking, bursting
Ῥησά	
ῥἤσσει	
ῥητός	stated, specified
ῥήτωρ	a public speaker, pleader
ριε	
ῥίζα	a root
ῥιζόω	to make to strike root
ριον	
ρίου	
ῥιπή	the swing or force with which anything is thrown
ῥιπίζω	to fan
ῥίπτω	to throw, cast, hurl
ρίς	
ῥίψαν	
Ῥοβοάμ	
Ῥόδη	
ῥόδον	the rose
Ῥόδος	Rhodes
ῥοιζηδόν	
Ῥομφά	
ῥομφαία	a large sword, scymitar
Ῥουβήν	
Ῥούθ	
Ῥοῦφος	
ρ́ς	
ῥύμη	the force, swing, rush
ῥύομαι	to draw to oneself
ῥυπανθήτω	
ῥυπαρία	dirt, filth: sordidness
ῥυπαρός	foul, filthy, dirty
ῥύπον	
ῥύπος	dirt, filth, dirtiness, uncleanness
ῥύσις	a flowing, flow
ῥῦσις	
ῥυτίς	a fold or pucker
ρώθη	
Ῥωμαικός	Roman, a Roman
Ῥωμαῖος	
ΡΩΜΑΙΟΥΣ	
Ῥωμαιστί	in Latin
Ῥώμη	
ῥώμη	bodily strength, strength, might
ῥώννυμι	to strengthen, make strong and mighty
ρώτησεν	
σαβαχθανεί	
σαβαώθ	hosts, armies
σάββασιν	
σάββατα	
σαββατισμός	
Σάββατον	sabbath
σάββατον	
σαββάτου	
σαββάτῳ	
σαββάτων	
σαγήνη	a large drag-net
Σαδδουκαῖοι	Sadducees
Σαδώκ	
σαι	
σαίνω	to wag the tail, fawn
σάκκος	a coarse hair-cloth, sackcloth
Σαλαθιήλ	
Σαλαμίς	Salamis
Σαλείμ	
σαλεύω	to cause to rock, make to oscillate, shake to and fro
Σαλήμ	
Σαλμών	
Σαλμώνην	
σαλός	
σάλος	any unsteady, tossing motion
σάλπιγξ	a war-trumpet, trump
σαλπίζω	to sound the trumpet, give signal by trumpet
σαλπιστῶν	
σαλώμη	
Σαμαρείτης	a Samaritan
Σαμαρίᾳ	
Σαμαρία	
Σαμαρίαν	
Σαμαρίας	
σαμεν	
Σαμοθρᾴκη	Samothrace
Σάμος	Samos
Σαμουήλ	
Σαμψών	
σαν	
σανδάλιον	
σανίς	a board, plank
Σαούλ	
σαπρός	rotten, putrid
Σαπφείρῃ	
σάπφειρος	the sapphire
σαργάνη	a plait, braid
Σάρδεις	Sardes
σάρδιον	the Sardian stone, carnelian
σαρδόνυξ	the sardonyx
Σάρεπτα	
σαρκα	
σαρκάζω	to tear flesh like dogs
σαρκάω	
σαρκικός	fleshly, sensual
σάρκινος	of flesh, in the flesh
σαρκίς	
σαρκόω	to make to look like flesh
σάρξ	flesh
σαρόω	to sweep clean
Σάρρᾳ	
Σάρρα	
Σάρρας	
Σαρῶνα	
σας	
Σατάν	Satan
Σατανᾷ	
Σατανᾶν	
σατε	
σάτον	sextarii
σαῦλος	swaggering, straddling
σαυτοῦ	
σβείαν	
σβέννυμι	to quench, put out
σβέσις	
σβυτέροις	
σεβάζομαι	to be afraid of
σέβασμα	an object of awe or worship
σεβαστός	reverenced, august
σέβομαι	to feel awe or fear
σειροῖς	
σεισμός	a shaking, shock
σείω	to shake, move to and fro
Σέκουνδος	
Σελευκίαν	
σελήνη	the moon
σεληνιάζομαι	to be moonstruck
Σεμεείν	
σεμίδαλις	the finest wheaten flour
σεμνόν	
σεμνός	revered, august, holy, awful
σεμνότης	gravity, solemnity, dignity, majesty
Σέργιος	
Σερούχ	
σεύω	to put in quick motion: to drive, hunt, chase away
ΣΈφανον	
Σήθ	
Σήμ	
σήμ	
σημαίνω	to shew by a sign, indicate, make known, point out
σημεῖον	a sign, a mark, token
σημειόω	to mark
σήμερον	to-day
σημικίνθιον	kerchief
σημῖΟν	
σήπω	to make rotten
σηρικός	Seric, silken
σής	a moth
σητε	
σητέ	
σητόβρωτος	eaten by moths
σθαι	
σθενώσει	
σιαγών	the jawbone, jaw
σιγάζω	to bid
σιγάω	to be silent or still, to keep silence
σιγή	silence
σιδήρεος	made of iron or steel, iron
σίδηρον	
σίδηρος	iron
σιδηρόω	to overlay with iron
Σιδών	Sidon
σικάριος	
σικαστήν	
σίκερα	a fermented liquor
Σίλᾳ	
Σίλαν	
Σίλας	
Σιλουανός	
ΣΙΛΟΥΑΝΟΣ	
Σιλωάμ	
σιμικίνθιον	
Σῖμος	flat-nose
σιμόω	to turn up the nose
ΣΙΜΩΝ	
Σίμων	
Σίμωνι'	
σίν	
σιν	
σίναπι	mustard
σινάς	
σινδόνη	
σινδών	sindon, a fine cloth
σινιάζω	to sift, winnow
σιρικόν	silk
σιτευτός	fed up, fatted
σιτίον	grain, corn: food made from grain, bread
σιτιστής	
σιτιστός	
σιτομέτριον	a measured portion of corn
σῖτος	corn, grain
σῖτου	
Σιών	
σιωπάω	to be silent
σιωπή	silence
σιώπησις	
σκανδαλίζω	to make to stumble, give offence to
σκάνδαλον	a trap or snare laid for an enemy
σκάνδαλος	
σκάπτω	to dig, delve
σκάφη	anything dug or scooped out
σκάφος	
σκέλος	the leg
σκέπασμα	a covering, shelter
σκευάζω	to prepare, make ready
σκευή	equipment, attire, apparel, dress
σκεῦος	a vessel or implement of any kind
σκῃ	
σκηνάω	to dwell, live
σκηνέω	to be or dwell in a tent, to be encamped
σκηνή	a covered place, a tent
σκηνοπηγία	a setting up of tents: the Feast of Tents or Tabernacles
σκηνοποιός	tent-making
σκῆνος	the body
σκηνόω	to pitch tents, encamp
σκήνωμα	quarters
σκήνωσις	
σκιά	a shadow
σκιάζω	to overshadow, shade
σκιάς	any thing serving as a shade, a canopy, pavilion
σκιάω	to overshadow
σκιρτάω	to spring, leap, bound
σκληροκαρδία	hardness of heart
σκληρός	hard
σκληρότης	hardness
σκληροτράχηλος	stiff-necked
σκληρύνω	to harden
σκολιός	curved, winding, twisted, tangled
σκόλοψ	
σκοπέω	to look at or after
σκοπή	
σκοπός	one that watches, one that looks after
σκορπίζω	to scatter, disperse
σκορπίον	
σκορπίος	a scorpion
σκοτία	darkness, gloom
σκοτίζω	to make dark
σκοτινόν	
σκότιος	dark
σκότος	darkness, gloom
σκότουξ	
σκοτόω	to make dark, to blind
σκύβαλον	dung, filth, refuse
Σκύθης	a Scythian
σκυθρωπός	angry-looking, of sad countenance, sullen
σκύλλω	to rend, mangle
σκῦλον	the arms stript off a slain enemy, spoils
σκωληκόβρωτος	eaten of worms
σκώληξ	a worm
σμαράγδινος	of smaragdus
σμάραγδος	emerald
σμικρός	
σμύρνα	myrrh
Σμύρνα	Smyrna
Σμύρνη	
σμυρνίζω	to flavour or drug with myrrh
σο	
Σόδομα	
Σοδόμοις	
Σοδόμων	
Σολομῶν	
Σολομών	
Σολομῶνα	
Σολομῶνος	
Σολομῶντος	
̓́Σονται	
σοντι	
σορός	a vessel for holding
σός	thy, thine, of thee
σοῦ	shoo! shoo!
σουδάριον	
Σουσάννα	
σοφία	skill
σοφίζω	to make wise, instruct
σοφός	skilled in any handicraft or art, cunning in his craft
σπανία	
σπάνιος	rare, scarce, scanty
σπαράσσω	to tear, rend in pieces, mangle
σπαργανόω	to wrap in swaddling-clothes, swathe
σπαταλάω	to live lewdly, to run riot
σπάω	to draw
σπεῖρα	coiled
σπειράομαι	to be coiled or folded round.
σπεῖρον	a piece of cloth
σπεῖρος	
σπείρω	to sow
σπεκουλάτωρ	speculator, one of the body-guard
σπένδω	to pour or make a drink-offering
σπέρμα	that which is sown
σπερμολόγος	picking up seeds
σπεύδω	to set a-going, to urge on, hasten, quicken
σπήλαιον	a grotto, cave, cavern
σπιλάς	a rock over which the sea dashes, a ledge of rock
σπίλον	
σπίλος	a spot, stain, blemish
σπιλόω	to stain, soil
σπλαγχνίζομαι	to feel compassion, mercy
σπλάγχνον	the inward parts
σπόγγος	a sponge
σποδός	wood-ashes, embers
σπορά	a sowing
σπορεύς	
σπόριμος	sown, to be sown, fit for sowing
σπόρος	a sowing
σπουδάζω	to make haste
σπουδαῖος	earnest, serious
σπουδή	haste, speed
στάδιον	a stade, =
στάδιος	standing firm
στάζω	to drop, let fall or shed drop by drop
σταθῆ	
στάμνος	an earthen jar for racking off wine
στασιαστής	
στάσις	a standing, the posture of standing
στατήρ	gold stater
σταυρός	an upright pale or stake
σταυρόω	to fence with pales, impalisade
σταφυλή	a bunch of grapes
στάχυς	an ear of corn
στέαρ	stiff fat, tallow, suet
στέγη	a roof
στέγος	a roof
στέγω	to cover closely, so as to keep
στεῖρα	
στεῖρος	barren
στέλλω	to set in order, to arrange, array, equip, make ready
στέμμα	a wreath, garland
στεναγμός	a sighing, groaning, moaning
στενάζω	to sigh often, sigh deeply
στενός	narrow, strait
στενοχωρέω	to straiten for room
στενοχωρία	narrowness of space: want of room
στερεός	stiff, stark, firm, solid
στερεόω	to make firm or solid
στερέωμα	a solid body, foundation
στεύητε	
Στεφανᾶ	
στέφανος	that which surrounds
Στέφανος	
στεφανόω	to be put round
στῆθος	the breast
στήκω	to stand
στηριγμός	a propping, supporting;
στηρίζω	to make fast, prop, fix, set
στήριξις	
στιβάς	a bed of straw, rushes
στίγμα	the mark of a pointed instrument, a tattoo-mark, brand
στιγμή	a spot, point
στίλβω	to glisten
στίλβων	
στοά	a roofed colonnade, piazza, cloister
στοιχείεν	
στοιχεῖον	one of a row
στοιχέω	to go in a line or row: to go in battle-order
στολάς	moving in close array
στολή	an equipment, armament
στόμα	the mouth
στόμαχος	a mouth, opening
στόν	
στόρεννυμι	
στός	
στράπτω	to lighten
στρατεία	an expedition, campaign
στράτευῃ	
στράτευμα	an expedition, campaign
στρατεύω	to serve in war, serve as a soldier, do military service, take the field, march
στρατηγέω	to be general
στρατηγός	the leader or commander of an army, a general
στρατία	an army
στρατιά	
στρατιώτης	a citizen bound to military service;
στρατολογέω	to levy soldiers
στρατόπεδον	the ground on which soldiers are encamped, a camp, encampment
στρεβλόω	to twist or strain tight
στρέφω	to turn about or aside, turn
στρηνιάω	to run riot, wax wanton
στρῆνος	wantonness
στρουθίας	
στρουθίον	
στρουθίων	
στυγητός	hated, abominated, hateful
στυγνάζω	to look gloomy, be sorrowful
στύλοι	
στύλον	
στύλος	
στωικός	of a colonnade or piazza:—
σύ	
συγγένεια	sameness of descent or family, relationship, kin
συγγενεύς	
συγγενής	born with, congenital, natural, in-born
συγγενίς	
συγκαθίζω	to make to sit together
συγκακοπαθέω	to partake in sufferings
συγκακουχέομαι	to endure adversity with
συγκαλέω	to call to council, convoke, convene
συγκαλύπτω	to cover or veil completely
συγκάμπτω	to bend together, bend the knee
συγκεράννυμι	to mix up with, commingle or blend with, temper by mixing with
συγκινέω	to stir up together
συγκλείω	to shut or coop up, hem in, enclose
συγκοινωνέω	to have a joint share of
συγκομίζω	to carry or bring together, collect
συγκρίνω	to compound
συγκύπτω	to bend forwards, stoop and lay heads together
συγκυρία	coincidence
συγχαίρω	to rejoice with, take part in joy
συγχέω	to pour together, commingle, confound
συγχράομαι	to make joint use of, avail oneself of
σύγχυσις	a commixture, confusion
συζεύγνυμι	to yoke together, couple or pair together
συζητέω	to search or examine together with
συκάζω	to pluck ripe figs
συκάμινον	the fruit of the
συκάμινος	the mulberry-tree
συκῆ	the fig-tree
συκομορέα	
σῦκον	the fruit of the
συκοφαντέω	to accuse falsely, slander, calumniate
συλαγωγέω	to carry off as booty, lead captive
συλάω	to strip off
συλλαλέω	to talk or converse with
συλλαμβάνω	to collect, gather together
συλλέγω	to collect, gather
συλλημφθέντα	
συλλημφθῆναι	
συλλήμψῃ	
συλλογίζομαι	to collect and bring at once before the mind, to compute fully, sum up
συλλυπέω	to hurt or mortify together
συμβαίνω	to stand with the feet together
συμβάλλω	to throw together, dash together
συμβασιλεύω	to rule or reign together with
συμβιβάζω	to bring together
συμβουλεύω	to advise, counsel
συμβούλιον	counsel
σύμβουλος	an adviser, counsellor
Συμεών	
συμμαρτυρέω	to bear witness with or in support of
συμμερίζω	to distribute in shares
συμμορφιζόμενος	
συμμορφόομαι	to be conformed to
σύμμορφος	conformed to
συμπαθέω	to sympathise
συμπαθής	sympathizing with
συμπάσχω	to suffer together, be affected by the same thing
συμπέμπω	to send with or at the same time
συμπίνω	to drink together, join in a drinking bout
συμπίτνω	
συμπληρόω	to help to fill
συμπνίγω	to throttle, choke, press closely
συμπορεύομαι	to go or journey together
συμπόσιον	a drinking-party, symposium
συμπόσιος	
συμφέρω	to bring together, gather, collect
σύμφημι	to assent, approve
σύμφορος	happening with, accompanying
συμφυλέτης	of the same
σύμφυτος	born with one, congenital, innate, natural, inborn, inbred
συμφύω	to make to grow together
συμφωνέω	to agree in sound, be in harmony
συμφώνησις	
συμφωνία	concord or unison of sound
σύμφωνος	agreeing in sound, in unison
συμψηφίζω	to reckon together, count up
σύν	along with, in company with, together with
συναγείρω	to gather together, assemble
συνάγνυμι	to break together, break to pieces, shiver, shatter
συνάγω	to bring together, gather together, collect, convene
συναγωγεύς	one who brings together, a convener
συναγωγή	a bringing together, uniting
συναγωγός	bringing together, uniting
συναγωνίζομαι	to contend along with, to share in a contest
συναθλέω	to strive together
συναθροίζω	to gather together, assemble
συναιρέω	to grasp or seize together, to seize at once
συναίρω	to take up together
συναιχμάλωτος	a fellow-prisoner
συνακολουθέω	to follow closely, to accompany
συναλίζω	to bring together, collect
συναλλάσσω	to bring into intercourse with, associate with
συναναβαίνω	to go up with or together
συνανάκειμαι	to recline together at table
συναναμίγιυσθαι	
συναναμίγνυμι	to mix up together
συναναπαύομαι	to take rest with others
συναντάω	to meet face to face
συνάντησις	a meeting
σύν-ἀντιλαμβάνω	
σύναξις	
συναπάγω	to lead away with
συναποθνήσκω	to die together with
συναπόλλυμι	to destroy together
συναποστέλλω	to despatch together with
συναρμολογέομαι	to be fitted or framed together
συναρπάζω	to seize and carry clean away
συνάρχω	to rule jointly with
συναυξάνω	to increase or enlarge along with or together
συνγνώμην	
σύνδεσμος	a bond of union, bond, fastening
συνδέω	to bind or tie together
συνδοξάζω	to join in approving
σύνδουλος	a fellow-slave
συνδρομή	a tumultuous concourse
συνεγείρω	to help in raising
συνέδριον	a body of men assembled in council, a council-board, council
συνεί	
συνείδησις	self-consciousness: conscience
σύν-εἶδον	
σύνειμι	
συνεισέρχομαι	to enter along with or together
συνέκδημος	a fellow-traveller
συνεκλεκτός	chosen along with
συνέπειμι	to join in attacking
σύν-ἐπιμαρτυρέω	
συνεπιτίθημι	to help in putting on
συνεργέω	to work together with, help in work, cooperate
συνεργής	
συνεργός	working together, joining or helping in work
συνέρχομαι	to go together or in company
σύν-ἐσθίω	
σύνεσις	a coming together, union
συνετός	intelligent, sagacious, wise
σύν-εὐδοκέω	
σύν-εὐωχέω	
συνεφίστημι	to set on the watch together, make attentive
συνέχυννεν	
συνζῆν	
συνζήσομεν	
συνζητεῖν	
συνζητεῖτε	
συνζητητής	
συνζητοῦντας	
συνζητοῦντες	
συνζητούντων	
σύνζυγε	
σύν-ζωοποιέω	
συνήδομαι	to rejoice together
συνήθεια	habitual intercourse, acquaintance, society, intimacy
συνῆλθαν	
συνηλικιώτης	
συνθάπτω	to bury together, join in burying
συνθλασθήσεται	
συνθλίβω	to press together, compress
συνθρύπτω	to break in pieces: to crush
συνίημι	to bring or set together
συνίουσιν	
σύν-ἱστάνω	
συνίστημι	to set together, combine, associate, unite, band together
συνίων	
συνκαθήμενοι	
συνκαθήμενος	
συνκαταβάντες	
συνκατάθεσις	
συνκατατεθειμένος	
συνκατεψηφίσθη	
συνκληρονόμα	
συνκληρονόμοι	
συνκληρονόμων	
συνκοινωνός	
συνκοινωνούς	
σύν-λέγω	
συνμαθηταῖς	
συνμέτοχα	
συνμέτοχοι	
Συνμιμηταί	
συνοδεύω	to travel in company
συνοδία	a journey in company
σύνοιδα	to share in knowledge, be cognisant of
συνοικέω	to dwell together
συνοικοδομέω	to build together
συνομιλέω	to converse with
συνομορέω	to abut upon
συνοχέομαι	to travel together in a chariot
συνοχεύς	
συνοχή	a being held together
συνόχωκα	to be held together
συνπαραγενόμενοι	
συνπαρακληθῆναι	
συνπαραλαβεῖν	
συνπαραλαβόντες	
συνπαραλαβών	
συνπαραλαμβάνειν	
συνπαρόντες	
συνπεριλαβών	
συνπολῖται	
συνπρεσβύτερος	
συνσταυρωθέντες	
συνσταυρωθέντος	
συνστενάζει	
συνστοιχεῖ	
συνστρατιώτῃ	
συνστρατιώτην	
συνσχηματίζεσθε	
συνσχηματιζόμενοι	
σύνσωμα	
συντάσσω	to put in order together
συντέλεια	a joint payment, joint contribution for public burdens
συντελέω	to bring quite to an end, complete, accomplish
συντελής	joining in payment, a contributor
συντέμνω	to cut in pieces: to cut down, cut short
συντετρίφθαι	
συντηρέω	to preserve together
συντίθημι	to put together
σύντομος	a short
συντρέχω	to run together so as to meet, to encounter
συντρίβω	to rub together
σύντριμμα	
σύντριψις	
σύντροφος	brought up together with
συντυγχάνω	to meet with, fall in with
Συντύχην	
συνυποκρίνομαι	to play a part along with
συνυπουργέω	to cooperate with
σύν-φαγεῖν	
συνχύννεται	
σύνψυχοι	
συνωδίνω	to be in travail together
συνωμοσία	a being leagued by oath, conspiracy
Συράκουσα	
Συράκουσαι	Syracuse
Συρία	Syria
Σύριος	of or from Syria
σύρον	
σύρος	
Σύρος	a Syrian
Σῦρος	Syros
Συροφοινίκισσα	
Σύρτις	the Syrtis
σύρω	to draw, drag
συσπαράσσω	to tear in pieces
σύσσημον	a fixed sign or signal
συστατικός	introductory
συσταυρόομαι	to be crucified with
συστέλλω	to draw together, draw in: to shorten sail
συστρέφω	to twist up into a ball
συστροφή	a dense mass
Συχάρ	
Συχέμ	
σφαγεύς	a slayer, butcher
σφαγή	slaughter, butchery
σφάγιον	a victim, offering
σφάγιος	slaying, slaughtering
σφάζω	to slay, slaughter
σφημία	
σφόδρα	very, very much, exceedingly, violently
σφοδρός	vehement, violent, excessive
σφραγίζω	to seal
σφραγίς	a seal, signet, seal-ring
σφυδρόν	
σφυπίδας	
σφυρίς	
σφυρίσων	
σχάζω	to let loose
σχε	
σχεδόν	close, near, hard by, nigh
σχῆμα	form, figure, appearance
σχίζω	to split, cleave
σχίσις	a cleaving, cleavage, parting, division
σχίσμα	a cleft, a rent
σχοινίον	a cord
σχοινίων	the sedge-bird
σχολάζω	to have leisure or spare time, to be at leisure
σχολή	spare time, leisure, rest, ease
σώζω	to save, keep
σῶμα	the body
σωματικός	of or for the body, bodily
Σώπατρος	
σώρευσις	
σωρεύω	to heap
Σωσθένην	
Σωσθένης	
Σωσίπατρος	
σωτήρ	a saviour, deliverer, preserver
σωτηρία	a saving, deliverance, preservation, safety
σωτήριος	saving, delivering
σωφρονέω	to be sound of mind
σωφρονισμός	
σωφροσύνη	soundness of mind, moderation, discretion
σωφρόσυνος	
σώφρων	of sound mind
τα	
Ταβειθά	
Ταβερνῶν	
τάγμα	that which has been ordered or arranged
ται	
ΤΑΙΣ	
τακτός	ordered, prescribed
ταλαιπωρέω	to go through hard labour, to suffer hardship or distress
ταλαιπωρία	hard work, hardship, suffering, distress
ταλαίπωρος	suffering, miserable
ταλαντιαῖος	worth a talent
τάλαντον	a balance
Ταλειθά	
ταμεῖον	
τάξις	an arranging
ταπεινός	low
ταπεινοφροσύνη	lowliness, humility
ταπεινόφρων	lowly in mind
ταπεινόω	to lower
ταπείνωσις	humiliation, abasement, defeat
ταράσσω	to stir, stir up, trouble
τάραχος	
Ταρσέα	
Ταρσεύς	
Ταρσός	
ταρταρόω	
τας	
τάσσω	to arrange, put in order
ταῦ	
ταῦρος	a bull
ΤΑΥΤΑ	
ΤΑΥΤΑΙΣ	
ταύτῃ	in this way.
ταφή	burial
τάφος	
τάχα	quickly, presently, forthwith
τάχειον	
ταχέως	
ταχινός	
τάχιστος	
τάχος	swiftness, speed, fleetness, velocity
ταχύς	quick, swift, fleet
τε	and
τέθηπα	to be astonished, astounded, amazed
τειχέω	to build walls
τεῖχος	a wall
τεκμήριον	a sure signs. or token
τεκνίον	a little
τεκνογονέω	to bear young, bear children
τεκνογονία	child-bearing
τέκνον	that which is borne or born, a child
τεκνόω	to furnish or stock with children
τέκτων	any worker in wood
τέλειος	having reached its end, finished, complete
τελειότης	
τελειόω	to make perfect, complete
τελειωσάντΝ	
τελείωσις	accomplishment, fulfilment
τελειωτής	an accomplisher, finisher
τέλεσις	
τελεσφορέω	to bring fruit to perfection
τελευτάω	to complete, finish, accomplish
τελευτή	a finishing, completion, accomplishment
τελέω	to complete, fulfil, accomplish
τέλλω	to make to arise, accomplish
τέλος	the fulfilment or completion
τελωνέω	to be a tax-gatherer
τελώνης	a farmer or collector of the taxes
τελώνιον	a custom-house
τέξις	
τέρας	a sign, wonder, marvel
τέρος	
Τέρτιος	
Τέρτυλλος	
Τερτύλλου	
τες	
τεσσαράκοντα	forty
τέσσαρες	four
τεσσαρεσκαιδέκατος	fourteenth
τεσσερακονταετῆ	
τεσσερακονταετής	
τετάπακται	
τεταρταῖος	on the fourth day
τέταρτος	fourth
τετήρηκαν	
τετραάρχης	
τετραάρχου	
τετρααρχοῦντος	
τετράγωνος	with four equal angles, rectangular or square
τετράδιον	
τετρακισχίλιοι	four thousand
τετρακόσιοι	four hundred
τετράμηνος	of four months, lasting four months
τετραπλόος	fourfold
τετράποδος	
τετράπους	four-footed
τέτυχεν	
τεφρώσας	
τέχνη	art, skill, craft in work, cunning of hand
τεχνίτης	an artificer, artisan, craftsman, skilled workman
τῆ	take
τή	
τῇ	here, there
τῇδε	here, thus
τήκω	to melt, melt down
τηλαυγής	far-shining, far-beaming
τηλικοῦτος	
την	
τῆξ	
τηρέω	to watch over, protect, guard
τήρησις	a watching, keeping, guarding
τηρός	a warden, guard
ΤΗΣ	
τῆσΚιλικιας	
τίαν	
Τιβεριάδος	
Τιβέριος	
τίθημι	to set, put, place
τίκτω	to bring into the world
τικῶς	
τίλλω	to pluck or pull out
Τίμαιος	
τιμαῖος	
τιμάω	to pay honour to, hold in honour, to honour, revere, reverence
τιμή	that which is paid in token of worth or value
τίμησις	a valuation
τίμιος	valued
τιμιότης	worth, value, preciousness
Τιμό	
ΤΙΜΟΘΕΟΝ	
Τιμόθεος	
ΤΙΜΟΘΕΟΣ	
Τίμων	
τιμωρέω	to help, aid, succour
τιμωρία	help, aid, assistance, succour
τιμωρός	upholding honour;
τίνω	to pay a price
τίς	who? which?
τις	any one, any thing, some one, some thing;
τίσις	payment by way of return or recompense, retribution, vengeance
τίτας	
τίτης	avenger
Τιτίου	
τίτλος	
ΤΙΤΟΝ	
Τίτος	
τίω	to pay honour to
τ̂Ν	
το	
ΤΟ	
τοι	let me tell you, surely, verily
τοιγάρ	so then, wherefore, therefore, accordingly
Τοιγαροῖν	
τοίνυν	therefore, accordingly
τοῖξ	
τοιόσδε	such a
τοιουΤοις	
τοιοῦτος	such as this
τοις	
τοῖχος	the wall of a house or court
τόκος	a bringing forth, childbirth, parturition
τόλεμοι	
τολήν	
τολμάω	to undertake, take heart
τολμηρός	hardihood
τολμητής	a bold, venturous man
τολμητός	to be ventured;
τολοῦτον	
τομός	cutting
τον	
ΤΟΝ	
τόξον	a bow
τοπάζιον	
τόπος	a place
τος	
τοσοῦτος	so large, so tall
τότε	at that time, then
ΤΟΤΕ	
τούξ	
τους	
ΤΟΥΤΟ	
τρ	
τράγος	a he-goat
τράγω	
τράπεζα	four-legged a table
τραπεζείταις	
τραῦμα	a wound, hurt
τραυματίζω	to wound
τραχηλίζω	of wrestlers
τράχηλος	the neck, throat
τραχύς	rugged, rough
τραχών	a rugged, stony tract
τρεῖς	
τρέμω	to tremble or fear to
τρέφος	
τρέφω	to thicken or congeal
τρέχω	to run
τρέω	to flee from fear, flee away
τρῆμα	a perforation, hole, aperture, orifice
τρί	
τρία	
τριάκοντα	thirty
τριακόσιοι	three hundred
τριάξω	to vanquish
τρίβολος	a caltrop
τρίβος	a worn or beaten track, the high road, highway
τριετία	
τρίζω	to utter a shrill cry, to scream, cry
τρίμηνος	of three months
τρίς	thrice, three times
τρίστεγος	of or with three stories
τρισχίλιοι	three thousand
τρίτος	the third
τρίχα	threefold, in three parts
τρίχινος	of hair
τρόμος	a trembling, quaking, quivering
τρον	
τροπέω	to turn
τροπή	a turn, turning
τρόπος	a turn, direction, course, way
τροποφορέω	to bear with
τροφεύς	one who rears or brings up, a foster-father
τροφή	nourishment, food, victuals
τρόφιμος	nourishing
τροφός	a feeder, rearer, nurse
τροχιά	the round of a wheel
τροχιός	round
τροχός	anything that runs round
τρύβλιον	a cup, bowl
τρυγάω	to gather in
τρυγών	the turtle-dove
τρυμαλιά	a hole
Τρύφαιναν	
τρυφάω	to live softly, delicately, luxuriously, to fare sumptuously
τρυφή	softness, delicacy, daintiness
Τρῳάς	Trojan
τρώγω	to gnaw, nibble, munch
τυγχάνω	to hit
τυμπανίζω	to beat a drum
τυπικός	
τύπον	
τύπος	a blow
τυπόω	to form, mould, model
τύπτω	to beat, strike, smite
Τύραννος	
Τύρης	
τυρίον	
Τύριος	of Tyre, Tyrian
Τύρος	Tyre
τυφλός	blind
τυφλόω	to blind, make blind
τυφόμσνον	
τυφόω	to wrap in smoke;
τυφωνικός	
Τύχικον	
Τύχικος	
τυχόν	
τύχος	
τῷ	therefore, in this wise, thereupon
των	
ΤΩΝ	
τῶς	
ὕ	
ὐ	
Ύ	
ὑ	
ὑακίνθινος	hyacinthine
ὑάκινθος	the hyacinth
ὑάλινος	of crystal or glass
ὕαλος	a clear, transparent stone
ὑβρίζω	to wax wanton, run riot
ὕβρις	wantonness, wanton violence or insolence
ὑβριστής	a violent, overbearing person, a wanton, insolent man
ὑγιαίνω	to be sound, healthy
ὑγιής	sound, healthy, hearty, sound in
ὑγρός	wet, moist, running, fluid
ὑδατόω	to make watery
ὕδης	
ὑδρία	a water-pot, pitcher, urn
ὕδριος	
ὑδροποτέω	to drink water
ὑδρωπικός	dropsical
ὕδωρ	water
ὑετός	rain
υἱοθεσία	adoption as a son
υιόν	
υἱόξ	
υἱός	A son
ὑλάω	to howl, bark, bay
ὕλη	forest-trees
Ὑμέναιος	
ὑμέναιος	hymenaeus, the wedding or bridal song
ὑμέτερος	your, yours
ὑμιν'	
υμῖν	
ὑμνέω	to sing, laud, sing of
ὕμνος	a hymn, festive song or ode, in praise
ὑμός	your
ὐμῶν	
ὑμών	
υμῶν	
ὔν	
ὑπάγω	to lead or bring under
ὑπακοή	obedience
ὑπακούω	to listen, hearken, give ear
ὕπανδρος	under a man, subject to him, married
ὑπαντάω	to come or go to meet
ὑπάντησις	
ὑπάρ	
ὕπαρξις	
ὕπαρχος	commanding under
ὑπάρχω	to begin, make a beginning
ὑπείκω	to retire, withdraw, depart
ὑπεναντίος	set over against, meeting
ὑπέρ	over, above, w. gen, over, beyond, w. acc.
ὑπεραίρω	to lift or raise up over
ὑπέρακμος	past the bloom of youth
ὑπεράνω	over, above
ὑπεραυξάνω	to increase above measure
ὑπερβαίνω	to step over, mount, scale
ὑπερβαλλόντως	exceedingly
ὑπερβάλλω	to throw over or beyond a mark, to overshoot
ὑπερβολή	a throwing beyond
ὑπέρ-εἶδον	
ὑπερέκεινα	on yon side, beyond
ὑπερεκπερισσοῦ	super-abundantly
ὑπερεκτείνω	to stretch beyond measure
ὑπερεκχυννόμενον	
ὑπερεντυγχάνω	to intercede
ὑπερέχω	to hold
ὑπερηφανία	arrogance, disdain
ὑπερήφανος	overweening, arrogant, haughty
ὑπερλίαν	exceedingly, beyond all doubt
ὑπερνικάω	to be more than conqueror
ὑπερο	
ὑπέρογκος	of excessive bulk, swollen to a great size
ὑπεροχή	a projection, an eminence
ὑπερπερισσεύομαι	to abound more and more
ὑπερπερισσῶς	
ὑπερπλεονάζω	to abound exceedingly
ὑπερυψόω	to exalt exceedingly
ὑπερφρονέω	to be over-proud, to have high thoughts
ὑπερῷον	the upper part of the house, the upper story or upper rooms
ὑπερῷος	being above
ὑπέχω	to hold or put under
ὑπήκοος	
ὑπήκους	giving ear, listening to
ὑπηρέτης	an under-rower, under-seaman
ὕπνον	
ὕπνος	sleep, slumber
ὑπνόω	to put to sleep
υπό	
υΠό	
ὑπό	from under, by, c. gen. under, c. dat., towards c. acc.
ὑπο	
ὑπό-ἀρετάω	
ὑποβάλλω	to throw, put or lay under
ὑπογραμμός	
ὑπόδειγμα	a token, mark
ὑποδείκνυμι	to shew secretly
ὑποδέχομαι	to receive beneath
ὑποδέω	to bind or fasten under
ὑπόδημα	a sole bound under the foot with straps, a sandal
ὑπόδημον	
ὑπόδικος	brought to trial or liable to be tried
ὑποζύγιον	a beast for the yoke, a beast of burden
ὑποζώννυμι	to undergird
ὑπό-ἠρετέω	
ὑποκάτω	below, under
ὑποκρίνομαι	to reply, make answer, answer
ὑπόκρισις	a reply, answer
Ὑποκριται	
ὑποκριτής	an interpreter or expounder
ὑπολαμβάνω	to take up by getting under
ὑπολείπω	to leave remaining
ὑπολήνιον	the vessel under a press
ὑπόλιμμα	
ὑπομένω	to stay behind, survive
ὑπομιμνήσκω	to remind
ὑπόμνησις	a reminding
ὑπομονή	a remaining behind
ὑπονοέω	to think secretly, suspect
ὑπόνοια	a hidden thought
ὑποπλέω	to sail under
ὑποπνέω	to blow gently
ὑποπόδιον	a footstool
ὑπόστασις	that which settles at the bottom, sediment
ὑποστέλλω	to draw in
ὑποστολή	a shrinking back, evasion
ὑπό-στόρεννυμι	
ὑποστρέφω	to turn round about, turn back
ὑποταγή	subordination, subjection, submission
ὑποτάσσω	to place or arrange under
ὑποτίθημι	to place under
ὑποτρέχω	to run in under
ὑποτύπωσις	an outline, pattern
ὑποφέρω	to carry away under
ὑποχωρέω	to go back, retire, recoil
ὑπωπιάζω	to strike
ὗς	the wild swine
ὕσατος	
ὕσσωπον	
ὕσσωπος	hyssop
ὑστέρα	the womb
ὑστερέω	to be behind or later, come late
ὑστέρημα	deficiency, need, want
ὑστέρησις	
ὕστερον	
ὕστερος	latter, last
ὑτό	
ὑφ̓	
ὑφαντός	woven
ὑφή	a web
ὑφίημι	to let down
ὑφίστημι	to place or set under
ὑψηλός	high, lofty, high-raised
ὑψηλοφρονέω	to be high-minded
ὕψιστος	highest, loftiest
Ὕψιστος	
ὕψος	height
ὑψόω	to lift high, raise up
ὑψωθήση	
ὕψωμα	
ὕψωσις	
φαγεῖν	to eat, devour
φάγος	
φάγων	
φαίνω	to bring to light, make to appear
φαλαίαν	
Φάλεκ	
φανεράσω	
φανερός	open to sight, visible, manifest, evident
φανερόω	to make manifest
φανέρωσις	
φανή	a torch:—a torch-procession
φανός	
Φανουήλ	
φαντάζομαι	to become visible, appear, shew oneself
φαντασία	imagination, the power by which an object is presented
φάντασμα	an appearance, phantasm, phantom
φάος	light, daylight
φάραγξ	a cleft or chasm
Φαραώ	
Φαρές	
Φαρισαῖος	a Pharisee, Separatist
φαρμακάω	to suffer from the effect of poison, to be ill or distraught
φαρμακίᾳ	
φαρμακία	
φάρμακον	a drug, medicine
φαρμακός	a poisoner, sorcerer, magician
φάρμακος	
φαρμακόω	to endue with healing power
φάσις	
φάσκω	to say, affirm, assert
φάτνη	a manger, crib, feeding-trough
φαῦλος	easy, slight
φέγγος	light, splendour, lustre
φείδομαι	to spare
φειδομένως	
φελόνην	
φέρω	to bear
φεύγω	to flee, take flight, run away
φεύζω	to cry
Φήλικα	
Φήλικι	
Φήλικος	
Φῆλιξ	
φήμη	a voice from heaven, a prophetic voice
φημί	to declare, make known
φῆμις	speech, talk
Φῆστε	
Φῆστον	
Φῆστος	
Φήστου	
Φήστῳ	
φθάνω	to come or do first or before
φθαρτός	perishable
φθέγγομαι	to utter a sound or voice
φθείρω	to ruin, waste, spoil, destroy
φθινοπωρινός	
φθόγγος	any clear, distinct sound
φθονέω	to bear ill-will or malice, bear a grudge, be envious or jealous
φθόνος	ill-will, envy, jealousy
φθορά	destruction, ruin, perdition
φθορεύς	
φιάλη	a broad, flat vessel, a bowl
φιάλλω	to undertake, set about
φίας	
φιλάγαθος	
φιλαδελφία	brotherly love
φιλάδελφος	loving one's brother or sister, brotherly, sisterly
φίλανδρος	loving men
φιλανθρωπία	humanity, benevolence, kindliness
φιλάνθρωπος	loving mankind, humane, benevolent, kindly
φίλαξον	
φιλαργυρία	love of money, covetousness
φιλάργυρος	fond of money, covetous
φίλαυτος	loving oneself
φιλέω	to love, regard with affection
φιλήδονος	fond of pleasure
φίλημα	a kiss
ΦΙΛΗΜΟΝΑ	
Φιλήμων	
Φίλητος	
φιλία	friendly love, affection, friendship
φίλιος	of or from a friend, friendly
Φιλιππήσιοι	
ΦΙΛΙΠΠΗΣΙΟΥΣ	
Φίλιππος	
φιλόθεος	loving God, pious
φιλόλογος	fond of speaking
φιλονεικία	love of strife, eager rivalry, contentiousness, party-spirit
φιλόνεικος	fond of strife, eager for strife, contentious
φιλοξενία	hospitality
φιλόξενος	loving strangers, hospitable
φιλοπρωτεύω	to strive to be first
φῖλος	
φίλος	loved, beloved, dear
φιλοσοφία	love of knowledge and wisdom, pursuit thereof, speculation, study
φιλόσοφος	a lover of wisdom
φιλόστοργος	loving tenderly, affectionate
φιλότεκνος	loving one's children or offspring
φιλοτιμέομαι	to love or seek after honour, to be ambitious, emulous, jealous
φιλόφρων	kindly minded, kindly, friendly, affable
φίλων	
φιμός	a muzzle
φιμόω	to muzzle, shut up as with a muzzle
φίμωσις	
Φλέγων	
φλογίζω	to set on fire, burn, burn up
φλογίς	
φλόξ	a flame
φλυαρέω	to talk nonsense, play the fool
φλύαρος	silly talk, foolery, nonsense
φοβερός	fearful
φοβέω	to put to flight
φόβηθρα	
φόβος	flight
φοί	
φοιβάω	to cleanse, purify
Φοίβη	
φοῖβος	bright, radiant
Φοινίκη	
Φοῖνιξ	a Phoenician
φοῖνιξ	a purple-red, purple or crimson
φονάω	to be athirst for blood, to be murderous
φονεύς	a murderer, slayer, homicide
φονεύω	to murder, kill, slay
φόνος	murder, homicide, slaughter
φορά	a carrying
φορέσωμεν	
φορεύς	a bearer, carrier
φορέω	to bear or carry constantly, to be used to carry
φόρον	
φόρος	that which is brought in, tribute
φορός	bringing on one's way, forwarding
φορτίζω	to load
φορτίον	a load, burden
Φορτουνάτου	
φραγέλλιον	
φραγελλόω	
φραγμός	a fencing in, blocking up
φράζω	to point out, shew, indicate
φράσσω	to fence in, hedge round
φρέαρ	a well
φρεναπατάω	to deceive
φρεναπάτης	a soul-deceiver
φρήν	the midriff or muscle which parts
φρίσσω	to be rough or uneven on the surface, to bristle
φρονέω	to think, to have understanding, to be sage, wise, prudent
φρόνημα	one's mind, spirit
φρόνησις	a minding
φρόνιμος	in one's right mind, in one's senses
φρόνις	prudence, wisdom
φροντίζω	to think, consider, reflect, take thought, have a care, give heed
φρουρέω	to keep watch or guard
φρούρησις	
φρυάσσομαι	to neigh and prance
φρύγανον	dry sticks, firewood
φρυγία	
Φρύγιος	Phrygian, of, from Phrygia
Φύγελος	
φυγή	flight
φυλάζω	to divide into tribes
φυλακεύς	
φυλακή	a watching or guarding, watch, guard, ward
φυλακίζων	
φυλακτήριον	a guarded post, a fort or castle
φυλακτήριος	
φύλαξ	a watcher, guard, sentinel
φύλαξις	a security
φυλάσἐξω	
φυλάσσω	to keep watch and ward, keep guard
φυλή	a race or tribe
φυλία	the wild olive
φύλιος	
φύλλον	a leaf;
φύραμα	that which is mixed
φύς	a son;
φυσάω	to puff or blow up, distend
φυσικός	natural, native
φυσιόω	to puff up
φύσις	the nature, natural qualities, powers, constitution, condition
φυσίωσις	a being puffed up, inflation
φυτεία	a planting
φυτεύω	to plant
φύω	to bring forth, produce, put forth
φωλεός	a hole, den
φωνέω	to produce a sound or tone
φωνή	a sound, tone
φώνησις	
φῶξ	
φώς	a man
φωστήρ	that which gives light, an illuminator
φωσφόρος	bringing or giving light
φωτίζω	to enlighten, illuminate: to instruct, teach
φωτινή	
φωτινόν	
φώτισις	
φωτισμός	illumination, light
χαίρω	to rejoice, be glad, be delighted
χάλαζα	hail
χαλαζάω	to hail
χαλάω	to slacken, loosen
Χαλδαῖος	a Chaldaean
χαλεπός	hard to bear, painful, sore, grievous
χαλιναγωγέω	to guide with or as with a bridle, to bridle
χαλιναγωγός	guiding as with a bridle.
χαλινός	a bridle, bit
χαλινόω	to bridle
χάλκεος	of copper or bronze, brasen
χαλκεύς	a worker in copper, a smith
χαλκηδών	chalcedony
χαλκίον	a copper vessel, a copper, caldron, kettle, pot
χαλκολίβανον	fine brass.
χαλκός	copper
χαλκοῦς	a copper coin
χαλκόω	to make in bronze
χαμαί	on the earth, on the ground
Χαναάν	
Χαναναῖος	a Canaanite
χαρά	joy, delight
χάραγμα	any mark engraven or imprinted
χαρακτήρ	a mark engraved or impressed, the impress or stamp
χάραξ	a pointed stake
χαρίζομαι	to say or do something agreeable
χάρις	Grace
Χάρις	
χάρισμα	a grace, favour: a free gift, gift of God's grace
χάριτος	
χαριτόω	to shew grace to
Χαρράν	
χάρτης	
χάσμα	a yawning hollow, chasm, gulf
χασμάω	to yawn, gape wide
χάσμη	a yawning, gaping
χεῖλος	a lip
χειμάζω	to pass the winter
Χείμαρρος	
χειμάρρους	winter-flowing, swollen by rain and melted snow
χειμών	winter
χείρ	the hand
χειραγωγέω	to lead by the hand
χειραγωγός	one that leads by the hand, a leader, guide
χειρίς	a covering for the hand, a glove
χειρόγραφον	
χειρόγραφος	
χειροποίητος	made by hand, artificial
χειροτονέω	to stretch out the hand
χειρόω	to bring into hand, to manage, master, subdue
χείρων	worse, meaner, inferior
Χερουβείν	
χέω	to pour
χήν	the tame goose
χήρα	bereft of a husband, a widow
χῆρος	
χηρόω	to make desolate
χιλίαρχος	the commander of a thousand men, a chiliarch
χιλιάς	the number one thousand, a thousand
χίλιοι	a thousand
χίλιος	
χῖον	
Χίος	Chios
Χῖος	Chian, of or from Chios
χιτών	the garment worn next the skin, a frock
χιών	snow
χλαμύς	a short mantle
χλευάζω	to joke, jest, scoff, jeer
χλιαρός	warm, lukewarm
χλόη	the first shoot of plants
χλωρός	greenish-yellow
χοικός	of earth or dust
χοῖνιξ	a choenix, a dry
χοῖρος	a young pig, porker
χοιστῷ	
χολάω	to be full of black bile, to be melancholy mad
χολή	gall, bile
Χοραζείν	
χορηγέω	to lead a chorus
χορήγησις	
χορός	a round dance
χορτάζω	to feed, fatten
χόρτασμα	fodder, forage: food for men
χόρτος	an inclosed place, a feeding-place
Χουζᾶ	
χούς	
χοῦς	
χόω	to throw or heap up
χράομαι	consulting or using an oracle
χραύω	to scrape, graze, wound slightly
χράω	
χρεία	use, advantage, service
χρέος	that which one needs must pay, an obligation, debt
χρεοφιλέται	
χρεοφιλετῶν	
χρῄ	
χρή	it is fated, necessary
χρῄζω	to need, want, lack, have need of
χρῆμα	a thing that one uses
χρηματίζω	to negotiate, transact business, have dealings
χρημάτισις	
χρηματισμός	an oracular response, divine warning
χρήσιμος	useful, serviceable, good for use, good, apt or fit
χρῆσις	a using, employment, use
χρηστεύομαι	to be good and kind
χρηστολογία	fair speaking, smooth speech
χρηστός	useful, good of its kind, serviceable
χρηστότης	goodness, honesty
χρι	
Χρι	
χρίσμα	
Χριστιανός	a Christian
Χριστόσ̓	
ΧΡΙΣΤΟΣ	
χριστός	to be rubbed on
ΧΡΙΣΤΟΥ	
χρίω	to touch on the surface: to rub or anoint with scented unguents
χρονίζω	to spend time
χρόνος	time
χρονοτριβέω	to waste time, loiter
χρυσᾶν	
χρύσεος	golden, of gold, decked or inlaid with gold
χρυσίον	a piece of gold
χρυσοδακτύλιος	with ring of gold
χρυσόλιθος	
χρυσόπρασος	the chrysoprase
χρυσός	gold
χρυσόω	to make golden, gild
χρώς	the surface of the body, the skin
χω	
χωλός	lame
χων	
χώοαν	
χώρα	the space in which a thing is
χωρέω	to make room for another, give way, draw back, retire, withdraw
χωρίζω	to separate, part, sever, divide
χωρίον	a particular place, a place, spot, district
χωρίς	separately, asunder, apart, by oneself or by themselves
χώρισις	
χῶρος	a piece of ground, ground, place
ψάλλω	to touch sharply, to pluck, pull, twitch
ψαλμός	a twitching or twanging
ψασθε	
ψευδάδελφος	a false brother
ψευδαπόστολος	a false apostle
ψευδής	lying, false
ψεῦδις	
ψευδοδιδάσκαλος	a false teacher
ψευδολόγος	speaking falsely
ψευδόλογος	
ψευδομάρτυρα	
ψευδομαρτυρέω	to be a false witness, bear false witness
ψευδομαρτυρία	false witness
ψευδομάρτυς	a false witness
ψευδοπροφήτης	
ψεῦδος	a falsehood, untruth, lie
ψευδόχριστος	a false Christ
ψεύδω	to cheat by lies, beguile
ψευδώνυμος	under a false name, falsely called
ψεῦσμα	a lie, untruth
ψευστέω	to be a liar, lie, cheat
ψεύστης	a liar, cheat
ψηλαφάω	to feel or grope about
ψηφίζομαι	
ψηφίζω	to count or reckon
ψῆφος	a small stone, a pebble, rubbed and rounded
ψιθυρισμός	a whispering
ψιθυριστής	a whisperer: a slanderer
ψιχίον	a crumb of bread
̔Ψπάγετε	
ψυχας	
ψυχή	breath
ψυχικός	of the soul or life, spiritual
ψῦχος	cold
ψύχος	
ψυχόω	to give life to
ψυχρόομαι	to grow cold, be cool
ψυχρός	cold, chill
ψύχω	to breathe, blow
ψωμίζω	to feed with sops or tid-bits
ψωμίον	
ψώχω	to rub out
ὦ	O! oh!
ὧδε	in this wise, so, thus
ὡδεί	
ᾠδή	a song, lay, ode
ὠδίν	
ὠδίνουξα	
ὠδίνω	to have the pains or throes of childbirth, to be in travail or labour
ὠδίς	the pangs or throes of labour, travail-pains
ωμεν	
ὦμος	ulna
ῶν	
ὠνέομαι	to buy, purchase
ᾠόν	eggs or
ὥρα	period
ὡραῖος	produced at the right season
ὠρυό	
ως	
ὡς	thus, as, so that, since
ΩΣ	
Ὡσαννά	
ὡσαύτως	in like manner, just so
ὡσεί	just as if, as though
Ὠσηέ	
ὦσις	
ωσπερ	
ὥσπερ	just as if, even as
ὥστε	as, as being
ω̂Τα	
ὠτάριον	a little ear
ὠτίον	
ὠφέλεια	help, aid, succour, assistance
ὠφελέω	to help, aid, assist, succour, to be of use or service to
ὠφέλησις	a helping, aiding;
ὠφέλιμος	helping, useful, serviceable, profitable, advantageous, beneficial
Ωφρονίζωσι	