Field1	Field2
ἄατος	insatiate
Ἄβας	
Ἄβδηρα	
Ἀβδηρίη	
Ἄβδηρος	
ἀβουλέω	to be unwilling
Ἀγάθων	
ἄγαλμα	a glory, delight, honour
Ἀγαμέμνων	the very steadfast
ἀγανακτέω	to feel irritation
ἀγαπάω	to treat with affection, to caress, love, be fond of
Ἀγαπήνωρ	
ἀγαπήνωρ	loving manliness, manly
ἀγάπησις	
Ἀγαπτόλεμος	
Ἀγασθένης	
Ἀγαύη	
Ἀγαυή	
ἀγαυός	illustrious, noble
ἀγγέλλω	to bear a message
ἀγείρω	to bring together, gather together
Ἀγέλαος	
Ἀγέλαστος	
ἀγέλαστος	not laughing, grave, gloomy, sullen
ἀγέλη	a herd
ἀγέρωχος	high-minded, lordly
Ἀγέρωχος	
ἀγήνωρ	manly, courageous, heroic
Ἀγήνωρ	
ἀγήραος	not waxing old, undecaying
ἅγιος	devoted to the gods, sacred, holy
Ἅγιος	
Ἀγκαῖος	
Ἀγκύωρ	
ἀγκών	the bend of the arm, the elbow
ἀγλαία	splendour, beauty, adornment
Ἀγλαία	
Ἀγλαόπη	
Ἀγλαός	
ἀγλαός	splendid, shining, bright, beautiful
ἁγνίζω	to cleanse away
Ἁγνίης	
ἀγνοέω	not to perceive or know
ἄγνοια	want of perception, ignorance
ἄγνυμι	to break, shiver
ἄγνωστος	unknown
ἀγοράζω	to be in the ἀγορά
ἄγος	any matter of religious awe
ἄγραυλος	dwelling in the field
Ἄγραυλος	
ἀγρέω	to capture, seize
ἀγρία	
ἄγριος	living in the fields
Ἄγριος	
ἀγριόω	to make wild or savage
ἄγχι	near, nigh, close by
Ἀγχινόη	
Ἄγχιος	
Ἀγχίσης	
ἀγχίων	
ἀγχόνη	a throttling, strangling, hanging
ἄγχω	to compress, press tight
ἄγω	to lead or carry, to convey, bring
ἀγών	a number of people brought together, a gathering, assembly
ἀγωνίζομαι	to contend for a prize
ἀγωνιστής	a rival
ἀδαμάντινος	adamantine
ἀδεής	without fear, fearless
ἀδελφή	a sister
ἀδελφός	sons of the same mother
ᾍδης	Hades or Pluto
Ἀδιάντη	
ἀδικέω	to do wrong
ἄδικος	wrong-doing, unrighteous, unjust
Ἀδίτη	
Ἀδμήτη	
ἄδμητος	unbroken
Ἄδμητος	
ἀδοξέω	to be held in no esteem, to stand in ill repute
Ἀδραμύτιον	
Ἀδράστεια	the Inevitable
ἄδραστος	not running away, not inclined to do so
Ἄδραστος	
ἀδυνατέω	to want strength
ἀδύνατος	unable
Ἄδωνις	Adonis
ἀέθλιος	
Ἀέθλιος	
ἀεί	always, for ever
ἀείδω	to sing
ἀεκούσιος	against one's will, involuntary
ἀέκων	against one's will, unwilling
ἀελλόπος	storm-footed, storm-swift
Ἀελλόπους	
ἀελλός	
Ἀελλώ	storm
Ἀερόπη	
ἀετός	an eagle
ἀηδών	the songstress
ἀήρ	the lower air, the air
Ἀθαμαντίη	
Ἀθαμάντιος	
Ἀθάμας	
ἀθανασία	immortality
ἀθάνατος	undying, immortal
ἀθεράπευτος	uncared for, of animals
Ἀθῆναι	the city of Athens
Ἀθήναια	
Ἀθήναιον	the temple of Athena
Ἀθηναῖος	Athenian, of or from Athens
Ἀθήναιος	
Ἀθήνευς	
Ἀθήνη	Athena
ἄθλιος	gaining the prize
ἆθλον	the prize of contest
ἆθλος	a contest for a prize
ἀθροίζω	to gather together, to muster
ἀθρόος	in crowds or masses, crowded together
ἀθυμέω	to be disheartened, lose heart
ἀθῷος	unpunished, scot-free
Αἶα	
Αἰαίη	
Αἰακός	
Αἴας	Ajax
αιγ	
Αἰγαίων	Aegaeon
αἴγεος	a goat's skin
Αἰγεύς	
Αἰγεωνεύς	
Αἰγιάλεια	
Αἰγιάλειος	
Αἰγιαλεύς	
Αἰγιάλευς	
αἰγιαλός	the sea-shore, beach, strand
Αἰγιαλός	
Αἰγίμιος	
Αἴγινα	Aegina
αἰγίνη	
Αἴγιος	
Αἰγίπαν	
Αἰγίς	
αἰγίς	the aegis or shield
Αἴγισθος	
αἴγλη	the light of the sun, radiance
Αἴγλη	
Αἰγληίς	
αἰγλήτης	
αἴγλητος	
αἰγυπιός	a vulture
Αἰγύπτιος	Egyptian
Αἴγυπτος	the river Nile
Αἵδης	
ἀίδιος	everlasting, eternal
αἰδοῖον	the genitals, pudenda
αἰδοῖος	regarded with reverence, august, venerable
Αἰήτης	
αἴητος	terrible, mighty
αἰθήρ	ether, the brighter purer air, the sky
Αἰθιοπία	Ethiopia
Αἰθιόπιος	
Αἰθιοπίς	
Αἰθίοψ	burnt-face
αἴθουσα	the corridor
Αἰθούσα	
Αἴθρη	
Αἴθυλλα	
αἴθω	to light up, kindle
αἰκίζω	to treat injuriously, to plague, torment
αἱΛαομέδοντος	
αἷμα	blood
αἱμάσσω	to make bloody stain with blood
Αἱμόνιος	
Αἷμος	
Αἵμων	
Αἰνείας	
αἰνετός	praiseworthy
Αἰνετός	
Αἰνιάν	
Αἰνίας	
αἴνιγμα	a dark saying, riddle
Αἶνος	
αἴξ	a goat
Αἰολεύς	an Aeolian
αἰολέω	
αἰολίας	
Αἰολίη	
Αἰόλιος	
αἰόλος	quick-moving
Αἴολος	
αἰπόλος	a goatherd
Αἴπυτος	
αἱρέω	to take with the hand, grasp
αἴρω	to take up, raise, lift up
Αἴσακος	
αἰσθάνομαι	to perceive, apprehend by the senses, to see, hear, feel
Αἰσχρηίς	
αἰσχύνω	to make ugly, disfigure, mar
Αἴσων	
αἰτέω	to ask, beg
αἰτία	a charge, accusation
αἰτιάομαι	to charge, accuse, censure, blame
αἴτιος	to blame, blameworthy, culpable
Αἴτνη	
Αἰτωλία	
Αἰτωλίη	
Αἰτώλιος	
Αἰτωλίς	
Αἰτωλοί	
Αἰτωλός	
αἰχμαλωτίς	
αἰχμάλωτος	taken by the spear, captive to one's spear, taken prisoner
αἰχμή	the point of a spear
αἰψηροκέλευθος	swift-speeding
Ἀκάλλη	
Ἀκάμας	
ἀκάμας	untiring, unresting
Ἀκαρνάν	
Ἀκαρνανίη	
ἀκαρπία	unfruitfulness, barrenness
ἄκαρπος	without fruit, barren
ἄκαστος	
Ἄκαστος	
ἀκαταγώνιστος	
ἀκέομαι	to heal, cure
ἀκίς	a point, the barb
ἀκληρωτί	
ἀκοή	a hearing, the sound heard
Ἀκόντης	
ἀκοντίζω	to hurl a javelin
ἀκόντιον	
ἄκος	a cure, relief, remedy for
ἀκοσμία	disorder
Ἀκουσίλαος	
ἀκούσιος	
ἄκουσις	
ἀκούω	to hear
ἄκρα	a headland, foreland, cape
ἀκραῖος	dwelling on the heights
ἀκριβής	exact, accurate, precise, made or done to a nicety
ἀκριβόω	to make exact or accurate
Ἀκρίσιος	
ἄκρον	the highest or furthest point
ἀκρόπολις	the upper city
ἄκρος	at the furthest point
ἄκρων	
ἀκρωτηριάζω	to cut off the extremities, mutilate
ἀκρωτήριον	any prominent part
Ἀκταίη	
ἀκταῖος	on the coast
Ἄκταιος	
Ἀκταῖος	
Ἀκταίων	
Ἀκτή	
ἀκτή	a headland, foreland, promontory, shore
ἀκτίς	a ray, beam
Ἄκτωρ	
ἄκτωρ	a leader
ἄκων	a javelin, dart
Ἀλαίου	
ἀλαλαγή	a shouting
ἀλαλαγμός	
ἀλάομαι	to wander, stray or roam about
Ἀλάστωρ	
ἀλάστωρ	the avenging deity, destroying angel
Ἀλέκτωρ	
ἀλέκτωρ	a cock
ἀλέξανδρος	defending men
Ἀλέξανδρος	
ἀλεξιάρη	she that keeps off a curse
Ἀλεξιάρης	
ἀλέξω	to ward or keep off, turn away or aside
Ἀλεός	
ἀλεός	
ἀλέω	to grind, bruise, pound
ἄλη	
ἀλήθεια	truth
ἀληθινός	agreeable to truth
Ἀληκτώ	
Ἀλήτης	
ἀλήτης	a wanderer, stroller, rover, vagabond
ἀλθαία	
Ἀλθαίη	
Ἀλθαιμένης	
ἁλία	an assembly of the people
Ἀλίζωνες	
ἁλίη	
Ἁλίη	
Ἁλιμήδη	
ἅλιος	
Ἅλιος	
Ἁλιρρόθιος	
ἁλιρρόθιος	dashed over by the sea
Ἅλις	
ἁλίσκομαι	to be taken, conquered
Ἁλίφηρος	
Ἀλκάθοος	
Ἄλκαθος	
ἀλκαῖον	
ἀλκαῖος	strong, mighty
Ἀλκαῖος	
Ἀλκάροψ	
Ἀλκείδης	
ἀλκή	strength
ἄλκη	
Ἄλκης	
Ἄλκηστις	
Ἀλκιδίκη	
Ἀλκιμένης	
ἄλκιμος	strong, stout
Ἀλκίνοος	
Ἀλκίππη	
Ἀλκμαίων	
Ἀλκμαιωνίς	
Ἀλκμήνη	
Ἀλκμήνωρ	
Ἀλκυονεύς	
Ἀλκυόνη	
ἀλκυών	the kingfisher
Ἄλκων	
ἀλλά	otherwise, but
ἀλλάσσω	to make other than it is, to change, alter
ἀλλαχῆ	elsewhere, in another place
ἀλλαχοῦ	elsewhere
ἄλλῃ	in another place, elsewhere
ἄλληκτος	unceasing, ceaseless
ἀλλήλων	of one another, to one another, one another
ἀλλοδαπός	belonging to another people or land, foreign, strange
ἀλλοιόω	to make different, to change, alter
ἅλλομαι	to spring, leap, bound
ἄλλος	alius, another, one besides
ἀλλότριος	of or belonging to another
ἄλλου	
ἄλλως	in another way or manner
ἅλμα	a spring, leap, bound
Ἁλοκράτης	
Ἀλόπιος	
ἄλσις	
ἄλσος	a glade or grove
Ἀλφειός	
Ἀλφεσίβοια	
ἀλφεσίβοιος	bringing in oxen
ἄλφιτον	peeled or pearl-barley
Ἀλωάδας	
ἀλωεύς	
Ἀλωεύς	
ἅλων	
ἁλώνης	
ἀλώπηξ	a fox
ἅλωσις	a taking, capture, conquest, destruction
ἅμα	at once, at the same time
Ἁμαδρυάδες	
Ἀμαζών	the Amazons
Ἀμαλθεία	
ἄμαξα	a wagon, wain
Ἀμαρυγκεύς	
Ἀμάρυνθος	
ἀμβροσία	
ἀμβροσίη	ambrosia
ἀμβρόσιος	immortal
ἀμείβω	to change, exchange
ἀμείνων	better, abler, stronger, braver
ἀμελέω	to have no care for, be neglectful of
Ἀμήστριος	
Ἄμηστρις	
ἀμηχανέω	to be at a loss for
ἀμηχανία	want of means, helplessness, impotence
ἅμιλλα	a contest for superiority, a conflict
Ἀμισώδαρος	
ἅμμα	anything tied or made to tie
Ἄμμων	Zeus-Ammon
ἄμορφος	misshapen, unsightly
ἄμπελος	a vine
Ἀμυθάων	
Ἀμύκλαι	a sort of shoes
Ἀμύκλης	
Ἄμυκος	
Ἀμυμώνη	
ἀμύντωρ	a defender, helper
Ἀμύντωρ	
ἀμύνω	to keep off, ward off
ἀμφί	on both sides
ἀμφιάζω	to clothe
ἀμφίαλος	sea-girt
Ἀμφίαλος	
ἀμφί-ἀμφιέννυμι	
Ἀμφίαναξ	
Ἀμφιάραος	Amphiaraus
Ἀμφιδάμας	
Ἀμφίδικος	
ἀμφιέννυμι	to put round or on
Ἀμφιθέη	
Ἀμφικτύων	
Ἀμφιλοχικός	
Ἀμφίλοχος	
Ἀμφίμαχος	
Ἀμφιμέδων	
Ἀμφίνομος	
Ἄμφιος	
ἀμφισβητέω	to stand apart
ἀμφίστομος	with double mouth
Ἀμφιτρίτη	
ἀμφί-τροχάζω	
ἀμφί-τροχάω	
Ἀμφιτρύων	
Ἄμφιων	
ἀμφότερος	each or both of two
Ἀμφότερος	
ἄμφω	
ἄν	
ἀνά	up, upon
ἀνά-ἀφύσσω	
ἀναβαίνω	to go up, mount, to go up to
ἀνάβασις	a going up, mounting
ἀναβιβάζω	to make go up, cause to mount
ἀναβλέπω	to look up
ἀναβοάω	to shout aloud, utter a loud cry
ἀναβολή	that which is thrown up, a mound
ἀναγιγνώσκω	to know well, know certainly
ἀναγκάζω	to force, compel
ἀνάγκη	force, constraint, necessity
ἀνά-γνωρίζω	
ἀνάγω	to lead up
ἀναδίδωμι	to hold up and give
ἀναδύνω	to come to the top of water
ἀνά-ἐφύω	
ἀναζάω	to return to life, be alive again
ἀναζητέω	to examine into, investigate
ἀναζώωσις	
ἀνά-θάλπω	
ἀνάθημα	a votive offering set up
ἀνά-θρῴσκω	
ἀναιρέω	to take up, raise
ἀνακαίω	to light up
ἀνακάμπτω	to bend back
ἀνακομιδή	a carrying away again, recovery
ἀνακομίζω	to carry up
ἀνακράζω	to cry out, lift up the voice
ἀνακρίνω	to examine closely, to question, interrogate
ἀνάκτορον	a palace
Ἀνάκτορος	
Ἀνάκτωρ	
ἀνάκτωρ	
ἀναλάζομαι	to take again
ἀναλαμβάνω	to take up, take into one's hands
ἀναλίσκω	to use up, to spend, lavish or squander
ἀναλύω	to unloose, undo
ἀνανεύω	to throw the head back
ἄναξ	a lord, master
ἀναξηραίνω	to dry up
Ἀναξιβίη	
Ἀναξώ	
ἀναπείθω	to bring over, convince
ἀναπέμπω	to send up
ἀναπέτομαι	to fly up, fly away
ἀνάπλεος	quite full of
ἀνάπτω	to make fast on or to
ἀναρπάζω	to snatch up
ἀναρρίπτω	to throw up
ἀναρτάω	to hang to
ἀνασπάω	to draw up, pull up
ἀνάσσω	to be lord, master, owner, to rule, in
ἀναστρέφω	to turn upside down, upset
ἀνασχίζω	to rip up
ἀνατείνω	to stretch up, hold up
ἀνατέλλω	to make to rise up or to grow up
ἀνατίθημι	to lay upon
ἀνατολάς	
ἀνατολή	a rising, rise
ἀνατρέπω	to turn up or over, overturn, upset
ἀνατρέφω	to feed up, nurse up, educate
Ἄναυρος	a torrent
ἄναυρος	
ἀναφαίνω	to make to give light, make to blaze up
ἀναφέρω	to bring or carry up
Ἀνάφη	
ἀναφύσημα	
ἀνά-φύω	
ἀναχώννυμι	to heap up into a mound
ἀναχωρέω	to go back
Ἀνδραίμων	
ἀνδρεία	manliness, manhood, manly spirit
ἀνδρεῖος	of or for a man
ἀνδρίς	
Ἀνδρόγεως	
Ἀνδρομάχη	
ἀνδρομάχος	fighting with men
Ἀνδρομέδα	
Ἀνδρομέδη	
Ἀνδρομήδης	
ἀνδρόμορφος	
Ἄνδρος	
ἀνδροφάγος	eating men
ἀνδρόω	to rear up into manhood
ἀνεγείρω	to wake up, rouse
ἀνείλω	
ἄνειμι	to go up
ἀνέλκω	to draw up
ἄνεμος	wind
ἀνεμόω	to expose to the wind:—
ἀνέρχομαι	to go up
ἄνετος	relaxed, slack, loose
ἀνευρίσκω	to find out, make out, discover
ἀνέχω	to hold up
ἀνήκω	to have come up to
ἀνήρ	a man
Ἄνθεια	
Ἀνθεμόεις	
Ἀνθηίς	
Ἀνθηλεία	
Ἀνθίππη	
ἄνθρα	
ἄνθραξ	charcoal, coal
ἄνθρωπος	man
ἀνθρωποφάγος	man eating
ἀνιάομαι	to cure again, repair
ἀνίατος	incurable
ἀνιάω	to grieve, distress
ἀνιερόω	to dedicate, devote
ἀνίημι	to send up or forth
Ἀνίκητος	
ἀνίκητος	unconquered, unconquerable
Ἄνιος	
ἄνιος	
ἀνίστημι	to make to stand up, raise up
ἄνοδος	
ἀνοίγνυμι	to open
ἀνοιδέω	to swell up
ἀνταῖος	set over against, right opposite
Ἀνταῖος	
ἀνταίρω	to raise against
Ἄντανδρος	
ἄντανδρος	instead of a man, as a substitute
Ἄντεια	
ἀντερῶ	to speak against, gainsay
Ἀντήνωρ	
ἀντήνωρ	instead of a man
ἀντί	over against, opposite. c. gen.
Ἀντιάδης	
Ἀντιγόνη	
Ἀντίγονος	
ἀντιδίδωμι	to give in return, repay
ἀντί-εἰμί	
ἀντί-ἵημι	
Ἀντίκλεια	
Ἄντικλος	
ἀντικρύ	over against, right opposite
Ἀντιλέων	
ἀντιλέων	lion-like
Ἀντίλοχος	
Ἀντιμάχη	
Ἀντίμαχος	
ἀντίμαχος	
ἀντίνοος	
Ἀντίνοος	
Ἀντιόπη	
Ἀντίοχος	
ἀντίπερας	
ἀντίπνοια	
ἀντιπράσσω	to act against, seek to counteract
Ἀντισθένης	
ἀντίστοιχος	ranged opposite in rows or pairs
Ἀντιφάτης	
Ἄντιφος	
ἄντρον	
ἄνυδρος	wanting water, waterless
ἀνυπέρβλητος	not to be surpassed or outdone
ἀνυπέρθετος	
ἀνυπόδετος	
ἀνύω	to effect, achieve, accomplish, complete
ἄνω	
ἄνωγα	to command, order
Ἀνώγων	
Ἀξιός	
ἀξιόω	to think or deem worthy of
ἄξων	an axle
ἀοιδή	song, a singing
ἀπαγγέλλω	to bring tidings, report, announce
ἀπαγορεύω	to forbid
ἀπάγω	to lead away, carry off
ἄπαις	childless
ἀπαιτέω	to demand back, demand
ἀπαίτησις	a demanding back
ἀπαλλαγή	deliverance, release, relief from
ἀπάλλαξις	
ἀπαλλάσσω	to set free, release, deliver
ἀπαντάω	to move from
ἀπαξιόω	to disclaim as unworthy, disown
ἀπαρνέομαι	to deny utterly, deny
ἀπαρχή	the beginning of a sacrifice, the primal offering
ἅπας	quite all, the whole
ἀπατάω	to cheat, trick, outwit, beguile
ἀπάτη	a trick, fraud, deceit
ἀπέθανεκαι	
ἀπείθεια	disobedience
ἀπειλέω	
ἄπειμι	
ἀπεῖπον	to speak out, tell out, declare
ἀπείργω	to keep away from, debar from
ἀπελαύνω	to drive away, expel from
ἀπεμπολάω	to sell
ἀπεναντιῶς	
ἀπέρχομαι	to go away, depart from
ἀπέχω	to keep off or away from
ἀπημοσύνη	freedom from harm
Ἀπημοσύνη	
ἀπήνη	a four-wheeled wagon
Ἀπίη	
ἄπιος	
Ἆπις	Apis
Ἀπις	
ἀπιστέω	to be ἄπιστος
ἄπλετος	boundless, immense
ἄπλοια	impossibility of sailing, detention in port
ἄπλωτος	
ἀπό	from, away from. c. gen.
ἀπό-ἅλλομαι	
ἀποβαίνω	to step off from
ἀποβάλλω	to throw off
ἀπογιγνώσκω	depart from a judgment, give up a design or intention
ἀπόγονος	born or descended from
ἀποδέχομαι	to accept from
ἀποδιδράσκω	to run away or off, escape
ἀποδίδωμι	to give up or back, restore, return
ἀποδύρομαι	to lament bitterly
ἀπό-ἐλπίζω	
ἄποθεν	from afar
ἀποθερίζω	to cut off
ἀποθνήσκω	to die off, die
ἀποικία	a settlement far from home, a colony settlement
ἀποκαθίστημι	to re-establish, restore, reinstate
ἀποκλείω	to shut off from or out of, debar
ἀποκοιμάομαι	to sleep away from home
ἀποκομίζω	to carry away, escort
ἀποκόπτω	to cut off, hew off
ἀποκρίνω	to separate, set apart
ἀποκρούω	to beat off from
ἀποκρύπτω	to hide from, keep hidden from
ἀποκτείνω	to kill, slay
ἀπό-κυλίνδω	
ἀπολαμβάνω	to take or receive from
ἀπολάπτω	to lap up
ἀπολείπω	to leave over or behind
ἀπολιθόομαι	to become stone
Ἀπολλόδωρος	
ἀπόλλυμι	to destroy utterly, kill, slay
Ἀπόλλων	Apollo
Ἀπολλώνιος	of or belonging to Apollo
ἀπολύω	to loose from
ἀπομάσσω	to wipe clean
ἀπόμνυμι	to take an oath away from
ἀποξύνω	to bring to a point, make taper
ἀποξύω	to strip off
ἀπό-ὀρνεόω	
ἀποπέμπω	to send off or away, to dismiss
ἀποπλέω	to sail away, sail off
ἀποπρίζω	
ἀπορέω	to be without means or resource
ἀπορία	difficulty of passing
ἀπορραίνω	to spirt out, shed about
ἀπορρήγνυμι	to break off, snap asunder
ἀπορρίπτω	to throw away, put away
ἀποσπάω	to tear or drag away from
ἀποστέλλω	to send off or away from
ἀποστρέφω	to turn
ἀποσφάζω	to cut the throat of
ἀποτέμνω	to cut off, sever
ἀπόΤενεδου	
ἀποτίθημι	to put away, stow away
ἀπό-τίκτω	
ἀποτρέπω	to turn
ἀπό-ὕω	
ἀποφαίνω	to shew fort, display, produce
ἄπρακτος	doing nothing, ineffectual, unprofitable
ἅπτω	to fasten, bind fast
ἀπωθέω	to thrust away, push back
ἀπώλεια	destruction
ἀπώτερος	
ἀπωτέρω	further off
ἀρά	a prayer
Ἀραβία	Arabia
Ἀράβιος	Arabian
ἀράομαι	to pray to
ἀραρίσκω	to join, join together, fasten
ἀράσσω	to strike hard, smite
Ἄρβηλος	
ἄρβηλος	
ἀργαλέος	painful, troublous, grievous
Ἀργεῖος	of or from Argos, Argive
Ἀργειφόντης	slayer of Argus
Ἀργέλη	
ἀργέω	to lie idle, be unemployed, do nothing
Ἄργη	
Ἀργιόπη	
Ἀργοναύτης	
Ἄργος	
Ἀργός	
ἀργός	
Ἀργυφίη	
Ἀργώ	the Argo or swift
Ἀρέθουσα	
ἄρειος	devoted to Ares, warlike, martial
Ἄρειος	
Ἀρείων	
ἀρείων	better, stouter, stronger, braver, more excellent
ἀρέμ	
Ἄρεος	
Ἀρέστωρ	
Ἀρετάων	
ἀρή	
Ἀρήνη	
Ἄρης	Ares
Ἀρήτη	
Ἄρητος	
ἄρθρον	a joint
Ἀριάδνη	
ἀριθμός	number
Ἄρις	
Ἀρίσβη	
Ἀρισταῖος	
ἀριστάω	to take breakfast or luncheon
ἀριστεῖα	the prize of the best and bravest, the meed of valour
ἀριστεῖος	
ἀριστερός	left, on the left
ἀριστεύς	the best man
ἀριστεύω	to be best or bravest
Ἀριστοδήμη	
Ἀριστόδημος	
ἀριστομάχος	
ἀριστόμαχος	best at fighting
Ἀριστόμαχος	
ἄριστον	the morning meal, breakfast
ἄριστος	best
Ἀρίστρατος	
ἀρίστῳνικητηριον	
Ἀρκαδία	
Ἀρκαδίη	
Ἀρκαδικός	
Ἀρκάς	
Ἀρκείσιος	
Ἄρκενα	
ἄρκτος	a bear
ἅρμα	a chariot
ἁρματηλατέω	to go in a chariot, drive it
ἁρματοδρομέω	
ἁρμόζω	to fit together, join
ἁρμονία	a fastening
Ἁρμονίη	
ἀρνέομαι	to deny, disown
Ἄρνεος	
ἀρνός	a lamb
ἄρος	
ἁρπαγεύς	
ἁρπαγή	seizure, rapine, robbery, rape
ἁρπάζω	to snatch away, carry off
ἁρπαλέος	greedy
Ἁρπάλευς	
Ἁρπάλυκος	
ἁρπάσασαεἰς	
ἅρπη	a kite
Ἅρπυιαι	the snatchers
Ἅρπυς	
ἄρσην	male
Ἀρσινόη	
Ἀρσίνοος	
Ἄρτεμις	Artemis
Ἀρτεμίσιον	a temple of Artemis
Ἀρτεμίσιος	
ἀρτίτοκος	new-born
ἀρύω	to draw
ἀρχαῖος	from the beginning
Ἀρχεβάτης	
Ἀρχέδικος	
ἀρχέλαος	leading the people, a chief
Ἀρχέλαος	
Ἀρχέλοχος	
Ἀρχέμαχος	
Ἀρχέμολος	
Ἀρχέμορος	
Ἀρχέστρατος	
ἀρχή	a beginning, origin, first cause
ἀρχήν	
ἀρχιτέκτων	a chief-artificer, master-builder, director of works, architect, engineer
Ἀρχιτέλης	
ἄρχω	to be first
ἀσέβεια	ungodliness, impiety, profaneness
ἀσθένεια	want of strength, weakness, feebleness, sickliness
ἀσθενέω	to be weak, feeble, sickly
ἀσθενής	without strength, weak, feeble, weakly
Ἀσία	Asia
Ἀσίης	
Ἄσιος	Asian
ἄσιος	
ἄσις	slime, mud
ἀσκάλαφος	
Ἀσκάλαφος	
Ἀσκάνιος	
ἀσκέω	to work curiously, form by art, fashion
Ἀσκληπιάδαι	physicians
Ἀσκληπιάδης	
Ἀσκληπιός	Asclepius
ἀσκός	a leathern-bag, a wine-skin
ἄσπαρτος	unsown, untilled
ἀσπίς	a round shield
ἄσπορος	
Ἀσσάρακος	
Ἀσσύριοι	the Assyrians
Ἀσσύριος	
ἀστακός	
Ἀστακός	
ἀστερίας	
Ἀστερίη	
Ἀστέριος	
ἀστέριος	
Ἀστεροδίη	
ἀστεροπαῖος	
Ἀστεροπαῖος	
Ἀστερόπη	
ἀστή	
ἀστός	a townsman, citizen
ἀστοχέω	to miss the mark, to miss, fail
ἀστράγαλος	one of the neck-vertebrae
ἀστραῖος	
Ἀστραῖος	
ἀστραπή	a flash of lightning, lightning
ἀστράπτω	to lighten, hurl lightnings
ἄστρον	the stars
ἄστυ	a city, town
ἀστυάναξ	lord of the city
Ἀστυάναξ	
Ἀστυβίης	
Ἀστύγονος	
Ἀστυδαμεία	
Ἀστυκρατεία	
Ἀστύλοχος	
Ἀστύνοος	
Ἀστυόχη	
Ἀστυπαλαία	
ἀσυνήθης	unaccustomed, inexperienced, unacquainted
ἀσφαλής	not liable to fall, immoveable, steadfast, firm
ἀσφαλίζομαι	to make safe, secure
ἈσωπίδοσΜεντωρ	
Ἀσωπός	
Ἀταβύριον	
ἄτακτος	not in battle-order
Ἀταλάντη	
ἄταφος	unburied
ἄτεκνος	without children, childless
Ἄτη	
ἄτη	bewilderment, infatuation, reckless impulse
Ἀτθίς	Attic
ἀτιμάζω	to hold in no honour, to esteem lightly, dishonour, slight
Ἀτλαντείη	
Ἀτλάντειος	
Ἀτλαντικός	of Atlas, Atlantic
Ἀτλαντίς	the Atlantic ocean
Ἄτλας	Atlas
ἆτος	
ἄτρακτος	a spindle
ἀτράχηλος	without neck
Ἀτρεύς	
Ἄτρομος	
ἄτρομος	intrepid, dauntless
ἄτροπος	unchangeable, eternal
Ἄτροπος	
ἄτρωτος	unwounded
Ἀττικός	Attic, Athenian
Ἀτύμνιος	
ἀτυχέω	to be unlucky or unfortunate, fail, miscarry
ἀτύχημα	a misfortune, mishap
Αὐγέης	
Αὐγείας	
αὔγειον	
Αὔγη	
αὐγής	
αὐθήμερος	made or done on the very day
αὖθις	back, back again
αὐλέω	to play on the flute
αὐλή	the court-yard
αὐλητής	a flute-player
αὐλίζομαι	to lie in the court-yard
Αὐλίς	
αὐλός	a flute
αὐξάνω	to make large, increase, augment
ἄυπνος	sleepless, wakeful
αὔριον	to-morrow
Αὐσονίη	
Αὐσόνιος	
Αὐτεσίων	
αὐτῆσἐρῶντος	
αὐτῆσπρος	
αὐτόθι	on the spot
Αὐτόλυκος	
Αὐτομάτη	
αὐτόματος	acting of one's own will, of oneself
Αὐτομεδούσα	
Αὐτονόη	
αὐτός	self
αὐτοῦ	at the very place, just here, just there
αὐτόχειρ	with one's own hand
αὐτόχθονος	country and all
αὐτόχθων	sprung from the land itself
αὐχέω	to boast, plume oneself
αὐχήν	the neck, throat
αὐχμηρός	dry, dusty, rough, squalid
ἀφαιρέω	to take from, take away from
ἀφανής	unseen, invisible, viewless
ἀφανίζω	to make unseen, hide from sight
Ἀφαρεύς	
ἀφαρεύς	
ἀφαρής	
ἀφαρπάζω	to tear off or from
Ἀφείδας	
ἀφειδής	unsparing or lavish of
Ἀφεταί	
ἀφήκω	to arrive at
ἄφθονος	without envy
Ἄφιδνα	
Ἀφίδναι	
ἀφίημι	to send forth, discharge
ἀφικνέομαι	to come to
ἄφλαστον	
ἀφοράω	to look away from
ἀφορία	a not bearing
ἄφορος	not bearing, barren
Ἀφροδίτη	Aphrodite
Ἀχαία	Achaia
Ἀχαιός	Achaian
ἀχαριστία	thanklessness, ingratitude
ἄχειρος	without hands
Ἀχελώιος	
Ἀχελῷος	Achelous
Ἀχέρων	Acheron, river of woe
ἄχθομαι	to be loaded
Ἀχιλλεύς	Achilles
ἄχρι	to the uttermost, utterly
Ἀψυρτίδες	
Ἄψυρτος	
βαδίζω	to go slowly, to walk
βάζω	to speak, say
βαθύς	deep or high
βαίνω	to walk, step
βακτηρία	a staff, cane
βάκτρον	
Βακχάω	to be in Bacchic frenzy, to rave
Βακχεύω	to keep the feast of Bacchus, celebrate his mysteries
Βάκχη	a Bacchante
Βαλίος	
βάλλις	
βάλλω	to throw
βάπτω	to dip in water
βάραθρον	a gulf, pit
βάραθρος	
βαρβαρόομαι	to become barbarous
βάρβαρος	barbarous
Βάρθας	
βάρος	weight
βαρύς	heavy
βασίλεια	a queen, princess
βασιλεία	a kingdom, dominion
βασίλειον	a kingly dwelling, palace
βασίλειος	of the king, kingly, royal
βασιλεύς	a king, chief
βασιλεύω	to be king, to rule, reign
βασίλη	
βασιλίς	a queen, princess
βάσις	a stepping, step
βαστάζω	to lift, lift up, raise
Βατεία	
βατέω	to tread, cover
βάτης	
βάτον	
βάτος	
Βάτων	
Βέβρυκες	
Βελλεροφόντης	
βέλος	a missile
Βενθεσικύμη	
Βῆλος	
βία	bodily strength, force, power, might
βιάζω	to constrain
βίαιος	forcible, violent
Βίας	
βιάω	to constrain
βιβλίον	a paper, scroll, letter
βιβρώσκω	to eat, eat up
Βιθυνίς	
Βιλσάτης	
βίος	life
βιόω	to live, pass one's life
Βισάλτης	
Βίστονες	
βλάπτω	to disable, hinder, stop
βλέπος	a look
βλέπω	to see, have the power of sight
βόα	
βοάω	to cry aloud, to shout
βοείη	an ox-hide, ox-hide shield
βόειος	of an ox or oxen
βοεύς	a rope of ox-hide
βοή	a loud cry, shout
βοηθέω	to come to aid, to succour, assist, aid
βοηθός	assisting, auxiliary
βοηλατέω	
βοηλάτης	one that drives away oxen, a cattle-lifter
Βοιωτία	Boeotia
Βοιώτιος	Boeotian
Βοιωτίς	
Βοιωτῶνμεν	
βορά	eatage, meat
Βορέας	the North wind
Βορέης	
βορός	devouring, gluttonous
βόσκημα	that which is fed or fatted
βόσκω	to feed, tend
Βόσπορος	ox-ford
βόστρυχος	a curl or lock of hair
βουκολέω	to tend cattle
βουκόλιον	a herd of cattle
Βουκολίων	
βούκολος	
βουκόλος	a cowherd, herdsman
Βουκόλος	
Βουλεύς	
βουλεύω	to take counsel, deliberate, concert measures
βούλησις	a willing
βούλομαι	to will, wish, be willing
βουλόμενοστους	
βοῦς	cow
Βούσιρις	
Βούτης	
βουφορβέω	to tend cattle
βουφόρβια	a herd of oxen
Βράγχος	
βραδύνω	to make slow, delay
Βραισίη	
βραχίων	the arm
βραχύς	short
βρέφος	the babe in the womb
βριάρεως	Aegaeon
Βρισηί̈ς	
Βρομίος	
βροντάω	to thunder
βροντή	thunder
Βρόντης	thunderer
βρόντης	
Βροτέης	
βρότειος	mortal, human, of mortal mould
βρότεος	
Βρύκη	
βρωτός	to be eaten
Βύβλιοι	
βυβλίον	
βύζω	
βυθίζω	to sink
βυθός	the depth
βύρσα	the skin stripped off, a hide
βύω	to stuff
βῶλος	a lump of earth, a clod
βωμός	any raised platform, a stand
Βῶρος	
γ	
Γάδειρα	
Γαῖα	
γάλα	milk
Γαλάτεια	
γαμβρός	any one connected by marriage
γαμετή	a married woman, wife
γαμέω	to marry
γάμος	a wedding, wedding-feast
Γανυμήδη	
Γανυμήδης	
γάρ	for
γαστήρ	the paunch, belly
Γελάνωρ	
γενεά	race, stock, family
γενεάρχης	
γενειάω	to grow a beard, get a beard
γένειον	the part covered by the beard, the chin
γένεσις	an origin, source, productive cause
γενετή	the hour of birth
γενέτης	the begetter, father, ancestor
Γενέτωρ	
γέννα	descent, birth
γενναῖος	suitable to one's birth or descent
γενναιότης	nobleness of character, nobility
γέννας	
γεννάω	to beget, engender
γέννησις	an engendering, producing
γένος	race, stock, family
γένυς	the under jaw
Γεραιστός	
Γέραιστος	
γέρας	a gift of honour
Γερήνιος	
γεύω	to give a taste of
γεωργία	tillage, agriculture, farming
γῆ	earth
γηγενής	earthborn
γηραιός	aged, in old age
γῆρας	old age
γηράσκω	to grow old, become old
Γηρυόνης	Geryon
Γίγας	
γίγνομαι	to come into being
γιγνώσκω	to learn to know, to perceive, mark, learn
Γλαύκη	
Γλαυκίππη	
Γλαυκονόμη	
Γλαῦκος	
γλαύξ	the owl
Γληνός	
γλῶσσα	the tongue
γνώμη	a means of knowing, a mark, token
γνωρίζω	to make known, point out, explain
γονεύς	a begetter, father
γονή	produce, offspring
γόνος	that which is begotten, offspring, a child
γόνυ	the knee
Γόργη	
Γοργόνη	
γοργός	grim, fierce, terrible
Γοργοφόνη	
Γοργοφόνος	Gorgon-killing
Γοργυθίων	
Γόργυρα	
Γοργώ	the Gorgon
Γόργων	
Γουνεύς	
γραῖα	an old woman
γραίη	
Γραϊκός	
Γραικός	
γραῖος	raisins
γράμμα	that which is drawn
Γρατίων	
γραῦς	an old woman
γράφω	to scratch, scrape, graze
Γύης	
γυμνικός	of or for gymnastic exercises
γυμνός	naked, unclad
γυναικεῖος	of or belonging to women, like women, befitting them, feminine
γυναικοκρατέω	
γυνή	a woman
Γυρτώνιος	
γύψ	a vulture
δ	
Δαήμων	
δαιδάλλω	to work cunningly, deck or inlay with curious arts, to embellish
Δαίδαλος	
δαίμων	a god, goddess
δαίνυμι	to divide
δαίς	
Δαισήνωρ	
δαίφρων	battle
Δαί̈φρων	
δάκνω	to bite
δάκρυον	a tear
δ'Ἀκταίου	
δαλός	a fire-brand, piece of blazing wood
Δαμάσιππος	
Δαμασίστρατος	
Δαμασίχθων	
Δαμάστης	
Δαμάστωρ	
Δανάη	
Δαναοί	the Danaans
Δαναός	
δαπανάω	to spend
Δαρδανία	
Δαρδάνιος	Trojan
Δαρδανίων	
Δάρδανος	Dardanus
Δάσκυλος	
δασμός	a division, distribution, sharing of spoil
δατέομαι	to divide among themselves
Δαυλία	Phocis
δέ	but
δέἀναγνωρισθεις	
δέβασιλευουσα	
δέἐμελλον	
δεῖ	it is binding on
δείδω	to fear
δείκνυμι	to bring to light, display, exhibit
δεινός	fearful, terrible, dread, dire
δεινόω	to make terrible: to exaggerate
Δεινώ	
δεῖξις	
δείξις	
δεῖπνον	the principal meal
δεῖπνος	
δειράς	the ridge of a chain of hills
δειρή	the neck, throat
δεῖσα	
δέκα	ten
δεκαετής	ten years old
δεκαμηνιαῖος	
δεκάτη	
δέκατος	tenth
δέλουσαμενος	
δέλτος	a writing-tablet
δελφίς	the dolphin
Δελφοί	the Delphians
Δελφύνη	
δέμω	to build
δένδρον	a tree
Δεξαμενός	
δεξιά	the right hand
Δεξιθέη	
δεξιόομαι	to greet with the right hand, welcome, greet
δεξιός	on the right hand or side
δέον	that which is binding, needful, right, proper
δέος	fear, alarm, affright
δέπαρελαβε	
δέπας	a beaker, goblet, chalice
δέρκομαι	to see clearly, see
Δέρκυνος	
δέρμα	the skin, hide
δέρος	
δεσμεύω	to fetter, put in chains
δέσμη	
δέσμιος	binding
δεσμός	anything for binding, a band, bond
δεσπότης	a master, lord, the master of the house
Δευκαλίων	
δεῦρο	hither
δεύτερος	second
δέχομαι	to take, accept, receive
δέω	
δή	exactness
Δηιάνειρα	destroying her spouse
Δηιδαμεία	
Δηϊκόων	
Δηίμαχος	
Δηιόνευς	
Δηϊοπίτης	
Δηιπύλη	
δηιφόβος	
Δηί̈φοβος	
Δηιφόντης	
Δηιών	
Δηλιάδης	
Δῆλος	Delos
δηλόω	to make visible or manifest, to show, exhibit
Δημάρατος	
Δημήτηρ	Demeter
Δημοκόων	
Δημονίκη	
Δημοπτόλεμος	
Δημοφῶν	
δηρός	long, too long
Δηρώ	
διά	through c. gen. through, by means of c. acc.
διά-ἀκέομαι	
διαβαίνω	to make a stride, walk or stand with the legs apart
διαβάλλω	to throw over or across, to carry over or across
διαβιβρώσκω	to eat up
διαγίγνομαι	to go through, pass
διαγιγνώσκω	to distinguish, discern
διάγω	to carry over or across
διαγωνίζομαι	to contend, struggle or fight against
διαδείκνυμι	to shew clearly, shew plainly
διαδέχομαι	to receive one from another
διάδοχος	succeeding
διαζεύγνυμαι	to be disjoined, separated, parted
διαθέω	to run about
διαιρέω	to take one from another, to cleave in twain, to divide into parts
διαίρω	to raise up, lift up
διακαθάρασαν	
διακληρόω	to assign by lot, allot
διακομίζω	to carry over or across
διακρίνω	to separate one from another
διακωλύω	to hinder, prevent
διαλλαγή	interchange, exchange
διαλλάσσω	to change one with another, interchange
διαλυμαίνομαι	to maltreat shamefully, undo utterly
διάλυσις	a loosing one from another, separating, parting
διαλύω	to loose one from another, to part asunder, undo
διανήχομαι	
διανίσταμαι	to stand aloof from, depart from
διανοέομαι	to be minded, intend, purpose
διαπαλαίω	to continue wrestling, go on wrestling
διαπάλλω	to distribute by lot
διάπειρα	an experiment, trial
διαπείρω	to drive through
διαπεράω	to go over or across
διαπλέω	to sail across
διαπορθμεύω	to carry over or across
διαπρεπής	eminent, distinguished, illustrious
διαπυρος	
διάπυρος	red-hot
διαρρήγνυμι	to break through, cleave asunder
διασπάω	to tear asunder, part forcibly
διασπείρω	to scatter abroad, throw about
διάστημα	an interval
διασῴζω	
διατελέω	to bring quite to an end, accomplish
διατελής	continuous, incessant
διατέμνω	to cut through, cut in twain, dissever
διατετραίνω	to bore through, make a hole in
διατίθημι	to place separately, arrange
διατρίβω	to rub between, rub hard, rub away, consume, waste
διαφέρω	to carry over or across
διαφεύγω	to flee through, get away from, escape
διαφθείρω	to destroy utterly
διάφορος	different, unlike
διδάσκω	to teach
δίδυμος	double, twofold, twain
διδυμοτόκος	
δίδωμι	to give
διείρω	to pass or draw through
διέξειμι	to go out through, pass through
διεξέρχομαι	to go through, pass through
διερείδομαι	to lean upon
διέρχομαι	to go through, pass through
Δίη	
διηγέομαι	to set out in detail, describe in full
διηνεκής	continuous, unbroken
Διιπετής	fallen from Zeus
διίστημι	to set apart, to place separately, separate
δικάζω	to judge, to give judgment on
δικαιοσύνη	righteousness, justice
δικαιόω	to set right
δικαστήνΝεοπτολεμον	
δικαστής	a judge
δικέφαλος	
δίκη	custom, usage
Δίκη	
Δίκτη	
Δίκτυς	
διό	wherefore, on which account
Διογενεία	
Διογενείη	
διοδεύω	to travel through
Διοκορυστής	
Διομήδης	Jove-counselled;
Διονύσιος	
Διόνυσος	Dionysus
Διονύσος	
διόπερ	
Διοπίθης	
δῖος	god-like, divine
Διόσκοροι	the sons of Zeus
Διόσκουροι	
διότι	for the reason that, since
διπλόος	twofold, double
διπλόω	to double
δίπους	two-footed
Δίρκη	
δισκεύω	to be pitched
δίσκος	a
δισσός	two-fold, double
δίφρος	the chariot-board
διφυής	of double form
διψάω	to thirst
διωγμός	the chase
διώκω	to pursue
Διώνη	
Διωξίππη	
δίωξις	chase, pursuit
δοκεύς	
δοκέω	videor mihi, to think, suppose, imagine, expect
δοκόν	
δοκός	a bearing-beam
δοκώ	
δόλιος	crafty, deceitful, treacherous
δολιόω	to deal treacherously with
Δολίχη	
Δολίων	
δόλος	a bait
Δόλοψ	
δολόω	to beguile, ensnare, take by craft
Δόλων	
δόξα	a notion
δορά	a skin, hide
δορεύς	
δόρυ	a stem, tree
Δορυκλεύς	
Δόρυκλος	
δουλεία	servitude, slavery, bondage
δούλειος	slavish, servile
δουλεύω	to be a slave
δούλη	
Δουλιχιεύς	
Δουλίχιος	
δοῦλος	a born bondman or slave
δοῦπος	any dead, heavy sound, a thud
δούρειος	
δράκαινα	a shedragon
δράκων	a dragon
δρασμός	a running away, flight
δρέπω	to pluck, cull
δρόμος	a course, running, race
Δρύας	
Δρύοψ	
δρῦς	a tree
Δύμας	
Δύμη	
δύναμαι	to be able, capable, strong enough
Δυναμένη	
δύναμις	power, might, strength
δυναστεία	power, lordship, sovereignty
δυναστεύω	to hold power or lordship, be powerful
Δυνάστης	
δυνάστης	a lord, master, ruler
δυνατός	strong, mighty, able
δύο	two
δύσις	a setting of the sun or stars
δυσοσμία	an ill smell, ill savour
δυσσέβεια	impiety, ungodliness
δυσσέβημα	
δυσώδης	ill-smelling
δύω	to strip off
δώδεκα	twelve
δωδεκαετής	years old
δωδέκατος	the twelfth
Δωδωνίς	
δωρέω	to give, present
Δωριεύς	a Dorian, descendant of Dorus
Δωρίζω	to imitate the Dorians in life, dialect
Δώριος	Dorian
Δωρίς	Dorian
δῶρον	a gift, present
Δῶρος	
Δωτίς	
Δωτώ	giver
ἕ	sui.
ἐάν	if haply
ἑαυτοῦ	itself, absolutely
ἐάω	to let, suffer, allow, permit
ἕβδομος	seventh
ἐγγράφω	to mark in or on, to paint on
ἐγγυάω	to give or hand over as a pledge
ἐγγύς	near, nigh, at hand
ἐγείρω	to awaken, wake up, rouse
ἐγκαθορμίζομαι	to run into harbour, come to anchor
ἐγκαλέω	to call in
ἐγκαταλείπω	to leave behind
Ἐγκέλαδος	
ἐγκέλαδος	
ἐγκέφαλος	that which is within the head, the brain
ἐγκρατής	in possession of power
ἐγκρύπτω	to hide or conceal in
ἐγκυμονέω	
ἔγκυος	
ἐγχαράσσω	to engrave upon
ἐγχειρίδιον	
ἐγχειρίδιος	in the hand
ἐγχειρίζω	to put into one's hands, entrust
Ἐγχέλεος	
ἐγχωρέω	to give room
ἐγχώριος	in or of the country
ἐγώ	ego
ἔδεσμα	meat
ἔδω	to eat
ἐθελοντής	
ἐθέλω	to will, wish, purpose
ἔθεσαν	
ἐθίζω	to accustom, use
ἔθνος	a number of people accustomed to live together, a company, body of men
Ἐθοδαί̈η	
ἔθω	to be accustomed
εἰ	whether.
εἴδομαι	are visible, appear
Εἰδομένευς	
Εἰδομένη	
εἶδον	to see, perceive, behold
Εἰδυία	
εἴδωλον	an image, a phantom
εἰκάζω	to make like to, represent by a likeness, portray
εἰκοσαετής	of twenty years
εἴκοσι	twenty
εἰκοσιδύο	
εἰκών	a likeness, image, portrait
Εἰλείθυια	Ilithyia
εἴλω	to roll up, pack
εἶμι	to go
εἰμί	to be, to exist
εἶπον	to speak, say
εἶπος	
εἰρεσία	rowing
Εἰρήνη	
εἴρω	
εἷς	
εἰς	into, to c. acc.
εἰσάγω	to lead in or into, to introduce
εἰσαίρω	to bring or carry in
εἰσβαίνω	to go into
εἴσειμι	to go into
εἰσελαύνω	to drive in
εἰσέρχομαι	to go in or into, enter
εἰσθέω	to run into, run up
εἰσίημι	to send into
εἰσ-κρύπτω	
εἴσοδος	a way in, entrance
εἰσ-περιμαίνομαι	
εἰσρέω	to stream in or into
εἰσΤαύρους	
εἰσ-τιτρώσκω	
εἴσω	to within, into
εἰσωθέω	to thrust into
εἶτα	then, next
εἴτε	
εἴτουν	
ἐκ	from out of
Ἑκάβη	
ἕκαστος	every, every one, each, each one
ἑκάτερος	each of two, either, each singly
ἑκατέρωσε	to each side, each way, both ways
ἑκάτη	
Ἑκάτη	Hecate, the far-darter
ἑκατόγχειρος	hundred-handed
ἑκατόν	a hundred
ἐκβάζω	to speak out, declare
ἐκβαίνω	to step out of or off from
ἐκβάλλω	to throw or cast out of
Ἔκβασος	
ἐκβράζω	to throw out
ἔκγονος	born of, sprung from
ἐκδέρω	to strip off the skin from
ἐκδέχομαι	to take or receive from
ἐκδέω	to bind so as to hang from, to fasten to or on
ἐκδίδωμι	to give up, surrender
ἐκδικάζω	to decide finally, settle
ἐκδικέω	to avenge, punish
ἐκδικία	
ἐκδιώκω	to chase away, banish
ἐκδύω	to take off, strip off
ἐκεῖ	there, in that place
ἐκεῖθεν	from that place, thence
ἐκεῖθι	
ἐκεῖνος	the person there, that person or thing
ἐκεῖσε	thither, to that place
ἐκζητέω	to seek out, enquire
ἐκθλίβω	to squeeze much: to distress greatly
ἐκ-θρῴσκω	
ἐκκαθαίρω	to cleanse out
ἐκκαθάρας	
ἔκκειμαι	to be cast out or exposed
ἐκκλέπτω	to steal and bring off secretly, to purloin
ἐκκλησία	an assembly of the citizens regularly summoned, the legislative assembly
ἐκκλύζω	to wash out
ἐκκόπτω	to cut out, knock out
ἐκλαλέω	to speak out, blab, divulge
ἐκλανθάνω	to escape notice utterly: —
ἐκλείπω	to leave out, omit, pass over
ἐκλέπω	to bring
ἔκλυτος	easy to let go, light, buoyant
ἐκμαίνω	to drive mad
ἐκμανθάνω	to learn thoroughly
ἐκμαρτυρέω	to bear witness to
ἐκμονομαχίας	
ἐκνήχομαι	to swim out or away
ἐκνίζω	to wash out, purge away
ἑκούσιος	voluntary
ἐκπέμπω	to send out or forth from
ἐκπετάννυμι	to spread out
ἐκπεφεύγοιτας	
ἐκπηδάω	to leap out
ἐκπίπτω	to fall out of
ἐκπλέω	to sail out, sail away, weigh anchor
ἐκποδών	away from the feet
ἐκπορθέω	to pillage
ἐκρέω	to flow out or forth
ἐκρίπτω	to cast forth
ἔκροος	a flowing out, outflow, outfall
ἐκροφέω	to drink out, gulp down
ἐκτείνω	to stretch out
ἐκτέμνω	to cut out
ἕκτη	
ἐκτίθημι	to set out, place outside
ἐκτίνω	to pay off, pay in full
ἕκτος	sixth
ἐκτός	outside
ἔκτοτε	
ἐκτρέπω	to turn out of the course, to turn aside
ἐκτρέφω	to bring up from childhood, rear up
ἐκτρέχω	to run out or forth, make a sally
ἐκ-τροχάζω	
ἐκ-τροχάω	
ἐκτυφλόω	to make quite blind
Ἕκτωρ	
ἕκτωρ	
ἐκφαίνω	to shew forth, bring to light, disclose, reveal, make manifest
ἐκφέρω	to carry out of
ἐκφορέω	to carry out
ἐκχωρέω	to go out and away, depart, emigrate
ἑκών	willing, of free will, readily
ἐλαία	the olive-tree
Ἐλαιόεις	
ἔλαιον	olive-oil
ἔλαιος	the wild olive
ἐλαιόω	
Ἐλαί̈σΣπερμω	
Ἐλάρη	
ἐλάτη	the silver fir, pinus picea
ἐλάτης	
Ἔλατος	
Ἐλάτων	
ἐλαύνω	to drive, drive on, set in motion
ἔλαφος	a deer
Ἐλαχείη	
ἐλάχιστος	the smallest, least
ἔλαχος	
ἐλαχύς	small, short, little
ἔλεγος	a song of mourning, a lament
ἐλέγχω	to disgrace, put to shame
ἐλεέω	to have pity on, shew mercy upon
Ἕλειος	
ἕλειος	of the marsh or meadow
ἑλένη	
Ἑλένη	
Ἕλενος	
ἔλεος	pity, mercy, compassion
Ἐλευθεραί	
ἐλεύθερος	free
Ἐλευθήρ	
Ἐλευθήρης	
Ἐλευσίνιος	of Eleusis
Ἐλευσίς	Eleusis, an old city of Attica
Ἐλεφαντίς	
Ἐλεφήνωρ	
Ἑλικωνιάδες	the dwellers on Helicon, the Muses
Ἕλιξ	
ἕλιξ	anything which assumes a spiral shape
ἑλκέω	to drag about, tear asunder
ἕλκος	a wound
ἑλκόω	to wound sorely, lacerate
ἕλκω	to draw, drag
ἑλλά	
Ἑλλάνικος	
Ἑλλάς	Hellas
Ἕλλη	
Ἕλλην	Hellen
Ἑλληνίς	a Grecian woman
ἝλλησιΚαλχας	
Ἑλλήσποντος	the Hellespont or sea of Helle
ἕλος	low ground by rivers, a marsh-meadow
Ἕλος	
Ἐλπήνωρ	
Ἔλυμοι	
ἔλυμος	
ἐλύω	to roll round
ἐμβάλλω	to throw in, put in
ἐμβιβάζω	to set in or on
ἐμμαίνομαι	to be mad at
ἐμμανής	in madness, frantic, raving
ἐμμεμαώς	in eager haste, eager
ἔμπειρος	experienced or practised in
ἐμπήγνυμι	to fix or plant in
ἐμπίμπρημι	to kindle, burn, set on fire
ἐμπίπλημι	to fill quite full
ἐμπίπτω	to fall in or upon or into
ἐμπλέκω	to plait or weave in
ἐμπλέω	to sail in
ἔμπνους	with the breath in one, breathing, alive
ἐμποιέω	to make in
ἐμπρήθω	to blow up, inflate
ἔμπροσθεν	before, in front
ἐμπτύω	to spit into
ἐμφορέω	to be borne about in or on
ἐν	in, among. c. dat.
ἐναγίζω	to offer sacrifice to the dead or manes
ἐναίρω	to slay
ἐναλλάσσω	to exchange
ἐναντίος	opposite
Ἐναρέτη	
ἐναρμόζω	to fit or fix in
Ἐναροφόρος	
ἔνατος	ninth
ἐν-βροχίζω	
ἑνδέκατος	the eleventh
ἐνδέω	
Ἐνδηίς	
ἐνδίδωμι	to give in
ἔνδιον	
ἔνδιος	at midday, at noon
Ἔνδιος	
ἔνδοθεν	from within
ἔνδον	in, within, in the house, at home
ἔνδοξος	held in esteem or honour, of high repute
Ἐνδυμίων	
ἐνδύω	to go into
ἐν-ἐγγυάω	
ἐνεδρεύω	to lie in wait for
ἐνἘλευσῖνι	
ἐνεσία	a suggestion
ἐνέχω	to hold within
ἔνθα	there
ἐνθεάζω	to be inspired
ἔνθεν	on the one side
ἔνθεος	full of the god, inspired, possessed
ἐν-θρῴσκω	
ἐνιαυσιαῖος	
ἐνιαυτός	any long period of time, a cycle, period
ἐνίημι	to send in or into
ἔνιοι	some
Ἐνιπεύς	
ἐνίπτω	to reprove, upbraid
ἐνίστημι	to put, set, place in
ἐνναέτηἙρμιονην	
ἐνναετής	nine years old
ἐννέα	nine
Ἐννέη	
ἐννεσία	
Ἔννομος	
ἔννομος	within the law, lawful, legal
ἐνοικέω	to dwell in
ἐνοικοδομέω	to build in
ἔνοπλος	in arms, armed
ἕνος	belonging to the former of two periods, last year's
ἐνράπτω	to sew up in
ἐνταῦθα	here, there
ἐντάφιος	of or used in burial
ἐντείνω	to stretch or strain tight
Ἐντελίδης	
ἐντέλλω	to enjoin, command
ἐντεῦθεν	hence or thence
ἐντίθημι	to put in or into
ἐντολή	an injunction, order, command, behest
ἔντονος	well-strung, sinewy
ἐντός	within, inside
ἐντυγχάνω	to light upon, fall in with, meet with
Ἐνυώ	Enyo
ἕξ	six
ἐξαγριόω	to make wild or waste
ἐξαιρετός	that can be taken out, removable
ἐξαιρέω	to take out of
ἐξαίρω	
ἐξαίφνης	on a sudden
ἐξακέομαι	to heal completely, heal the wound, make amends
ἐξαμβλόω	to make to miscarry
ἑξαμηνιαῖος	
ἐξανεμόω	to blow out with wind, inflate
ἐξανίστημι	to raise up: to make one rise
ἐξαπατάω	to deceive or beguile thoroughly
ἐξάπτω	to fasten from
ἐξαρπάζω	to snatch away from
ἐξαφίημι	to send forth, discharge
ἐξεικάζω	to make like, to adapt
ἐξείλλω	to disentangle
ἔξειμι	to go out, come out
ἐξεῖπον	to speak out, tell out, declare
ἐξελαύνω	to drive out from
ἐξέλκω	to draw or drag out
ἐξεμέω	to vomit forth, disgorge
ἐξέρχομαι	to go or come out of
ἔξεστι	it is allowed, it is in one's power, is possible
ἐξευρίσκω	to find out, discover
ἐξευτελίζω	to disparage greatly
ἐξέχω	to stand out or project from
ἑξῆς	one after another, in order, in a row
ἐξίημι	to send out, let
ἐξιλάσκομαι	to propitiate
ἕξις	a having, possession
ἐξισόω	to make equal or even bring to a level with
ἔξοδος	
Ἐξόλη	
ἐξορκίζω	to adjure
ἐξορύσσω	to dig out
ἐξουσία	power or authority
ἔξοχος	standing out
ἔξω	out
ἐξωθέω	to thrust out, force out, wrench out
ἔοικα	to be like
ἑορτή	a feast or festival, holiday
ἐπαγγέλλω	to tell, proclaim, announce
ἐπάγγελμα	a promise, profession
ἐπάγνυμι	to break
ἐπάγω	to bring on
ἐπ'Ἀθήνας	
ἐπαινέω	to approve, applaud, commend
ἐπαιτέω	to ask besides
ἐπαίτης	
ἐπακολουθέω	to follow close upon, follow after
ἐπαμύνω	to come to aid, defend, assist
ἐπανάγω	to bring up: to stir up, excite
ἐπάνειμι	to go back, return
ἐπανέρχομαι	to go back, return
ἐπάνοδος	a rising up
ἐπαράομαι	to imprecate curses upon
ἐπάρχω	to be governor of
ἔπαυλις	a fold
ἐπαύω	to shout over
Ἔπαφος	
ἐπεί	after that, after (postquam), since, when (quum)
ἐπείγω	to press down, weigh down
ἐπειδάν	whenever.
ἔπειμι	to be upon
Ἐπειός	
ἐπείπερ	seeing that
ἐπεισέρχομαι	to come in besides
ἔπειτα	thereupon
ἐπέρχομαι	to come upon, come near, come suddenly upon
ἐπερωτάω	to inquire of, question, consult
ἐπέχω	to have or hold upon
ἐπί	on, upon with gen., dat., and acc.
ἐπιβαίνω	to go upon
ἐπιβιβάζω	to put
ἐπιβοάω	to call upon or to, cry out to
ἐπιβοηθέω	to come to aid, to succour
ἐπιβουλεύω	to plan or contrive against
ἐπιβουλή	a plan against
ἐπίβουλος	plotting against
ἐπιγαμέω	to marry besides
ἐπιγίγνομαι	to be born after, come into being after
ἐπιγιγνώσκω	to look upon, witness, observe
ἐπίγονος	born besides
Ἐπίδαυρος	
ἐπιδείκνυμι	to exhibit as a specimen
ἐπιδίδωμι	to give besides
ἐπιδιώκω	to pursue after
ἐπιέννυμι	to put on besides or over
ἐπιζητέω	to seek after, wish for, miss
ἐπιθυμέω	to set one's heart upon
ἐπιθυμία	desire, yearning, longing
ἐπιθυμιάω	to offer incense
ἐπικαίω	to light up
ἐπικαλέω	to call upon
ἐπίκλην	by surname, by name
ἐπίκλησις	a surname or additional name;
ἐπικλύζω	to overflow
Ἐπικνημίδιοι	
Ἐπικνημίδιος	
ἐπικουρέω	to act as an ally
Ἐπιλάις	
ἐπιλαμβάνω	to lay hold of, seize, attack
Ἐπίλαος	
ἐπί-λέγω	
ἐπιλήθω	to cause to forget
ἐπιμαστίδιος	at the breast, not yet weaned
ἐπιμελέομαι	to take care of, have charge of, have the management of
ἐπιμελητής	one who has charge of
ἐπιμένω	to stay on, tarry or abide still
Ἐπιμηθεύς	Epi-metheus, after-thought
ἐπιμηθής	thoughtful
ἐπινέμω	to allot, distribute
ἐπινοέω	to think on or of, contrive
ἐπιξενόομαι	to have hospitable relations with, be intimate with
ἐπιπέμπω	to send besides or again
ἐπιπέτομαι	to fly to or towards
ἐπιπλέω	to sail upon or over
ἐπιπλήσσω	to strike at, strike smartly
ἐπιπρεσβεύομαι	to send an embassy
ἐπιρρίπτω	to cast at
ἐπισεύω	to put in motion against, set upon
ἐπισκέπω	to cover over
ἐπισκήπτω	to make to lean upon, make to fall upon
ἔπισος	
ἐπισπάω	to draw or drag after
ἐπιστασία	authority, dominion
ἐπιστάσιος	Jupiter Stator
ἐπιστέλλω	to send to, send as a message or letter
ἐπιστήμη	acquaintance with
ἐπιστολή	a message, command, commission
ἐπιστρατεύω	to march against, make war upon
ἐπιστρέφω	to turn about, turn round
Ἐπίστροφος	
ἐπίστροφος	having dealings with, conversant with
ἐπιταγή	
ἐπιτάσσω	to put upon
ἐπιτελέω	to complete, finish, accomplish
ἐπιτελής	brought to an end, completed, accomplished
ἐπιτέλλω	to lay upon, enjoin, prescribe, ordain, command
ἐπιτήδειος	made for an end or purpose, fit or adapted for it, suitable, convenient
ἐπιτηρέω	to look out for
ἐπιτίθημι	to lay, put or place upon
ἐπίτοκος	
ἐπιτρέπω	to turn towards
ἐπιτυγχάνω	to hit the mark
ἐπιφαίνω	to shew forth, display, shew off
ἐπιφέρω	to bring, put or lay upon
ἐπιφοιτάω	to come habitually to, visit again and again
ἐπιχειρέω	to put one's hand on
ἐπιχωρέω	to give way, yield
ἐπιχώριος	in or of the country
ἐποδύρομαι	to lament over
ἕπομαι	
Ἔποχος	
ἔποχος	mounted upon
ἔποψ	the hoopoe
ἑπτά	seven
ἑπταμηνιαῖος	
ἑπτάς	
ἐπώνυμος	given as a name
Ἐπωπεύς	
ἐπωπεύς	
Ἐπώπευς	
ἔρα	
ἔραμαι	to love, to be in love with
ἔρανος	a meal to which each contributed his share
Ἐράσιππος	
ἐρατός	lovely, charming
Ἐρατώ	Erato, the lovely
ἐράω	
ἐργάζομαι	to work, labour
Ἐργῖνος	
ἔρδω	to do
ἐρεβώδης	
ἔρευνα	inquiry, search
ἐρευνάω	to seek or search for, search after, track
Ἐρεχθεύς	the render
Ἐρεχθηίς	
ἐρημία	a solitude, desert, wilderness
ἐρῆμος	desolate, lone, lonely, lonesome, solitary
ἐρίζω	to strive, wrangle, quarrel
ἐρινεόν	
ἐρινεός	the wild fig-tree
ἐρινεοῦἑστωσης	
Ἐρινύς	the Erinys or Fury
ἐρινύω	
ἔριον	wool
ἔρις	strife, quarrel, debate, contention
Ἔρις	
ἔριφος	a young goat, kid
Ἐριφύλη	
Ἐριχθόνιος	
ἑρκεῖος	of or in the
ἕρκειος	
Ἑρμῆς	Hermes
Ἑρμιονεύς	
Ἑρμιονή	
Ἑρμιόνη	
Ἕρμος	
ἔρομαι	to ask, enquire
ἔρος	
ἑρπετόν	a walking animal, quadruped
ἔρσα	dew
Ἕρση	
ἕρση	
Ἐρυθεία	
Ἐρύθρης	
Ἐρύθριος	
Ἐρυμάνθιος	
Ἐρύμανθος	
Ἔρυξ	
Ἐρυσίχθων	
ἔρχομαι	to come or go
ἐρῶ	I will say or speak
ἐρώμενος	one's love
ἔρως	love
ἐρωτάω	to ask
ἐρωτικός	amatory
ἐσθής	dress, clothing, raiment
ἐσθίω	to eat
ἑσπέρα	evening, eventide, eve
Ἑσπερία	
Ἑσπερίη	
ἑσπέριος	at even, at eventide
Ἑσπέριος	
ἑσπερίς	the Hesperides
Ἑσπερίς	
Ἑστία	Vesta
ἑστία	the hearth of a house, fireside
Ἑστιαίη	
ἑστιάω	to receive at one's hearth or in one's house: to entertain, feast, regale
ἕστιος	
ἐσχάρα	the hearth, fire-place
ἔσχατος	outermost
ἔσωσενἈντηνωρ	
ἐτάζω	to examine, test
ἔται	
ἑταῖρος	a comrade, companion, mate
ἔτειδευτερῳ	
Ἐτεοκλῆς	
Ἐτέοκλος	
ἕτερος	one of the
Ἐτεωνεύς	
ἔτης	clansmen
ἐτήσιος	lasting a year, a year long
ἔτι	yet, as yet, still
ἑτοιμάζω	to make or get ready, prepare, provide
ἑτοῖμος	at hand, ready, prepared
ἔτος	a year
εὐαγορέω	
Εὐαγόρη	
Εὐαγόρης	
Εὐάδνη	
Εὐαίμων	
εὐάλωτος	easy to be taken or caught
Εὔανδρος	
Εὐβοεύς	an Euboean
Εὔβοια	Euboea
Εὐβώτη	
Εὐδώρη	
εὐεργεσία	well-doing
Εὐηνορίδης	
Εὔηνος	
Εὐήρης	
εὐθέως	
εὐθής	
εὐθύς	
Εὐίππη	
Εὔιππος	
Εὐκράντη	
εὐλαβέομαι	to behave like the
Εὐλιμένη	
Εὔμαιος	
Εὐμενίδες	the gracious goddesses
Εὐμήδης	
Εὔμηλος	
Εὐμήτης	
εὐμολπέω	to sing well
Εὐμόλπη	
Εὔμολπος	
εὐμορφία	beauty of form, symmetry
Εὔμων	
εὐνάζω	to lay or place in ambush
εὐνάω	to lay or place in ambush
εὐνή	a bed
Εὔνηος	
Εὐνίκη	
εὐνομία	good order, order
Εὐνομίη	
Εὔνομος	
Εὐξάνθιος	
Εὐπάλαμος	
Εὐπίνυτος	
εὐπλοέω	
εὕρεσις	a finding, discovery
εὑρετής	an inventor, discoverer
Εὐριπίδης	
εὑρίσκω	to find
Εὐρονόμη	
Εὐρυ	
Εὐρυάλη	
Εὐρύαλος	
εὐρυβίας	
Εὐρυβίη	
Εὐρύβιος	
Εὐρυγανείη	
εὐρυγάστωρ	
Εὐρυδάμας	
Εὐρυδίκη	
Εὐρύθεμις	
Εὐρύκαπυς	
Εὐρύλοχος	
Εὐρυμέδη	
Εὐρυμέδων	
Εὐρυμένης	
Εὐρυνόμη	
Εὐρύνομος	
εὐρύοπα	the far-seeing
Εὐρυόπης	
Εὐρυπύλη	
Εὐρύπυλος	
Εὐρυσθένης	
Εὐρυσθεύς	
Εὐρύστρατος	
Εὐρυτέλη	
Εὐρύτη	
εὐρύτης	
Εὐρυτίων	
Εὔρυτος	
Ἔυρυτος	
Εὐρώπη	Europa, Europe
Εὐρώπης	
Εὐρώτης	
εὐσέβεια	reverence towards the gods, piety, religion
εὐσεβής	righteous
εὐστοχέω	
Εὔσωρος	
Εὐτείχης	
εὔτεκνος	blest with children
Εὐτέρπη	
εὐτυχέω	to be well off, successful, prosperous
Εὔφημος	
Εὔφορβος	
Εὐφορίων	
Εὐφροσύνη	
εὐφρόσυνος	in good cheer
εὐφυία	natural goodness of shape, shapeliness
εὐχή	a prayer, vow
Εὐχήνωρ	
εὔχομαι	to pray, offer prayers, pay one's vows, make a vow
εὐωχέω	to treat or feed well, entertain sumptuously
εὐωχία	good cheer, feasting
ἐφάπτω	to bind on or to
ἐφέζομαι	to sit upon
ἐφέλκω	to draw on, drag or trail after
Ἔφεσος	
ἐφήκω	to have arrived
ἔφημαι	to be set or seated on, to sit on
ἐφήμερον	
ἐφήμερος	living but a day, short-lived
Ἐφιάλτης	
ἐφιάλτης	
ἐφίζω	to set upon
ἐφίημι	to send to
ἐφίστημι	to set or place upon
ἐφοράω	to oversee, observe, survey
ἐφορεύω	to be ephor
ἐφορμάω	to stir up, rouse against
ἐφορμέω	to lie moored at or over against
ἐφορμή	a way of attack
Ἔφυρα	
Ἐφύρα	Ephyra
ἐφύω	to rain upon
Ἐχέδωρος	
Ἐχέμμων	
Ἔχεμος	
ἐχέφρων	sensible, prudent, discreet
Ἐχέφρων	
ἔχθρα	
ἔχθρη	hatred, enmity
Ἔχιδνα	
ἔχιδνα	an adder, viper
Ἐχινάδες	
Ἐχῖναι	the islands in the Ionian sea
ἔχιον	
Ἐχίος	
ἔχις	an adder, viper
Ἐχίων	
ἐχομένως	
ἔχω	to have or to hold
ἔχωνἀσκον	
ἔχωσιτοξα	
ἕψω	to boil, seethe
ἕως	until, till
Ἑωσφόρος	bringer of morn
ζ	
Ζάκυνθος	
ζάλη	the surging
ζάω	to live
Ζελίη	
ζεστός	
ζεύγνυμι	to yoke, put to
Ζευξίππη	
Ζεύς	Zeus
ζέω	to boil, seethe
Ζῆθος	
ζῆλος	eager rivalry, zealous imitation, emulation
Ζῆλος	
ζητέω	to seek, seek for
Ζήτης	
ζήτησις	a seeking, seeking for, search for
ζώιον	
ζώννυμι	to gird
ζῷον	a living being, animal
ζωστήρ	a girdle
ἤ	
ᾗ	which way, where, whither, in or at what place
ἡβάω	to be at man's estate, to be in the prime of youth
Ἥβη	
ἥβη	manhood, youthful prime, youth
ἡγεμόνεια	
ἡγεμονία	a leading the way, going first
ἡγεμών	one who leads
ἡγέομαι	to go before, lead the way
ἤγουν	that is to say, or rather
ἠδέ	and
ἤδη	by this time, before this, already
ἥδομαι	to enjoy oneself, take delight, take one's pleasure
ἡδονά	
ἡδονή	delight, enjoyment, pleasure
ἦδος	delight, enjoyment, pleasure
ἡδύς	sweet
Ἠδωνοί	
Ἠετίων	
ἡἼλιος	
Ἠιόνη	
ἠιών	a sea-bank, shore, beach
ἥκω	to have come, be present, be here
ἠλακάτη	a distaff
Ἠλεῖος	
Ἠλέκτρη	
Ἠλεκτρύων	
ἡλιακός	
ἡλικιώτης	an equal in age, fellow, comrade
ἡλίκος	as big as
ἧλιξ	of the same age
ἥλιος	the sun
Ἥλιος	
Ἦλις	
ἧλος	a nail
Ἠλύσιον	the Elysian fields
Ἠλύσιος	Elysian
Ἠμαθίων	
ἡμέρα	day
ἥμερος	tame, tamed, reclaimed
ἡμερόω	to tame, make tame
ἠμί	I say
ἡμιθέα	
Ἡμιθέη	
ἡμίθεος	a half-god, demigod
ἡμίθηρ	
ἡμιθνής	
ἥμισυς	half
ἡνία	
ἡνίκα	at which time, when
ἡνιοχέω	to hold the reins
ἡνίοχος	one who holds the reins, a driver, charioteer
ἧπαρ	the liver
ἥπατος	
Ἤπειρος	
ἤπειρος	terra-firma, the land
ἠπειρόω	to make into mainland
ᾗπερ	in the same way as
Ἥρα	Hera
ἤρα	acceptable gifts, kindnesses
Ἡραίευς	
Ἡραιεύς	
Ἡράκλεα	
Ἡρακλέης	Heracles
Ἡρακλεία	
Ἡράκλειδαι	the Heraclidae or descendants of Hercules
Ἡρακλεῖδαι	
Ἡρακλείδης	
Ἡράκλειος	of Hercules
Ἠριγόνη	
Ἠριδανός	Eridanus
Ἡρόδωρος	
ἥρπασενἈντιοπην	
ἡρωίς	
ἥρως	warriors
Ἡσίοδος	
Ἡσιόνη	
ἡσσάομαι	to be less than another, inferior to
ἥσσων	less, weaker, less brave
Ἡσυχείη	
ἠύτε	as, like as
Ἡφαιστίνη	
Ἥφαιστος	Hephaestus
ἡφαιστότευκτος	
Ἠώνη	
Ἠώς	
ἠώς	the morning red, daybreak, dawn
θ	
Θαδύτιος	
θάλαμος	an inner room or chamber
θάλασσα	the sea
θαλάσσιος	of, in, on or from the sea, belonging to it
θαλασσοκρατέω	to be master of the sea
Θάλεια	
θάλλω	to bloom, abound, to be luxuriant
Θάλπιος	
θάλπος	warmth, heat
Θάμυρις	
θάνατος	death
θανατόω	to put to death
θάπτω	to pay the last dues to a corpse, to honour with funeral rites
θαρσέω	to be of good courage, take courage
Θάσος	
θαυμάζω	to wonder, marvel, be astonied
Θαύμακος	
Θαύμας	
θεά	a goddess
θέα	a seeing, looking at, view
Θεανώ	
θεάομαι	to look on, gaze at, view, behold
θεία	
Θείας	
Θείη	
Θείης	
Θειοδάμας	
θεῖος	
Θελξιεπεία	
Θελξίων	
θεμέλιος	of or for the foundation
Θέμις	
Θεμίσκυρα	
Θεμισκύρη	
Θεμίστη	
θεμιστός	
Θεμιστώ	
θεός	God
Θεόφρων	
θεράπαινα	a waiting maid, handmaid
θεραπεία	a waiting on, service
θεραπείη	
θεραπεύω	to be an attendant, do service
θεράπων	a waiting-man, attendant
θερμαίνω	to warm, heat
Θερμυδραί	
Θερμώδων	
Θέρσανδρος	
Θερσίλοχος	
Θερσίτης	Thersites
θέρω	to heat, make hot
θεσμοφόρια	an ancient festival held by the Athenian women in honour of Demeter
θεσμοφόριον	the temple of Demeter
θεσμοφόριος	
θεσπίζω	to declare by oracle, prophesy, divine
Θεσπίη	
Θεσπίης	
Θέσπιος	
Θεσπιός	
θεσπιῳδέω	to prophesy, sing in prophetic strain
Θεσπρωτοί	
Θεσπρωτός	
Θεσσαλία	
Θεσσαλίη	
Θεσσαλός	a Thessalian
Θεστάλος	
Θέστιος	
Θέτις	Thetis
θετός	taken as one's child, adopted
θέω	to run
θεωρέω	to look at, view, behold
θεωρός	a spectator
Θῆβαι	Thebes
Θηβαῖος	Theban
Θηβαίς	the Thebais
Θήβασἐπι	
Θήβη	
θηλή	the part of the breast which gives suck, the teat, nipple
θῆλυς	female
θήρ	a wild beast, beast of prey
θήρα	a hunting of wild beasts, the chase
θηράω	to hunt or chase
θηρευτικός	of or for hunting
θηρεύω	to hunt, go hunting
Θηρίμαχος	
θηρίον	a wild animal, beast
θηριόω	to make into a wild beast.
Θησεύς	Theseus
θητεία	hired service, service
θητεύω	to be a serf or menial, serve for hire
θνήσκω	to die, be dying
θνητός	liable to death, mortal
θοάζω	to move quickly, ply rapidly
Θόας	
Θόη	
θοινάω	to feast on, eat
Θορικός	
Θούριος	
Θόων	
Θόωσα	speed
Θράκευς	
Θρᾴκη	Thrace
Θράκη	
Θρᾳκίας	
Θρᾴκιος	
Θράκιος	Thracian
Θρᾷξ	a Thracian;
Θρασυμήδης	
θραύω	to break in pieces, shatter, shiver
θρεψίππας	
Θρεψίππης	
θρηνέω	to sing a dirge, to wail
Θριάσιος	
Θρίασος	
Θρινακίη	three
Θρινάκιος	
θρίξ	the hair of the head
θρόνον	flowers embroidered on cloth, patterns
θρόνος	a seat, chair
θυγάτηρ	a daughter
Θυέστης	
θύεστον	
Θυμβραῖος	
θυμός	the soul
θύον	
θύος	a sacrifice, offering
θυόω	to fill with sweet smells
θύρα	a door
Θυρέη	
Θύρευς	
θύρσος	the thyrsus or Bacchic wand
θυσία	an offering or mode of offering
θυσιάζω	to sacrifice
θύω	
Θυώνη	
θώραξ	a breastplate, cuirass, corslet
ια	
Ἰαλεβίων	
Ἰάλμενος	
Ἰάμβη	
Ἰάνειρα	
ἰάομαι	to heal, cure
Ιαπετός	
Ἰαπετός	
Ἰάρδανος	
Ἰάσιος	
ἴασις	healing, a mode of healing, cure, remedy
Ἰασίων	
Ἴασος	
Ἰάσων	
ἰατρικός	of or for a surgeon
ἰατρός	one who heals, a mediciner, physician or surgeon
ιβ	
Ἰβηρίη	
Ἰβηρικός	
Ἰδαῖος	of Ida
ἰδέα	form
ἴδη	a timber-tree
Ἴδη	Ida
Ἴδης	
ἴδιος	one's own, pertaining to oneself
ἰδίω	to sweat
Ἴδμων	
ἴδμων	skilled, skilful
Ἰδομενεύς	strength of Ida
ἶδος	violent heat
ἰδοῦσακαι	
ἱδρύω	to make to sit down, to seat
ἱερά	
ἱεραί	
ἱέραξ	a hawk, falcon
Ἵεραξ	
ἱέρεια	a priestess
ἱερεῖον	a victim, an animal for sacrifice or slaughter
ἱερεύς	a priest, sacrificer
ἱερή	
Ἱερομνήμη	
ἱερόν	
ἱερός	super-human, mighty, divine, wonderful
ἱερουργέω	to perform sacred rites
ἱερόω	to hallow, consecrate, dedicate
ἱερωσύνη	the office of priest, priesthood
ἱερώσυνος	
ἵημι	to set a going, put in motion
Ἰθάκη	Ithaca
Ἴθακος	
ἰθυβόλος	
Ἰκάριος	Icarian
Ἴκαρος	
Ἱκετάων	
ἱκετεύω	to approach as a suppliant
ἱκετήριος	of or fit for suppliants
ἱκέτης	one who comes to seek protection, a suppliant or fugitive
ἵκετις	
ἱκέτις	
ἱλάειρα	
Ἱλαείρα	
Ἰλιάς	Troy, the Troad
Ἴλιον	
Ἴλιος	Ilian, Trojan
Ἰλισσός	
Ἰλλυρία	
Ἰλλυρίη	
Ἰλλυριοί	
Ἰλλυριός	
Ἰλλυρίς	
Ἶλος	
Ἴμβρος	
Ἰμεύσιμος	
ἵνα	in that place, there
Ἰνάχειος	
Ἴναχος	
Ἰνδικός	Indian
Ἴνδιος	
Ἰνδός	an Indian
Ἰνώ	Ino
ἰξίον	
Ἴξιος	
Ἰξίων	Ixion
Ἰοβάτης	
Ἰόβης	
Ἰοκάστη	
Ἰόλαος	
Ἰόλευς	
Ἰόλη	
Ἰόνη	
Ἰόνιος	of or called after Io
ἰός	
Ἱππάλκιμος	
Ἵππαλμος	
Ἵππασος	
Ἱππεύς	
ἱππεύς	a horseman
Ἱπποδάμας	
Ἱπποδάμεια	
Ἱπποδαμείη	
Ἱπποδάμειον	
Ἱπποδίκη	
Ἱππόδοχος	
Ἱπποδρόμος	
ἱπποδρόμος	a light horseman
Ἱππόζυγος	
Ἱπποθόη	
Ἱππόθοος	
ἱππόθοος	
Ἱπποκορυστής	
ἱπποκορυστής	equipt or furnished with horses
Ἱπποκόων	
Ἱπποκοωντίδαι	
ἱπποκρατέω	to be superior in horse
Ἱπποκράτη	
Ἱπποκράτης	
Ἱππόλοχος	
Ἱππολύτη	
Ἱππόλυτος	
ἱππόλυτος	
Ἱππόμαχος	
ἱππόμαχος	
ἱππομάχος	fighting on horseback, a trooper
Ἱππομεδούσα	
Ἱππομέδων	
Ἱππομένης	
Ἱππονόη	
Ἱππονόμη	
Ἱππόνοος	
ἵππος	a horse, mare
Ἱππόστρατος	
ἱππότης	a driver or rider of horses, a horseman, knight
Ἱππότης	
ἱπποφορβός	a horse-keeper
ἵππωνκατηρραχθη	
Ἵππωτος	
Ἶρις	Iris
ἶρις	
Ἶρος	
Ἴσθμια	
Ἰσθμιάς	Isthmian
ἴσθμιον	anything on the neck, a necklace
ἴσθμιος	Isthmian
Ἴσθμιος	
ἰσθμός	any narrow passage
Ἶσις	Isis
Ἴσμαρος	
Ἰσμήνη	
Ἰσμηνός	
ἴσος	equal to, the same as
ἰσόω	to make equal
ἱστάω	
ἵστημι	to make to stand
ἱστίον	any web, a sail
ἱστορέω	to inquire into
ἱστορία	a learning by inquiry, inquiry
ἱστός	anything set upright
Ἴστρος	
ἰσχυρός	strong, mighty
Ἴσχυς	
ἰσχύς	strength
ἴσχω	to hold, check, curb, keep back, restrain
Ἰταλία	
ἰταλός	
Ἴτανος	
ἴτυς	a circle made of willow
Ἴτυς	
Ἴτωνος	
ἰφιγένεια	strong-born
Ἰφιγενεία	
Ἰφιδάμας	
Ἰφικλέης	
Ίφικλος	
Ἴφικλος	
Ἰφιμέδεια	
Ἰφιμεδούσα	
Ἰφιμέδων	
Ἰφινόη	
ἴφιος	stout, fat, goodly
Ἴφις	
Ἶφις	
Ἴφιτος	
ἴχνος	a track, footstep
ἰχώρ	ichor, the etherial juice
ἰώ	oh!
Ἰώ	Io
Ἰωλκός	
Ἴων	Ion
Καδμεῖος	Cadmean
Κάδμος	Cadmus
καθά	according as, just as
καθαιρέω	to take down
καθαίρω	to make pure or clean, cleanse, clean, purge
καθᾶραι	
καθάρας	
καθαρμός	a cleansing, purification
καθάρσιος	cleansing
κάθαρσις	a cleansing
καθέννυμι	to clothe
καθέψω	to boil down
καθηγεμών	a leader, a guide
καθήκω	to have come or gone down
καθηλόω	to nail on or to
κάθημαι	to be seated
καθίζω	to make to sit down, seat
καθίημι	to send down, let fall
καθίστημι	to set down, place
καθό	in so far as, according as
καθοδηγός	
κάθοδος	a going down, descent
καθόλου	on the whole, in general
καθοπλίζω	to equip or arm fully
καθορμίζω	to bring
καθοσιόομαι	to dedicate
καθυπέρτερος	above
καθώς	how
καί	and
καίἀποθανατισθεις	
καίἀποθανοντος	
καίεὑρων	
καίΚασανδραν	
Καινεύς	
καίπερ	although, albeit
καίπολλα	
καιρός	due measure, proportion, fitness
καίτοι	and indeed, and further
καίτους	
καίω	to light, kindle
κάκη	wickedness, vice
κακός	bad
κάκουργος	
κακοῦργος	doing ill, mischievous, knavish, villanous
κακόω	to treat ill, maltreat, afflict, distress
Κάλαις	
Καλάμητις	
καλέω	to call, summon
κάλη	
Καλιάδνη	
καλλία	
καλλίας	
Καλλιδίκη	
Καλλίης	
Καλλιλέων	
καλλίνικος	with glorious victory
Καλλιόπη	Calliope, the beautiful-voiced
Καλλιρρόη	
Καλλιστώ	most-beautiful
Καλλίχορον	
καλλίχορος	with beautiful places
κάλλος	beauty
καλός	beautiful, beauteous, fair
Καλύβη	
Καλυδών	
Καλυδωνεύς	
Καλυδώνιος	
Καλύκη	
καλύπτρα	a woman's veil
καλύπτω	to cover with
Καλυψώ	
Κάλχας	Calchas
κάλχη	the murex or purple limpet.
κάματος	toil, trouble, labour
Κάμικος	
κάμνω	to work
Καμπανοί	
Κάμπη	
καμπή	a bending, winding
κάμπος	
κάμπτω	to bend, curve
Κανάκη	
Κάναστρον	
κἄναὐτος	
Κάνηθος	
Καπανεύς	
καπνός	smoke
κάπρος	the boar, wild boar
Καπύλος	
Κάπυς	
Κάρ	a Carian
κάρ	hair cut off, a lock of hair
κάρα	the head
καρατομέω	to cut off the head, behead
καρδία	the heart
Καρικός	Carian
Κάριος	
καρκίνος	a crab
κάρον	
καρπός	
καρποφορέω	to bear fruit
καρπόω	to bear fruit or bear as fruit
καρτερός	strong, staunch, stout, sturdy;
Καρτέρων	
καρώ	
Κασάνδρη	
Κάσιος	
Κασσιεπεία	
Κασσιέπεια	
Κάστωρ	Castor
κατά	down, downwards, with gen. or acc.
κατά-ἀλέγω	
κατά-ἀντάω	
καταβαίνω	to step down, go or come down
κατάβασις	a going down, way down, descent
καταβιβρώσκω	to eat up, devour
καταγελάω	to laugh at, jeer or mock at
κατάγνυμι	to break in pieces, shatter, shiver, crack
κατάγω	to lead down
καταδέομαι	
καταδέχομαι	to receive, admit
καταδέω	
καταδικάζω	to give judgment against
καταδιώκω	to pursue closely
κατά-ἕζομαι	
καταζεύγνυμι	to yoke together, yoke
κατάζευξις	a yoking together
καταθέω	to run down
καταθύω	to sacrifice
καταίρω	to come down, make a swoop
καταισχύνω	to disgrace, dishonour, put to shame
κατά-καθέζομαι	
κατακαίω	to burn down, burn completely
κατακαλύπτω	to cover up
κατακλείω	to shut in, inclose
κατακλίνω	to lay down
κατακλύζω	to dash over, flood, deluge, inundate
κατακλυσμός	a deluge, inundation
κατακοιμίζω	
κατακοντίζω	to shoot down
κατακρίνω	to give as sentence against
κατακρύπτω	to cover over, hide away, conceal
καταλαμβάνω	to seize upon, lay hold of
κατά-λέγω	
καταλέγω	to lay down
καταλείπω	to leave behind
καταλεύω	to stone to death
καταλέω	to grind down
κατάληψις	a seizing
καταλύω	to put down, destroy
καταμαρτυρέω	to bear witness against
καταμελέω	to take no care of
καταμέμφομαι	to find great fault with, blame greatly, accuse
καταμένω	to stay behind, stay
καταναλίσκω	to use up, spend, lavish
κατανεύω	to nod assent
κατά-ὀδύρομαι	
καταπαύω	to lay to rest, put an end to
καταπέτομαι	to fly down
καταπίμπρημι	to burn to ashes
καταπίνω	to gulp or swallow down
καταπλάσσω	to plaster over with
κατάπλεος	quite full
καταπλέω	to sail down
καταπλήσσω	to strike down
καταπολεμέω	to war down
κατά-πτερόω	
κατάρα	a curse
καταράομαι	to call down curses upon, imprecate upon
καταράσσω	
κατάρης	
καταριθμέω	to count or reckon among
καταρόω	to plough up
κατάρχω	to make beginning of
κατασκευάζω	to equip or furnish fully
κατασκευή	preparation
κατάσκοπος	one who keeps a look out, a scout, spy
κατασπείρω	to sow thickly
καταστερίζω	
καταστράπτω	to hurl down lightning
καταστρέφω	to turn down, trample on
καταστροφεύς	
καταστροφή	an overturning
κατασφάζω	to slaughter, murder
κατασχεθείς	
κατασχίζω	to cleave asunder, split up
κατά-ταρταρόω	
κατατείνω	to stretch or draw tight
κατατίθημι	to place, put
κατατιτρώσκω	to wound severely
κατατοξεύω	to strike down with arrows, shoot dead
κατατραυματίζω	to cover with wounds
κατά-ὑμνέω	
καταφαγεῖν	to devour, eat up
καταφαίνω	to declare, make known
καταφανής	clearly seen, in sight
καταφέρω	to bring down
καταφεύγω	to flee for refuge
καταφλέγω	to burn down, burn up, consume
καταφρονέω	to think down upon
καταφρόνησις	contempt, disdain
καταχεύω	
καταχώννυμι	to cover with a heap
καταψεύδομαι	to tell lies against, speak falsely of
κατά-ὠρύομαι	
κατεγγυάω	to pledge, betroth
κατεζευγμένωντῶν	
κατεῖδον	to look down
κάτειμι	to go or come down
κατείργω	to drive into, shut in
κατεργάζομαι	to effect by labour, to achieve, accomplish
κατέρχομαι	to go down from
κατεσθίω	to eat up, devour
κατευθύνω	to make or keep straight, to set right, guide aright
κατεφλέχθη	
κατέχω	to hold fast
κατοικέω	to dwell in as a κάτοικος, to settle in, colonise
κατοίκησις	a settling in
κατοικίζω	to remove to
κάτοικος	a settler
κατοικτείρω	to have mercy or compassion on
κατοίχομαι	to have gone down
κατόπισθεν	behind, after, in the rear
κατορθόω	to set upright, erect
κατορύσσω	to bury in the earth
Κατρεύς	
Καύκασος	Mt. Caucasus
Καύκων	
καυχάομαι	to speak loud, be loud-tongued
Καφήρευς	
Καφηρίς	
κβ	
κγ	
Κεβρήν	
Κεβριόνης	
κεῖμαι	to be laid
κείρω	to cut
Κεκροπία	
Κεκρόπιος	
Κέκροψ	Cecropian, Athenian
Κελαίνευς	
κελαινόομαι	to grow black or dark
κελαινός	black, swart, dark, murky
Κελαινώ	
Κελένδερις	
Κελεός	
Κελευστάνωρ	
Κελεύτωρ	
κελεύω	to urge or drive on, urge, exhort, bid, command, order
Κελτοί	the Kelts or Celts
Κελτός	
Κέλτος	
κενεών	the hollow below the ribs, the flank
κενός	empty
κενόω	to empty out, drain
Κένταυρος	a Centaur
κέντρον	any sharp point
Κεραός	
κέρας	the horn of an animal
κεραύνιον	
Κεραύνιος	
κεραυνός	a thunderbolt
κεραυνόω	to strike with thunderbolts
Κέρβερος	
Κέρθη	
Κερκέτης	
κερκίς	the rod or comb
κέρκισις	
Κέρκυρα	Corcyra
Κερκυών	
Κέρκωψ	the Cercopes
Κερυνῖτις	
Κευθώνυμος	
κεφαλή	the head
Κεφαλλήν	
Κεφαλληνία	
Κεφαλληνίη	
Κεφαλλήνιος	
Κέφαλος	
κηδεστής	a connexion by marriage
κηδεύω	to take charge of, attend to, tend
κήλη	a tumor
Κήναιον	
κηρός	bees-wax
κῆρυξ	a herald, pursuivant, marshal, public messenger
κηρύσσω	to be a herald, officiate as herald
Κήτευς	
κῆτος	any sea-monster or huge fish
Κητώ	
κήυξ	
Κῆϋξ	
Κηφεύς	
Κηφισός	the Cephisus
κίβισις	a pouch, wallet
Κιθαιρών	
Κιθαιρώνειος	
κιθάρα	guitar)
κιθαρίζω	to play the cithara
κιθαρῳδέω	to sing to the cithara
κιθαρῳδία	a singing to the cithara
Κίκονες	
Κιλίκιος	
Κίλιξ	a Cilician
Κίλλα	
Κιμμερίς	
κινέω	to set in motion, to move
κινύρα	
Κινύρης	
κινύρομαι	to utter a plaintive sound, lament, wail
Κίνυψ	
Κίος	
Κίρκαιος	
Κίρκη	Circe
κισσάω	to crave for strange food
Κισσεύς	
κισσός	ivy
κισσόω	to wreathe with ivy
κίστη	a box, chest
κίω	to go
Κλαζομεναί	
κλάω	to break, break off
κλείς	that which serves for closing
Κλεισιθύρη	
Κλειτή	
κλειτός	
Κλειτός	
Κλειτώνυμος	
Κλείτωρ	
Κλειώ	Clio
κλείω	
Κλεοβοία	
Κλεόδαιος	
Κλεόδοξα	
Κλεοδώρη	
Κλεόλαος	
Κλεοπάτρη	
Κλεοφύλη	
Κλεοχαρείη	
Κλέοχος	
κλέπτω	to steal, filch, purloin
Κλεωναί	
κλῄζω	
κλῆμα	a vine-twig, vine-branch
κλῆρος	a lot;
κληρόω	to appoint
κλῖμαξ	a ladder or staircase
κλίνη	that on which one lies, a couch or bed
κλίνω	to make to bend, slope
Κλονίη	
Κλονίος	
κλοπεύς	a thief, stealer
κλοπή	theft
κλύδων	a wave, billow
Κλυμένη	
κλύμενον	
Κλύμενος	
κλύμενος	famous
Κλυταιμνήστρα	
Κλυταιμνήστρη	
Κλυτίος	
Κλυτίππη	
Κλωθώ	spinster
Κνωσσίη	
κοιλαίνω	to make hollow, scoop out
κόιλος	
κοῖλος	hollow, hollowed
κοιμάω	to lull or hush to sleep, put to sleep
κοινῇ	
κοινός	common, shared in common
κοινόω	to make common, communicate, impart
Κοῖος	
κοιρανέω	to be lord or master, to rule, command
Κοιρανός	
κοίτη	the marriage-bed
κόκκος	a grain, seed
κόκκων	a pomegranate-seed
κολάζω	to curtail, dock, prune
κόλλα	glue
κολλάω	to glue, cement
Κολοφών	
κόλπος	the bosom
κολπόω	to form into a swelling fold;
Κολχικός	
Κόλχος	a Colchian
Κολώνη	
Κολωνός	
Κομαιθώ	
κομάω	to let the hair grow long, wear long hair
κόμη	the hair, hair of the head
Κομήτης	
κομίζω	to take care of, provide for
κόνδυλος	a knuckle
Κοπρεύς	
κόπρον	
κόπρος	dung, ordure, manure
κόπτω	to strike, smite, knock down
Κόρα	
κόραξ	carrion-crow
Κορέθων	
κορέω	to sweep, sweep out
κόρη	a maiden, maid, damsel
Κορίνθιος	Corinthian
Κόρινθος	Corinth
κόρις	a bug
κόρος	
Κορύβας	a Corybant, priest of Cybele in Phrygia;
Κόρυθος	
κορύνη	a club, mace
κορυνήτης	a club-bearer, mace-bearer
κόρυς	a helmet, helm, casque
κορυφή	the head, top, highest point;
Κορωνίς	
Κόρωνος	
κόσμος	order
Κόττος	
κούρητες	young men
Κουρῆτες	
Κούρητις	
κουρῆτις	
κοχλίας	a snail with a spiral shell
κόχλιας	
κοχλίον	a small snail
κόχλος	a shell-fish with a spiral shell
κράζω	to croak
Κρανάη	
Κραναίχμη	
Κραναός	
κράνειον	
Κραντώ	
κράς	the head
Κραταιίς	
κρατερός	strong, stout, mighty
κρατέω	to be strong, mighty, powerful
Κράτης	
Κρατίευς	
κρατιστεύω	to be mightiest, best, most excellent
κράτος	strength, might
κρατύς	strong, mighty
κραυγάζω	to bay
κραυγή	a crying, screaming, shrieking, shouting
κρέας	flesh, meat, a piece of meat
κρεῖον	a meat-tray, dresser
Κρεῖος	
κρείσσων	stronger, mightier, more powerful
Κρείων	
κρείων	a ruler, lord, master
κρεμάννυμι	to hang, hang up
Κρεοντιάδης	
κρεουργέω	to cut up meat like a butcher
Κρεούσα	
Κρεσφόντης	
Κρέων	
Κρηθεύς	
κρήνη	a well, spring, fountain
Κρηνίς	
Κρής	a Cretan
Κρήτη	Crete
Κρητινίη	
Κρίασος	
κριθάω	to be barley-fed, to wax wanton
Κρίμισσα	
κρίνω	to pick out, choose
Κρινώ	
κριός	a ram
κρίσις	a separating, power of distinguishing
κριτής	a decider, judge, umpire
κριτός	picked out, chosen
Κροῖσος	
Κρόκων	
Κρομμυών	
Κρόνος	Cronus
κρόταλον	a rattle, castanet
Κρότων	
κρούω	to strike, smite: to strike
κρύπτω	to hide, cover, cloak
κρύφα	without the knowledge of
κρυφαῖος	hidden
κτάομαι	to procure for oneself, to get, gain, acquire
Κτέατος	
κτείνω	to kill, slay
κτέομαι	
Κτήσιος	
Κτήσιππος	
κτῆσις	acquisition
κτίζω	to people
Κυάνιππος	
Κύβελα	
Κύβελον	
κυβερνάω	to act as pilot or helmsman
Κύζικος	of or from Cyzicus
Κυθήριος	Cytherean
κυκεών	mixed drink, a potion, tankard
κυκλέω	to move round and round, wheel along
κυκλόω	to encircle, surround
Κύκλωψ	a Cyclops
κύκνος	a swan
Κύκνος	
κύλιξ	a cup, drinking-cup, wine-cup
κυλίω	to roll along
Κυλλήνη	Cyllene, a mountain in Arcadia
κῦμα	anything swoln
Κύμη	
Κυμοθόη	
Κυμώ	wavy
Κύναιθος	
κυνάω	to play the Cynic
κυνέα	
κυνέη	a dog's skin
κύνεος	shameless, unabashed
κυνέω	to kiss
κυνηγετέω	to hunt
κυνηγετικός	of or for hunting, fond of the chase
κυνηγός	
Κῦννος	
Κυνόρτης	
Κυνός	
κυνώ	a she-dog
κυοφορέω	to be pregnant
Κύπρια	
κύπριον	
Κύπριος	of Cyprus, Cyprian
Κύπρος	Cyprus
Κυρήνη	Cyrene
κυριεύω	to be lord or master of
Κυτίσωρος	
κύτος	the hollow
Κύχρευς	
κύω	to conceive
κύων	a dog or bitch
Κῷ	
Κώκαλος	
κῶλον	a limb
κωλύω	to let, hinder, check, prevent
κώμη	country town
Κῷον	
Κῷος	of, from the island Cos, Coan
Κῶος	
κώπη	the handle of an oar
κωρύκιον	
Κωρύκιος	Corycian
Κῶς	Cos
λ	
λᾶας	
Λάβδακος	
λάβρος	furious, boisterous
λαβύρινθος	a labyrinth or maze
λαγχάνω	to obtain by lot, by fate, by the will of the gods
λαγών	the hollow on each side below the ribs, the flank
Λάδων	
Λαέρτης	
λαθραῖος	secret, covert, clandestine, furtive
λάθρῃ	secretly, covertly, by stealth, treacherously
Λαί̈ης	
Λαί̈ος	
Λαιστρυγών	
Λακεδαιμόνιος	
Λακεδαίμων	Lacedaemon
Λακωνικός	Laconian
Λάμας	
λαμβάνω	to take
λαμπάς	
Λάμπος	bright
λαμπρός	bright, brilliant, radiant
λάμπω	to give light, shine, beam, be bright, brilliant, radiant
λανθάνω	to escape notice, to be unknown, unseen, unnoticed
λάξ	with the foot
Λαογόρης	
Λαοδάμας	
Λαοδάμεια	
Λαοδίκη	
Λαόδικος	
Λαοδόκος	
Λαόδοκος	
Λαοθόη	
Λαοκόων	
Λαομέδων	
Λαομένης	
Λαομήδης	
Λαονόμη	
λαός	the people
Λαοφόντη	
Λαπίθαι	
Λαπίθης	
λάπτω	to lap with the tongue
Λάρισα	Larissa
Λάρισσα	
Λαρισσαῖος	
λάρναξ	a coffer, box, chest
Λατῖνος	
λατρεία	the state of a hired workman, service, servitude
λατρεύω	to work for hire or pay, to be in servitude, serve
λάφυρα	spoils
λαφυραγωγέω	
Λάχεσις	Lachesis, disposer of lots
λάχος	an allotted portion
Λεάδης	
Λεανείρα	
Λέαρχος	
λέβης	a kettle or caldron
λέγος	
λέγω	
λεηλατέω	to drive away cattle as booty, to make booty
λεία	booty, plunder
λειμών	any moist, grassy place, a meadow, mead, holm
λεῖος	smooth, plain, not embroidered
λείπω	to leave, quit
Λειώδης	
Λειώκριτος	
Λέλεγες	
λεοντέη	a lion's skin
Λεοντεύς	
Λεοντοφόνος	
λεπτόν	a very small coin, a mite
λεπτός	peeled, husked, threshed out
Λέρνα	Lerna
Λερναῖος	
Λέρνη	
Λέσβος	Lesbos
Λεστορίδης	
Λευκανοί	
Λευκή	
Λευκής	
Λευκίππη	
Λεύκιππος	
Λευκοθέα	the white goddess
λευκόν	white
Λεῦκος	
λευκός	light, bright, brilliant
Λεύκοφρυς	
λευκόω	to make white
Λεύκων	
Λευκώνης	
Λευκωπεύς	
Λέων	
λέων	a lion
λήγω	to stay, abate
Λήδη	
λῆδος	a light summer dress
λήθη	a forgetting, forgetfulness
Λήθη	
λῆθος	
λήιον	a crop
ληιστής	
ληιστός	to be carried off as booty, to be won by force
Λήϊτος	
Λήμνιος	Lemnian
Λῆμνος	Lemnos
λῆξις	
λῃστής	a robber, plunderer
λῃστρικός	piratical
Λητώ	Leto
Λιβύη	Libya, the north part of Africa
λίγυρος	
Λιγύρων	
Λίγυς	a Ligurian
Λιγυστίνη	
Λιγυστῖνος	
λιθάω	
λιθοβολέω	to pelt with stones, stone
λιθόομαι	
λίθος	a stone
λίκνον	a winnowing-fan
Λικύμνιον	
Λικύμνιος	
Λιλύβαιον	
λιμήν	a harbour, haven, creek
λιμνει	
λίμνη	a pool of standing water
Λιμνώρεια	
λιμός	hunger, famine
Λιναῖον	
Λίνδιος	
λίνον	anything made of flax
Λίνος	Linos
λίνος	
Λίξος	
Λίχας	
Λίχης	
λοβός	the lobe of the ear
λόγιον	an announcement, oracle
λόγιος	versed in tales or stories
λόγος	the word or that by which the inward thought is expressed
λοιδορέω	to abuse, revile
λοιμός	a plague, pestilence
λοιπάς	
λοιπός	remaining, the rest
Λοκρίς	
Λοκροί	the Locrians
Λοκρός	Locrian
λούω	to wash
λόφος	the back of the neck
λοχάω	to lie in wait for, to watch, waylay, entrap
λόχμη	a thicket, coppice, copse
Λύαμμος	
Λυγκαῖος	
Λυγκεύς	
Λυδός	a Lydian
Λύκαιθος	
Λυκάων	
Λύκη	
Λύκης	
Λυκία	Lycia.
Λύκιοι	the Lycians
λύκιον	
Λύκιος	Lycian.
Λυκομήδης	
Λυκόρμης	
Λύκος	
λύκος	a wolf
Λυκοῦργος	
λυκόω	to tear like a wolf
Λύκων	
Λυκωπεύς	
λυμαίνομαι	to treat with indignity, to outrage, to maltreat
λύμη	brutal outrage, maltreatment, maiming
λυπέω	to give pain to, to pain, distress, grieve, vex, annoy
λύπη	pain of body
λύρα	
Λυρνησσός	
λύρον	
Λύρος	
Λύση	
Λυσιάνασσα	
Λυσιδίκη	
Λυσίθοος	
Λυσιμάχη	
λυσίμαχος	ending strife
Λυσίνομος	
Λυσίππη	
Λύσις	
λύσσα	rage, fury
λυσσάω	to be raging
Λυταίη	
λυτρόω	to release on receipt of ransom, to hold to ransom
λύω	to loose
λωβάομαι	to treat despitefully, to outrage, maltreat
λωτός	the lotus
Λωτοφάγοι	
μ	
Μάγνης	a Magnesian
Μάγος	a Magus, Magian
μαθητής	a learner, pupil
μαθητός	learnt, that may be learnt
Μαῖα	Maia
Μαίναλον	Mount Maenalus
Μαίναλος	
μαινάς	raving, frantic
μαίνομαι	to rage, be furious
μαῖον	
μαιόομαι	to deliver
Μάιος	of May
Μαῖρα	the sparkler
Μαίων	
μάκαρ	blessed, happy
Μάκαρ	
Μακαρεύς	
Μακάρευς	
μάκαρος	
Μάκεδνος	
μακράν	a long way, far, far away
μακρόβιος	long-lived
μακρός	long
Μαλέη	
μᾶλλον	
μανθάνω	to learn
μανία	madness, frenzy
μαντεία	prophesying, prophetic power
μαντεῖον	an oracle
μαντεῖος	oracular, prophetic
μαντεύομαι	to divine, prophesy, presage
μαντικός	of or for a soothsayer or his art, prophetic, oracular
Μαντινέη	
Μαντινεία	
Μαντινεύς	
Μαντίνευς	
μάντις	one who divines, a seer, prophet
Μαντώ	
Μαραθών	Marathon
Μαραθώνιος	
Μαριανδυνοί	
Μαριανδυνός	a wild, barbaric
Μάρπησσα	
Μαρπήσση	
Μάρση	
Μαρσύης	
μαρτυρέω	to be a witness, to bear witness, give evidence, bear testimony
μαρτύρομαι	to call to witness, attest, invoke
μάρτυς	a witness
Μάρψιος	
Μάρων	
μάσσω	to handle, touch
μαστεύω	to seek, search
μαστός	one of the breasts
μάχαιρα	a large knife or dirk
Μαχαίρευς	
Μαχάων	Machaon
μαχεσθῆναι	
μάχη	battle, fight, combat
μάχιμος	fit for battle, warlike
μάχομαι	to fight
μγ	
μδ	
Μεγαίρα	
Μεγαμήδη	
Μεγανείρα	
Μεγαπένθης	
Μέγαρα	Megara
Μεγαρεύς	a citizen of Megara
Μεγάρη	
Μεγαρικός	Megarian
μέγαρον	a large room or chamber
Μέγαρος	
μέγας	big, great
Μεγασθένης	
Μεγασσάρης	
μέγεθος	greatness, magnitude, size, height, stature
Μέγης	
μέδιμνος	the medimnus
μέδος	
Μεδούσα	
μέδω	a guardian, lord
Μέδων	
Μεθάρμη	
μέθη	strong drink
μεθήκω	to be come in quest of
μεθίημι	to let go, let loose, release
μεθίστημι	to place in another way, to change
μεθό	after that.
μεθύσης	
μεθύσκω	to make drunk, intoxicate, inebriate
μέθυσος	drunken
μειδιάω	
μείρομαι	to receive as one's portion or due
μείς	a month
Μελαίνευς	
Μελαινεύς	
μελαίνω	to blacken
Μελάμπους	
μελανέω	
μελάνθιον	
Μελάνθιος	
μελάνια	
μελάνιον	
Μελανίππη	
Μελάνιππος	
Μελανίων	
Μελάντιος	
μέλας	black, swart
Μέλας	
μελέαγρον	
Μελέαγρος	
μέλη	
μεληδόν	
μεληδών	
Μέλης	
Μελησαγόρης	
μέλι	
μελία	the ash
Μελίβοια	
μελίζω	to modulate, sing, warble
Μελίη	
Μελικέρτης	
μέλινος	ashen
μέλισσα	a bee
Μελίσσευς	
μελισσεύς	
Μελίτη	
μέλλω	to think of doing, intend to do, to be about to do
μέλος	a limb
Μελπομένη	Melpomene
μέλπω	to sing of, celebrate with song and dance
μελῳδέω	to sing, chant
μελῳδός	singing, musical, melodious
Μέμνων	the steadfast or resolute
Μέμφις	
μέμφομαι	to blame, censure, find fault with
μέν	on the one hand, on the other hand
Μενάλκης	
Μενέλαος	withstanding-men
Μενέμαχος	
Μενεπτόλεμος	
Μενεσθεύς	abider
Μενέσθιος	
Μενιππίς	
Μενοικεύς	
Μενοίτης	
Μενοίτιος	
μένος	might, force, strength, prowess, courage
Μέντωρ	
μένω	to stay at home, stay where one is, not stir
μέρα	
μερίζω	to divide, distribute
Μέρμερος	
Μερόπη	
μέρος	a part, share
Μέροψ	
μέση	
μέσης	
Μέσθλης	
μέσος	middle, in the middle
μεσόω	to form the middle, be in or at the middle
Μεσσήνη	
μετά	in the midst of, among with gen., dat., and acc.
μεταβάλλω	to throw into a different position, to turn quickly
μετάγω	to convey from one place to another
μεταδίδωμι	to give part of, give a share of
μεταί	
μεταιτέω	to demand one's share of
μεταίτης	a beggar
μετακομίζω	to transport
μεταλαμβάνω	to have or get a share of, to partake of
μεταλήγω	to leave off, cease from
μεταλλάσσω	to change, alter
μεταμορφόω	to transform
Μετανείρα	
μετανοέω	to change one's mind or purpose
μεταξύ	betwixt, between
μεταπέμπω	to send after
μεταστρέφω	to turn about, turn round, turn
μετά-ὕω	
μεταφορικός	apt at metaphors
μετάφρενον	the part behind the midriff
μέτειμι	to be among
μετέπειτα	afterwards, thereafter
μετέρχομαι	to come or go among
μετεωρίζω	to raise to a height, raise
μετέωρος	raised from the ground, hanging
Μετώπη	
μέτωπον	the space between the eyes, the brow, forehead
μέχρι	to a given point, even so far
μή	not
μηδέ	but not or and not, nor
Μηδεία	
Μήδειος	
μηδείς	and not one
Μηδεσικάστη	adorned-with-prudence
Μήδη	
Μηδίη	
Μῆδος	a Mede, Median
μηκέτι	no more, no longer, no further
Μηκιστεύς	
μῆκος	length
Μηλιεύς	an inhabitant of Malis
Μηλίνη	
μήλινος	
Μήλιος	from the island of Melos, Melian
μῆλον	
Μῆλος	
μήνιον	
μῆνις	wrath, anger
μηνίω	to be wroth with
μηνύω	to disclose what is secret, reveal, betray
μηρός	the thigh
Μήστωρ	
μήτε	and not
Μήτη	
μήτηρ	a mother
Μητιαδούσα	
Μητιονίδης	
μήτις	lest any one, lest anything; that no one, that nothing
Μῆτις	
Μητίων	
μητρίς	
μητροπάτωρ	one's mother's father
μητρυιά	a step-mother
μητρώιος	
μητρῷος	of a mother, a mother's, maternal
μίγνυμι	to mix, mix up, mingle, properly of liquids
Μίδεα	
Μιδέη	
Μίδεια	
μικρός	small, little
Μίλητος	Miletus
Μίμας	
μιμέομαι	to mimic, imitate, represent, portray
μιν	himself
Μίνις	
Μινύαι	the Minyans
Μινύης	
Μίνυος	
Μίνως	Minos
Μινώταυρονἐν	
Μινώταυρος	
μισέω	to hate
μισθός	wages, pay, hire
μισθόω	to let out for hire, farm out, let
μῖσος	hate, hatred
μνάομαι	to turn one's mind
Μνημοσύνη	
μνησικακέω	to remember wrongs done one, remember past injuries
Μνησίλευς	
Μνησιμάχη	
μνηστεία	a wooing, courting
μνηστευόμενοιἀνῃροῦντο	
μνηστεύω	to woo, court, seek in marriage
μνηστήρ	a wooer, suitor
Μνήστρη	
μοῖρα	a part, portion
μοιράω	to share, divide, distribute
μοιχεία	adultery
μοιχεύω	to commit adultery with
Μόλεβος	
Μολιόνη	
Μολιονίδης	
μόλις	not scarcely
Μόλορχος	
Μόλος	
Μολοσσία	
Μολοσσός	Molossian
Μολοττικός	
μονομαχέω	to fight in single combat
μονομαχία	single combat
μόνος	alone, left alone, forsaken solitary
μονοσάνδαλος	
μονόφθαλμος	one-eyed
μονοχίτωνεσκαι	
μονόω	to make single or solitary
μορφάζω	to use gesticulations
μορφάω	to shape, fashion, mould
μορφή	form, shape
Μοῦσα	the Muse
μουσική	any art over which the Muses presided
μουσικός	of or for music, musical
μουσόομαι	to be trained in the ways of the Muses, to be educated or accomplished
Μόψος	
Μυγδαλίων	
Μύγδων	
μύδρος	a mass of red-hot metal
μυελός	marrow
μυέω	to initiate into the mysteries
μύζω	to murmur with closed lips, to mutter, moan
Μυκηναῖος	Mycenaean
Μυκήνη	Mycene, Mycenae
Μύκονος	
Μύλιος	
Μύνης	
μυρίος	numberless, countless, infinite
μύρμηξ	a beast of prey
Μυρμιδόνες	the Myrmidons
Μυρμιδών	
Μυρτίλος	
Μυρτῷος	
μῦς	the field-mouse
μυσάττομαι	to feel disgust at
μυσή	
μυσία	
Μύσιος	a Mysian dirge
μυσόν	
Μυσός	a Mysian
μύσος	uncleanness
μυστήριον	a mystery or secret doctrine;
μυχός	the innermost place, inmost nook or corner
μύω	to close, be shut
Μῶλος	
μῶλυ	moly, mandrake
ν	
Ναιάς	a Naiad, a river nymph
Νάξος	Naxos
ναξος	
ναός	the dwelling of a god, a temple
νάρθηξ	the Bacchanalian wands
νάσσω	to press or squeeze close, stamp down
Νάστης	
ναυαγέω	to suffer shipwreck, be shipwrecked
Ναύαιθος	
ναυαρχέω	to command a fleet
Ναύβολος	
ναυκρατέω	to be master of the sea
ναυκράτης	master or mistress of the seas
Ναύκρατις	Naucratis
ναυλοχέω	to lie in a harbour or creek
Ναυπακτικά	
Ναύπακτος	
Ναυπλιεύς	a Nauplian
Ναύπλιος	
Ναυπρήστιδες	
ναύπρηστις	
ναῦς	a ship
Ναυσιθόη	
Ναυσικάα	
Ναυσιμέδων	
ναύσταθμον	a harbour, anchorage, roadstead
ναύσταθμος	
ναυτικόν	
ναυτικός	seafaring, naval
νέα	
νεάζω	to be young or new
Νέαιρα	
νεανίης	a young man, youth
νεανίσκος	a youth
νεάω	to plough up anew
Νεβροφόνος	
Νεῖλος	the Nile
νεκρός	a dead body, corpse
νεκρόω	to make dead
Νεμέα	Nemea
Νέμεα	
Νέμειος	Nemean
Νέμεσις	
νέμος	a wooded pasture, glade
νέμω	to deal out, distribute, dispense
νεογνός	
νεόδαρτος	newly stripped off
Νεόμηρις	
Νεοπτόλεμος	new-warrior
νέος	young, youthful
νεοσσιά	a nest of young birds, a nest
νεοσσός	a young bird, nestling, chick
νεόω	to renovate, renew
Νέσσος	
Νέστωρ	
νεῦρον	a sinew, tendon;
Νεφέλη	
νεφέλη	a cloud
νέφος	a cloud, mass or pile of clouds
νέω	
νεών	
νεώς	a temple
νεώτατος	youngest
νεώτερος	younger
νζ	
Νηλεύς	
νηλής	pitiless, ruthless
Νηλώ	
νήπιος	not yet speaking
Νηρεύς	Nereus
Νηρηίς	a daughter of Nereus, a Nereid or Nymph of the sea
Νησαίη	
Νησαῖος	
νησιώτης	an islander
νῆσος	an island
νηφάλιος	unmixed with wine, wineless
Νηφαλίων	
Νῆφος	
νίζω	to wash the hands or feet
νικάω	to conquer, prevail, vanquish
Νίκη	
νίκη	victory in battle
Νικίππη	
Νικόδρομος	
Νικοθόη	
Νικόμαχος	
νῖκος	
Νικόστρατος	
Νιόβη	
Νιρεύς	
Νῖσα	
Νῖσος	
Νισσαῖος	
νίσσομαι	to go, go away
Νίσυρος	
νοέω	mere sight
νόημα	that which is perceived, a perception, thought
νόθος	a bastard, baseborn child
νομεύς	a shepherd, herdsman
νομή	a pasture, pasturage
νομίζω	to hold or own as a custom or usage, to use customarily, practise
Νομίων	
νομοθετέω	to make law
νομοθέτης	a lawgiver
νόμος	anything assigned, a usage, custom, law, ordinance
νοσέω	to be sick, ill, to ail
νόσος	sickness, disease, malady
νόστος	a return home or homeward
Νότιον	
νότιος	wet, moist, damp
νοτίς	moisture, wet
Νυκτεύς	
Νυκτηίς	
Νύκτιμος	
νύκτωρ	by night
νύμφη	a young wife, bride
νυμφίος	
νῦν	now at this very time
νύξ	the night-season or a night
νύσα	
Νῦσα	
Νύση	
νῶτον	the back
νῶτος	
ξ	
Ξανθίππη	
Ξάνθιππος	
Ξανθίς	
Ξάνθος	
ξενίζεικαι	
ξενίζω	to receive or entertain strangers, to receive as a guest
ξένιος	belonging to a friend and guest, hospitable
Ξενόδαμος	
Ξενοδίκη	
ξενοδοκέω	to entertain guests or strangers
Ξενοδόκη	
ξένος	
ξενόω	to make one's friend and guest
ξηραίνω	to parch up, dry up
ξιφήρης	sword in hand
ξίφος	a sword
ξιφουλκέω	
ξόανον	an image carved
Ξοῦθος	
ξύλινος	of wood, wooden
ξύλον	wood
Ξυλοφάγος	
ξύω	to scrape, plane, smooth or polish
ὁ	the, that
ὄγδοος	eighth
Ὀγκάϊδαι	
Ὀγχηστόν	
Ὀγχηστός	
ὁδάω	to export and sell;
ὅδε	this
ὅδευσις	
ὁδεύω	to go, travel
Ὀδίος	
ὁδός	
ὀδούς	
ὁδόω	to lead by the right way
ὀδυνάω	to cause
ὀδύνη	pain of body
Ὀδυσσεύς	
ὀδών	
ὅθεν	from whom
Οἴαγρος	
Οἶαξ	
οἴαξ	the handle of the rudder, the tiller
Οἴβαλος	
οἶδα	to know
Οἰδίπους	Oedipus
οἴη	
οἰκεῖος	in or of the house, domestic
οἰκειότης	kindred, relationship
οἰκειόω	to make one's own
οἰκείω	
οἰκέτης	a house-slave, menial
οἰκέω	to inhabit, occupy
οἴκημα	any inhabited place, a dwellingplace
οἴκησις	the act of dwelling, habitation
οἰκήτωρ	an inhabitant
οἰκία	a building, house, dwelling
οἰκίασἐπερχομενοι	
οἰκίζω	to found as a colony or new settlement
Ὀϊκλέης	
οἴκοι	at home, in the house
οἶκος	a house, abode, dwelling
οἰκουμένη	the inhabited world
Ὀϊλεύς	
Ὀιλεύς	Oi_leus
οἰμάω	to swoop or pounce upon
Οἴμη	
Οἰνεύς	
Οἰνόη	Oenooe
Οἰνόμαος	
οἶνον	
Οἰνοπίων	
οἰνοποιία	
οἶνος	wine
Οἰνότροφοι	
οἰνοχόος	a wine-pourer, cupbearer
οἰνόω	to intoxicate
Οἰνώ	
Οἰνώνη	
οἰνώνης	
οἶος	alone, lone, lonely
οἷος	such as, what sort or manner of nature, kind
ὀιστός	an arrow
Οἰστρόβλης	
οἶστρος	the gadfly, breese
Οἴτη	Oeta
Οἰχαλία	
οἴχομαι	to be gone, to have gone
οἰωνός	a large bird, bird of prey
ὀκνέω	to shrink
ὀκταετία	
ὀκταμηνιαῖος	
ὀκτώ	
ὀκτωκαίδεκα	eighteen
ὀκτωκαιδεκαέτης	
ὁλάω	
ὀλίγος	few, little, scanty, small
Ὀλιζών	
ὀλισθάνω	to slip, slip and fall
ὁλκός	
ὁλοίτροχος	a rolling stone, a round stone
ὀλοίτροχος	
Ὀλοίτροχος	
ὅλοξ	whole, entire, complete
ὅλος	
ὀΛυμπιακός	Olympian
Ὀλυμπιακός	
Ὄλυμπος	Olympus
Ὀλυμπούσα	
ὄλυνθος	a winter-fig
ὄμβρος	
ό̓μβρος	heavy rain
ὅμηρος	a pledge for the maintenance of unity, a surety, a hostage
Ὅμηρος	Homer;
ὁμίχλη	a mist, fog
ὄμμα	the eye
ὀμματόω	to furnish with eyes
ὄμνυμι	to swear
ὅμοιος	like, resembling
ὁμοῖος	
ὁμοιόω	to make like
Ὁμόλιππος	
ὁμολογέω	to speak together
ὁμολόγησις	
Ὁμολώιος	
ὅμορος	having the same borders with, marching with, bordering on
ὁμός	one and the same, common, joint
ὁμοῦ	at the same place, together
ὁμόω	to unite
Ὀμφάλη	
ὁμωνυμία	a having the same name, identity, an equivocal word
ὁμωνύμιος	
ὁμώνυμος	having the same name
ὅμως	all the same, nevertheless, nothwithstanding, still
ὀνειδίζω	to throw a reproach upon
ὀνειροκρίτης	an interpreter of dreams
ὄνειρος	a dream
Ὀνείτης	
Ὀνήσιππος	
ὄνθος	the dung
ὄνομα	by name
ὀνομάζω	to name or speak of by name, call or address by name
ὀνομαστί	by name
ὄνος	an ass
ὄντα	existing things, the present
ὀξυδερκία	
ὀξυδορκία	
Ὄξυλος	
Ὀξύπορος	
ὀξύπορος	
ὁπηνίκα	at what point of time, at what hour, on what day
ὀπίσω	backwards
Ὅπλευς	
Ὁπλής	
ὁπλίζω	to make or get ready
ὁπλομαχέω	
ὅπλον	a tool, implement
Ὀπόεις	
ὁποῖος	of what sort or quality
ὁπότε	when
ὁπότερος	which of two, whether of the twain
ὅπου	in some places
ὀπτός	roasted, broiled
ὅπως	as, in such manner as
ὅρασις	seeing, the act of sight
ὁράω	To see
ὀργάζω	to soften, knead, temper
ὀργάω	to swell with moisture
ὀργή	natural impulse or propension: one's temper, temperament, disposition, nature
ὀργίζω	to make angry, provoke to anger, irritate
ὄργυια	the length of the outstretched arms
ὀργυιαῖος	six feet long or large
ὀρέγω	to reach, stretch, stretch out
Ὀρείη	
ὄρειος	of or from the mountains, mountain-haunting
Ὀρέστειος	of Orestes
Ὀρέστης	
ὀρέστης	
ὀρεύς	a mule
Ὀρθαίη	
Ὄρθος	
ὅρκος	the object by which one swears, the witness of an oath
ὁρκόω	to bind by oath
ὁρμάω	to set in motion, urge
Ὀρμένιος	
Ὄρμενος	
ὁρμέω	to be moored, lie at anchor
ὅρμος	a cord, chain
ὄρνεον	a bird
ὀρνεόω	
ὄρνις	a bird
ὄρνυμι	to stir, stir up
ὄρομαι	to watch, keep watch and ward
ὅρος	a boundary, landmark
ὄρος	a mountain, hill
Ὅρος	
ὀρός	
ὀροφή	the roof of a house
Ὀρσεδίκη	
Ὀρσηίς	
ὄρτυξ	the quail
ὀρφεύς	
Ὀρφεύς	Orpheus
Ὀρφικός	
Ὀρχομένιος	
Ὀρχομενός	
ὅς	this, that;
ὅσιος	hallowed, sanctioned by the law of God
ὀσμή	a smell, scent, odour
ὅσος	quantus
ὅσπερ	the very man who, the very thing which
Ὄσσα	
ὄσσα	a rumour
ὅστε	who, which
ὀστέον	the
ὅστις	any one who, anything which
ὅταν	whenever
ὅτανἀπελπισῃ	
ὅτε	when
ὅτι	
Ὀτρεύς	
Ὀτρηρή	
ὀτρηρός	quick, nimble, busy, ready
οὐ	not
οὗ	where
Οὐδαῖος	
οὐδέ	but not
οὐδείς	and not one
οὐδός	
οὐκἐτίμα	
οὖν	really, at all events
οὐρά	the tail
Οὐρανία	Urania, the heavenly one
οὐράνιος	heavenly, of or in heaven, dwelling in heaven
Οὐρανός	
οὐρανός	heaven
οὐρεύς	a mule
οὖς	auris, the ear
οὖσον	
οὔτε	and not
Οὔτιν	
οὔτις	no one or nobody
οὗτος	this
οὗτοσἀπο	
οὕτωπαρεπλει	
οὕτως	in this way or manner, so, thus
ὀφείλω	to owe, have to pay or account for
ὄφελος	furtherance, advantage, help
Ὀφέλτης	
ὀφθαλμός	the eye
ὄφις	a serpent, snake
ὀχέω	to uphold, sustain, endure
ὄψις	look, appearance, aspect
ὄψος	
π	
Παγγαῖον	
πᾶγος	
πάγος	that which is fixed or firmly set
παιγνία	play, sport, a game
παῖδεσΔημοφῶν	
παιδία	
παιδιή	childish play, sport, game, pastime
παίδιον	
παιδίον	a little or young child
παίδιος	
παίζω	to play like a child, to sport, play
Παίονες	the Paeonians
παῖς	a child
παίω	
παίων	
Παίων	
πάλα	
πάλαι	long ago, in olden time, in days of yore, in time gone by
Παλαίμων	Palaemon
παλαιός	old in years
παλαιόω	to make old
παλαίω	to wrestle
Παλαμήδης	the Inventor
πάλη	wrestling
πάλιν	back, backwards
παλινδικία	a second action, a new trial
Παλλάδιον	a statue of Pallas
παλλακή	
Παλλάς	Pallas
Πάλλας	
Παλλήνη	
πάλλω	to poise or sway
Πάμμων	
Πάμφυλος	
Πάν	Pan
Παναθήναια	the Panathenaea
Παναθήναιος	
Πάνδαρος	
Πάνδια	a feast of Zeus
πανδῖος	
Πανδίων	
Πανδρόσειον	
Πάνδροσος	
πανδώρα	giver of all
Πανδώρη	
Πάνδωρος	
Πανοπεύς	
Πανόπη	
πανοπλία	the full armour of an ὁπλίτης
πανόπτης	the all-seeing
πανός	a torch
παντελής	all-complete, absolute, complete, entire
παντοῖος	of all sorts or kinds, manifold
πάντως	altogether;
πάνυ	altogether, entirely
Πανύασις	
πανώλεθρος	utterly ruined, utterly destroyed
πάομαι	to get, acquire
παρά	from the side of, c. gen., beside, alongside of, c. dat., to the side of, motion alongside of, c. acc.
παραγίγνομαι	near, attend upon
παραδίδωμι	to give or hand over to another, transmit
παράδοξος	contrary to opinion, incredible, paradoxical
παραινέω	to exhort, recommend, advise
παραιτέομαι	to beg from
παρακαλέω	to call to
παρακατατίθεμαι	to deposit one's own property with
παράκειμαι	to lie beside or before
παρακελεύομαι	to order
παρακλίνω	to bend or turn aside
παρακολουθέω	to follow beside, follow closely
παραλαμβάνω	to receive from
Πάραλος	
παραμείβω	to leave on one side, pass by
παραναγιγνώσκω	to read beside
παραπέμπω	to send past, convey past or through
παραπλέω	to sail by or past
παραπλήσιος	coming near, nearly resembling, such-like
παρας	
παρασκευάζω	to get ready, prepare
παρά-σπειράομαι	
παρατηρέω	to watch closely, observe narrowly, to watch one's opportunity
παρατίθημι	to place beside
παραχρῆμα	on the spot, forthwith, straightway
παραχωρέω	to go aside, make room, give place, retire
παρέζομαι	to sit beside
παρέθεσαν	
παρείας	
Παρείη	
παρείης	a reddish-brown snake
πάρειμι	to be by or present
παρέπλειτῶν	
παρέρχομαι	to go by, beside or past, to pass by, pass
παρέχω	to hold beside, hold in readiness, to furnish, provide, supply
παρθενία	
παρθενίας	
παρθενίης	the son of a concubine
παρθένιον	
Παρθένιος	
παρθένιος	of a maiden or virgin, maiden, maidenly
Παρθενοπαῖος	the maiden-hero or son of the maiden
Παρθενόπη	
παρθένος	a maid, maiden, virgin, girl
παρίημι	to let drop beside or at the side, let fall
παριππεύω	to ride along or over
Πάρις	
παρίστημι	to make to stand or to place beside
Παρνασός	Parnassus
παροικέω	to dwell beside
παροξύνω	to urge, prick or spur on, stimulate
Πάρος	Paros
παροχετεύω	to turn from its course, divert
πᾶς	all, the whole
πᾶσις	
Πασιφάη	
πάσσω	to sprinkle
πάσχω	to receive an impression from without, to suffer
πάταγος	a clatter, crash
πάτηρ	
πατήρ	a father
πατρίς	of one's fathers
Πάτροκλος	Patroclus
πατροκτόνος	murdering one's father, parricidal
πατρόσπανοπλιαν	
Πατρώ	
πατρῷος	of or from one's father, coming or inherited from him
παῦλα	rest, a resting-point, stop, end, pause
παύω	to make to cease
Παφλαγών	a Paphlagonian
Πάφος	Paphos
πεδάω	to bind with fetters, to bind fast, make fast
Πεδιάς	
πέδιλον	sandals
πέδιον	
πεδίον	a plain or flat
πεζός	on foot
πείθω	to prevail upon, win over, persuade
πειράζω	to make proof or trial of
Πείρας	
πειράω	to attempt, endeavour, try
Πείρευς	
Πειρήν	
Πειρήνη	
Πειρίθοος	
πείρω	to pierce quite through, fix
πεῖσα	obedience
Πείσανδρος	
Πεισήνωρ	
Πεισιδίκη	
Πεισινόη	
Πεισίστρατος	
πεῖσμα	a ship's cable
Πεῖσος	
πέλαγος	the sea
Πελάγων	
πέλας	near, hard by, close
Πελασγικός	Thessalian
Πελασγιῶτις	
Πελασγός	a Pelasgian;
πελειάς	
πελεκάω	to hew or shape with an axe
πέλεκυς	an axe
Πελίᾳἀγῶνα	
Πελίης	
πέλιος	
πελιόω	
Πέλλα	
Πέλλας	
Πελλήνη	
πέλλος	
Πελοπεία	
Πελοπίδης	
Πελοπίη	
Πελοποννήσιοι	Peloponnesian, inhabitants of the Peloponnese
Πελοποννήσιος	
Πελοπόννησος	the Peloponnesus
Πέλοψ	Pelops
πέλω	to be in motion
πέλωρον	a monster, prodigy
πέλωρος	monstrous, prodigious, huge, gigantic
Πέλωρος	
πέμπτος	the fifth, oneself with four others
πέμπω	to send, despatch
Πενθεσιλεία	
Πενθεύς	
πενθέω	to bewail, lament, mourn for
πένθος	grief, sadness, sorrow
πενιχρός	poor, needy
πενταετία	
πένταθλον	the contest of the five exercises
πένταθλος	one who practises the πένταθλον or conquers therein
πέντε	five
πεντεκαιδεκαέτης	
πεντήκοντα	fifty
πεντηκόντορος	a ship of burden with fifty oars
Πεπάρηθος	
πεπλος	
πέπλος	any woven cloth
πέρα	beyond, across or over, further
περαιόω	to carry to the opposite side, carry over or across
πέραν	on the other side, across, beyond
πέρας	an end, limit, boundary
περάω	
Πέργαμον	
Πέργαμος	Pergamus
Πέρδιξ	
Περεύς	
Πέρευς	
πέρθω	to waste, ravage, sack, destroy
περί	around, round about with gen., dat., and acc.
περιαιρέω	to take off something that surrounds, take off an outer coat, take away, strip off
Περίαλλος	
περί-ἀνίστημι	
περιβάλλω	to throw round
Περίβοια	
περιγίγνομαι	to be superior to
περιδεής	very timid or fearful
περίειμι	to be around
περί-εἶμι	
περί-ἐνράπτω	
περιεργία	over-exactness
περιέχω	to encompass, embrace, surround
Περιήρης	
περιίστημι	to place round
περικαλύπτω	to cover all round
περί-καταλαμβάνω	
περικατάληπτος	
περικλάω	to break
περικλύμενον	
Περικλύμενος	
περικόπτω	to cut all round, clip, mutilate
Περίλεως	
περίλυπος	deeply grieved
περιμένω	to wait for, await
Περιμήδης	
πέριξ	round about, all round
περίοικος	dwelling round
περιπίτνω	
περιπλανάομαι	to wander about
περιπλέκω	to twine or enfold round
περί-ῥάπτω	
περισθενέω	to be exceeding strong
Περισθένης	
περισπειράω	to wind round
περισσός	beyond the regular number or size, prodigious
περισταδόν	standing round about
περιστάζομαι	to be bedewed all round
περισώζω	to save alive, to save from death or ruin
περιτίθημι	to place round
περί-τροχάζω	
περιτυγχάνω	to light upon, fall in with, meet with
περιφανής	seen all round
Περίφας	
Περιφήτης	
περιφλέγω	to burn all round
Περίφρων	
περί-χαίρω	
Περίωπις	
περόνη	anything pointed for piercing or pinning, the tongue of a buckle or brooch, the buckle or brooch
περσέα	
Πέρσευς	
Περσεύς	Perseus
Περσεφόνη	Persephone, Proserpine
Περσηίς	sprung from Perseus
Πέρσης	a Persian, inhabitant of Persis
πέρσις	a sacking, sack
πετάννυμι	to spread out
πετεινός	able to fly, full fledged
Πετεώς	
πέτομαι	to fly
πέτρα	a rock, a ledge or shelf of rock
πέτρος	a stone
πετρόω	to turn into stone, petrify
Πευκέτιος	
Πεφρηδώ	
πηγάζω	to spring or gush forth
πηγάς	anything congealed, hoarfrost, rime
Πήγασος	Pegasus
πηγή	running waters, streams
πήγνυμι	to make fast
πηγός	well put together, compact, strong
πηδάω	to leap, spring, bound
Πηλεγών	
Πηλεύς	Peleus
Πηλιακός	Pelian, of or from Mount Pelion
Πηλιάς	
Πήλιον	Pelion
Πηνειός	
Πηνέλεως	
Πηνελόπεια	Penelope
Πηνελόπη	
πήρα	a leathern pouch, a wallet, scrip
πηρός	disabled in a limb, maimed
πηρόω	to lame, maim, mutilate
Πηρώ	
πήρωσις	a being maimed, mutilation, imperfection
πηχυαῖος	a cubit long
πῆχυς	the fore-arm
Πιερία	Pieria
Πιερίς	
Πίερος	
πίθος	a wine-jar
πίθων	a little ape
πίμπλημι	to fill full of
Πίνδαρος	
πίνω	to drink
πιπίσκω	to give to drink
πιπράσκω	to sell
πίπτω	to fall, fall down
πίσα	
Πῖσα	Pisa
πιστεύω	to trust, trust to or in, put faith in, rely on, believe in
πιστόω	to make trustworthy
Πιτθεύς	
πιτυοκάμπτης	pine-bender
πίτυς	the pine, stone pine
Πλαγκταί	
πλαγκτός	wandering, roaming
Πλακίη	
πλανάω	to make to wander, lead wandering about
πλάνη	a wandering, roaming
πλάσσω	to form, mould, shape
Πλάταια	Plataea or Plataeae
Πλαταιεῖς	Plataeans
Πλαταιός	
πλάτανος	the oriental plane
πλάτος	breadth, width
Πλάτων	Plato
Πλειάδες	the Pleiads
Πλεισθένης	
πλεῖστος	most, largest
πλείων	more, larger
πλεονεξία	the character and conduct of a πλεονέκτης, greediness, grasping, assumption, arrogance
πλέος	full.
πλευρά	a rib
Πλευρών	
πλέω	to sail, go by sea
πλέως	full of
πλῆθος	a great number, a throng, crowd, multitude
πλήθω	to be or become full of
πληιάδες	
Πληιόνη	
πλῆκτρον	anything to strike with
πλήμμυρα	the flood-tide
πλημμυρίς	a rise of the sea
πλήν	more than
Πληξαύρη	
Πλήξιππος	
πληρόω	to make full
πλησιάζω	to bring near
πλησίος	near, close to
πλήσσω	to strike, smite
πλόος	a sailing, voyage
πλουτέω	to be rich, wealthy
Πλοῦτος	
Πλούτων	Pluto
πλύνω	to wash, clean
πλωτός	floating
πνεῦμα	a blowing
πνίγω	to choke, throttle, strangle
πόα	grass, herb
Ποδαλείριος	
ποδαρκής	
Ποδάρκης	
ποδάων	
ποδηγεῖν	
ποθέω	to long for, yearn after
πόθος	a longing, yearning, fond desire or regret
ποῖ	whether?
ποι	somewhither
Ποίας	
ποιέω	to make
ποίησις	a making, fabrication, creation, production
ποικίλλω	to work in various colours, to broider, work in embroidery
ποικίλος	many-coloured, spotted, mottled, pied, dappled
ποιμαίνω	to be shepherd
ποιμήν	
ποίμνη	a flock
ποίμνιον	a flock
ποίμνιος	
ποινή	quit-money for blood spilt
ποῖος	of what nature? of what sort?
πολεμαρχέω	to be Polemarch
πολεμάρχης	
πολέμαρχος	one who begins or leads the war, a leader, chieftain
πολεμέω	to be at war or go to war, make war
πολέμιος	of or belonging to war
πόλεμος	battle, fight, war
πολεμόω	to make hostile, make an enemy of
πολέω	to go about, range over
πόλεωνΑἰνειας	
πόλινΛυκαονα	
πολιορκέω	to hem in a city, blockade, beleaguer, besiege
πολιορκία	a besieging, siege
Πολιπόρθης	
πόλις	a city
Πολίτης	
πολίτης	a member of a city or state
Πόλιχος	
πολλάκις	many times, often, oft
πολλοίτελευτῶσιν	
πόλος	a pivot, hinge, axis
Πόλτυς	
Πολύαναξ	
Πόλυβος	
Πολυβώτης	
πολύγονον	
Πολύγονος	
Πολυδέκτης	
Πολυδεύκης	Pollux
Πολυδώρη	
Πολύδωρος	
Πολύϊδος	
Πολυκάστη	
Πολύκτωρ	
Πολύλαος	
Πολυμέδων	
Πολυμήδη	
Πολυμήλη	
Πολυμνίη	
Πολυνείκης	
Πολυνόμη	
Πολυξένη	
πολύξενος	entertaining many guests, very hospitable
Πολύξενος	
Πολυξώ	
Πολυπήμων	
πολύπλοκος	much-tangled, thick-wreathed
Πολυποίτης	
πολυπραγμονέω	to be busy about many things
πολύς	many
πολυτελής	very expensive, very costly
Πολυφείδης	
Πολύφημος	
Πολυφόντης	
πολυχρόνιος	long-existing, of olden time, ancient
πομπεύς	one who attends or escorts, a conductor, guide
πομπή	conduct, escort, guidance
ποντίζω	to plunge in the sea
Ποντομεδούσα	
Πόντος	
πόντος	the sea
πορεία	a walking, mode of walking or running, gait
πορεύω	to make to go, carry, convey
Πορθάων	
Πόρθευς	
πορθέω	to destroy, ravage, waste, plunder
πόρθησις	the sack
πορθμεία	
πόρος	a means of passing a river, a ford, ferry
πορφύρεος	darkgleaming, dark;
πορφύριον	
Πορφυρίων	
πορφύρω	gleams darkly
πόρω	to furnish, offer, present, give
Ποσειδῶν	Poseidon
Ποσειδωνεῖος	
πόσος	bulk)
ποσόω	to reckon up, count
ποταμός	a river, stream
Ποταμών	
ποτάομαι	to fly about
πότε	when? at what time?
ποτέ	at some time or other, at some time
πότερος	whether of the two?
ποτόν	
ποτός	drunk, fit for drinking
πότος	drinking, a drinking-bout, carousal
ποῦ	where?
πού	anywhere, somewhere
πούς	a foot
πρᾶγμα	that which has been done, a deed, act
Πραξιθέη	
πράσσω	to pass over
πραύνω	to make soft, mild or gentle, to soften, soothe, calm
πρέσβις	age
πρέσβυς	an old man
πρεσβύτης	
Πρίαμος	Priam
πρίν	comparative
πρίω	to saw
πρό	before
προαίρεσις	a choosing
προαιρέω	to bring forth, produce from one's stores
προβαίνω	to step on, step forward, advance
πρόβατον	anything that walks forward;
πρό-γαμέω	
πρόγονος	a forefather, ancestor
προδίδωμι	to give beforehand, pay in advance
προδοσία	a giving up, betrayal, treason
προδότης	a betrayer, traitor
προεῖδον	to see beforehand, catch sight of
προεῖπον	to tell or state before
προερέω	to say beforehand
προέρχομαι	to go forward, go on, advance
προέχω	to hold before
προθέω	
Πρόθοος	
πρόθυμος	ready, willing, eager, zealous
πρόθυρον	the front-door, the door leading from the
προίημι	to send before, send on or forward
προίξ	a gift, present
Προιτίδες	
Προῖτος	
προκαθηγέομαι	to go before and guide
προκαλέω	to call forth
Προκλέης	
Προκλείη	
Προκλής	
πρόκλησις	a calling forth, challenging, challenge
Πρόκνη	
προκρίνω	to choose before others, choose by preference, prefer, select
Πρόκρις	
προλέγω	
προμανθάνω	to learn beforehand
προμαντεύομαι	to prophesy
Πρόμαχος	
Προμηθεύς	Prometheus
προμηθής	forethinking, provident, cautious
Πρόμος	
προνοέω	to perceive before, foresee
Προνόη	
πρόνοια	foresight, foreknowledge
Πρόνομος	
Πρόνοος	
πρόνους	careful
πρόοιδα	to know beforehand
προπέμπω	to send before, send on or forward
Προποντίς	the fore-sea
πρός	motion from
προσαγγέλλω	to announce
προσαγορεύω	to address, greet, accost
προσανέχω	to wait patiently for
προσάπτω	to fasten or attach to, attribute
προσαρμόζω	to fit to, attach closely to
προσαρτάω	to fasten or attach to
προσδέχομαι	to receive favourably, accept
προσδέω	
προσδοκία	a looking for, expectation
πρόσειμι	
προσερέω	to speak to, address, accost
προσέρχομαι	to come or go to
προσέτι	over and above, besides
προσέχω	to hold to, offer
προσήκω	to have arrived at
προσηλόω	to nail, pin
πρόσθεν	before
προσίημι	to send to or towards, let come to
προσίσχουσιΚρητῃ	
προσίσχω	
προσκαλέω	to call to, call on, summon
προσλαμβάνω	to take or receive besides, get over and above
πρόσΛυκομηδην	
προσνέμω	to assign, attach or dedicate to
προσομιλέω	to hold intercourse with, live or associate with, converse with
προσονομάζω	to call by a name
προσορμίζομαι	to come to anchor near
προσπασσαλεύω	to nail fast to
προσπελάζω	to make to approach, bring near to
προσπέμπω	to send to
προσπλέω	to sail towards or against
προσποιέω	to make over to
προσποίητος	
πρόσταξις	an ordaining, an ordinance, command
προστάσσω	to place or post at
προστειχίζω	to add to a fortification, include in the city-wall
προστίθημι	to put to
προστρέχω	to run to or towards, come to
προσφέρω	to bring to or upon, apply to
προσφεύγω	to flee for refuge to
προσφιλής	dear, beloved
προσφύω	to make to grow to
προσχώννυμι	to heap up besides
πρόσω	forwards, onwards, further
πρόσωπον	the face, visage, countenance
προτείνω	to stretch out before, hold before
προτερέω	to be before, be in advance
πρότερος	prae.
προτομή	the foremost or upper part of anything: a bust or half-figure
πρόφασις	that which is alleged as the cause, an allegation, plea
πρύμνα	the hindmost part of a ship, the stern, poop
πρώην	lately, just now
Πρῶ́ναξ	
πρῷρα	the forepart of a ship, a ship's head, prow, bow
Πρωτεσίλαος	Protesilaus, first-of-the-people
Πρωτεύς	
πρωτεύω	to be the first, hold the first place
Πρωτογενεία	
πρωτογένεια	
πρωτογένειος	
πρῶτος	
πρωτός	
Πρωτώ	
Πτελέων	
Πτερέλαος	
πτερόν	feathers
πτέρυξ	the wing
πτερωτός	feathered
πτηνός	feathered, winged
πτοέω	to terrify, scare
Πτολεμαῖος	
Πτῶος	
Πυγμαλίων	
πυγμή	a fist
Πυθία	the Pythia, priestess of Pythian Apollo
Πυθίανἦλθε	
Πύθιος	Pythian
Πυθώ	Pytho
πύθω	to make rot, to rot
Πύθων	Python
πυκτεύω	to practise boxing, box, spar
Πυλάδης	
Πύλαι	
Πυλαιμένης	
Πυλάργη	
πύλη	one wing of a pair of double gates
Πύλης	
Πυλίη	
Πύλιοι	
Πύλιος	
Πύλος	Pylos
πυλόω	to furnish with gates
πυνθάνομαι	to learn by hearsay or by inquiry
πῦρ	fire
Πυραίχμης	
Πύραμος	
πύργος	a tower
πυργόω	to gird or fence with towers
πυρεύς	a fire-proof vessel
πυρή	any place where fire is kindled
Πυρήνη	
πυρίπνους	fire-breathing, fiery
Πυρίππη	
πυρός	wheat
πυρόω	to burn with fire, burn up
Πύρρα	
Πύρρος	
πυρρός	flame-coloured, yellowish-red
πυρσός	a firebrand, torch
πυρσοφορέω	
πω	up to this time, yet
πῶς	how? in what way or manner?
πως	in any way, at all, by any means
ρ	
ῥάβδος	a rod, wand, stick, switch
Ῥαδάμανθυς	
ῥαίνω	to sprinkle, besprinkle
ῥάμμα	
ῥέα	easily, lightly
Ῥέα	Rhea
ῥεῖθρον	that which flows, a river, stream
ῥέον	
ῥέος	a stream
ῥέω	to flow, run, stream, gush
Ῥήγιον	
ῥήγνυμι	to break, break asunder or in pieces, rend, shiver, shatter
Ῥηξήνωρ	
ῥηξήνωρ	breaking through armed ranks
Ῥῆσος	
ῥίζα	a root
ῥίπτω	to throw, cast, hurl
ῥίς	the nose
Ῥόδη	
Ῥοδιακός	Rhodian, of Rhodes
Ῥόδιος	
Ῥοδίος	
ῥόδον	the rose
Ῥόδος	Rhodes
ῥοιά	mulberry.
Ῥοῖκος	
Ῥοίτειον	
ῥόπαλον	a club, cudgel
ῥύομαι	to draw to oneself
ῥώμη	bodily strength, strength, might
ῥώννυμι	to strengthen, make strong and mighty
Σαγγάριος	
Σαλαμίνιος	Salaminian, of or from Salamis
Σαλαμίς	Salamis
Σαλμυδησσός	
Σαλμωνεύς	
σάλπιγξ	a war-trumpet, trump
Σάμη	
Σαμοθρᾴκη	Samothrace
Σάνδοκος	
Σάραπις	
σαρδόνιον	the rope sustaining the upper-edge of a hunting-net
σαρδόνιος	
Σαρδώ	Sardinia
σαρκάω	
σάρξ	flesh
Σαρπηδών	
Σάτυρος	a Satyr
Σαώ	
Σειληνός	Silenus
σειρά	a cord, rope, string, band
Σειρήν	a Siren
Σελήνη	
Σεμέλη	
σέριφον	
Σέριφος	
σῆμα	a sign, mark, token
σημεῖον	a sign, a mark, token
σημειόω	to mark
σήπω	to make rotten
Σθενέβοια	
Σθενέλαος	
Σθενέλευς	
Σθενέλη	
Σθένελος	
Σθενώ	
σιαγών	the jawbone, jaw
Σίγειον	
Σίδη	
σιδήρεος	made of iron or steel, iron
σίδηρον	
σίδηρος	iron
σιδηρόω	to overlay with iron
Σιδηρώ	
Σιδών	Sidon
Σικελία	Sicily
Σικελικός	Sicilian
Σικυών	Sicyon
Σιμόεις	the
Σιμωνίδης	
Σίνις	
Σίνων	Sinon
Σίπυλος	
Σίσυφος	the craftiest
σιτέομαι	to take food, eat
σῖτος	corn, grain
Σκαιαῖσπυλαις	
Σκαίη	
Σκαῖος	
Σκαιός	
Σκάμανδρος	the Scamander
σκάπτω	to dig, delve
σκάφη	anything dug or scooped out
σκαφή	
σκάφος	
Σκείρων	
Σκειρωνίς	
σκέλος	the leg
σκηνάω	to dwell, live
σκηνέω	to be or dwell in a tent, to be encamped
σκηνή	a covered place, a tent
σκῆπτρον	a staff or stick to lean upon, a walking-stick
σκῆψις	a pretext, plea, excuse, pretence
σκόλοψ	
σκόπελον	
σκόπελος	a look-out place, a peak, headland or promontory
σκοτόω	to make dark, to blind
Σκύθης	a Scythian
Σκυθία	
Σκυθίη	
Σκυθικός	Scythian
Σκύθιος	
Σκύλλα	Scylla
Σκύλλαἑξ	
Σκύριος	
Σκῦρος	Scyros
σκύταλον	
σκύταλος	
σκώληξ	a worm
σκώπτω	to hoot, mock, jeer, scoff at
σμικρός	
σμύρνα	myrrh
Σμύρνα	Smyrna
Σμύρνη	
Σόλυμοι	
σορός	a vessel for holding
Σούνιον	Sunium
σοφός	skilled in any handicraft or art, cunning in his craft
σπαίρω	to gasp
σπαράσσω	to tear, rend in pieces, mangle
σπάργανον	a swathing band
σπαργανόω	to wrap in swaddling-clothes, swathe
Σπάρτη	Sparta
Σπαρτός	
σπάω	to draw
σπεῖρα	coiled
σπείραμα	a coil, spire, convolution
σπειράομαι	to be coiled or folded round.
σπεῖρος	
σπείρω	to sow
Σπειώ	
σπένδω	to pour or make a drink-offering
Σπερχειός	the Spercheius
σπεύδω	to set a-going, to urge on, hasten, quicken
σπήλαιον	a grotto, cave, cavern
σπλάγχνον	the inward parts
σπονδή	a drink-offering
σπουδάζω	to make haste
σπυράς	a ball of dung
σταδιαῖος	
στάδιον	a stade, =
στάδιος	standing firm
σταλαγμός	a dropping, dripping
στασιάζω	to rebel, revolt, rise in rebellion
στάσις	a standing, the posture of standing
Στάφυλος	
στέγη	a roof
στενός	narrow, strait
στενυγρός	
στερέω	to deprive, bereave, rob of
στέρνον	the breast, chest
Στέρνοψ	
Στερόπης	lightner
στέφανος	that which surrounds
στεφανόω	to be put round
στῆθος	the breast
στήλη	a block of stone
Στησίχορος	Stesichorus
στολή	an equipment, armament
στόλος	an equipment
στόμα	the mouth
στόμιον	the mouth
στόρεννυμι	
στράπτω	to lighten
στρατάω%	
στρατεία	an expedition, campaign
στράτευμα	an expedition, campaign
στρατεύω	to serve in war, serve as a soldier, do military service, take the field, march
στρατηγέω	to be general
στρατηγός	the leader or commander of an army, a general
στρατιά	
στρατία	an army
Στράτιος	
Στράτιχος	
Στρατοβάτης	
στρατολογέω	to levy soldiers
Στρατονίκη	
στρατοπεδεύω	to encamp, bivouac, take up a position
στρατόπεδον	the ground on which soldiers are encamped, a camp, encampment
στρατός	an encamped army
στρατοῦἦν	
στρατόω	to lead to war;
στρέφω	to turn about or aside, turn
στρουθός	the sparrow
Στροφάδες	
στροφάς	turning round
στρόφιον	a band worn by women
Στροφίος	
Στρόφιος	
Στρυμώ	
Στρυμών	the Strymon
Στύγνη	
Στυμφαλίς	
Στύμφαλος	
Στύξ	the Styx
σύ	
συγγενεύς	
συγγενής	born with, congenital, natural, in-born
συγγίγνομαι	to be with
συγγράφω	to write or note down
συγγυμνάζω	to exercise together
συγκαλέω	to call to council, convoke, convene
συγκατακαίω	to burn together or also
συγκατάκειμαι	to lie with or together
συγκατακλίνω	to make to lie with
συγκαταλέγεταιὡς	
συγκαταμίγνυμι	to mix in with, mingle, blend with
συγκοιμάομαι	to sleep with, lie with
συγκρίνω	to compound
συγκρούω	to strike together
συγχωρέω	to come together, meet
συζεύγνυμι	to yoke together, couple or pair together
συζητέω	to search or examine together with
σύζυγος	yoked together, paired
συλάω	to strip off
Συλέη	
Συλέος	
συλεύς	
Σύλευς	
σύλη	the right of seizing the ship or cargo
συλλαμβάνω	to collect, gather together
Σύμαιος	
συμβαίνω	to stand with the feet together
συμβάλλω	to throw together, dash together
σύμβολον	a sign or token by which one infers
σύμβολος	an augury, omen
συμβουλεύω	to advise, counsel
συμμαχέω	to be an ally, to be in alliance
συμμάχομαι	to fight along with
σύμμαχος	fighting along with, allied with
συμμίγνυμι	to mix together, commingle
σύμπας	all together, all at once, all in a body
συμπείθω	to join or assist in persuading
συμπίτνω	
συμπλέκω	to twine or plait together
συμπληγάς	striking or dashing together
σύμπλους	sailing with
συμπράσσω	to join or help in doing
σύμπτωσις	a collapsing
συμφεύγω	to flee along with
συμφορά	an event, circumstance, chance, hap
συμφορᾶσἐπληρωθη	
συμφορεύς	aide-de-camp
συμφορέω	to bring together, to gather, collect, heap up
συμφράζομαι	to join in considering, to take counsel with
συμφράσσω	to press or pack closely together
συμφυής	born with one, congenital, natural
συμφύω	to make to grow together
σύν	along with, in company with, together with
συνάγω	to bring together, gather together, collect, convene
συναθροίζω	to gather together, assemble
συναναγκάζω	to join or assist in compelling
συνανάκειμαι	to recline together at table
συναναμίγνυμι	to mix up together
συναντάω	to meet face to face
συναπόλλυμι	to destroy together
σύν-ἀποσπάω	
συνάπτω	to tie or bind together, to join together, unite
συναρπάζω	to seize and carry clean away
σύν-γνωμονέω	
συνδέομαι	to join in begging
συνδέω	to bind or tie together
συνδιώκω	to chase away together, join in the chase
σύνεγγυς	near together
σύν-εἶδον	
σύνειμι	
συνεῖπον	to speak with
συνελαύνω	to drive together
συνεξέρχομαι	to go or come out with
συνεπιβουλεύω	to join in plotting against
συνέπομαι	to follow along with, follow closely
συνεργέω	to work together with, help in work, cooperate
συνεργός	working together, joining or helping in work
συνέρχομαι	to go together or in company
συνευνάζομαι	to lie with
συνευνάομαι	
σύνευνος	a consort
συνεχέθη	
συνεχής	holding together
σύν-ἠθέω	
συνήθης	dwelling or living together, accustomed or used to each other
συνηρεφής	thickly covered
σύνθηρος	hunting with
συνθύτης	
συνίημι	to bring or set together
συνίστημι	to set together, combine, associate, unite, band together
σύν-καταλέγω	
συνοικέω	to dwell together
συνοικίζω	to make to live with
συνοργίζομαι	to be angry together with
συνουσία	a being with, social intercourse, society, conversation, communion
συνουσιάζω	
σύν-σκεπάζω	
συντελέω	to bring quite to an end, complete, accomplish
συντίθημι	to put together
συντυγχάνω	to meet with, fall in with
συνωμοσία	a being leagued by oath, conspiracy
Συρία	Syria
συριγμός	a whistling, hissing
σῦριγξ	a pipe
συρίζω	to play the σῦριγξ, to pipe
Σύριος	of or from Syria
σύρον	
σύρος	
Σῦρος	Syros
σύρω	to draw, drag
συστάς	standing together, planted closely
συστρατεύω	to make a campaign or serve together, to join or share in an expedition
σφαγεύς	a slayer, butcher
σφαγή	slaughter, butchery
σφάγιον	a victim, offering
σφάγιος	slaying, slaughtering
σφάζω	to slay, slaughter
σφάλλω	to make to fall, throw down, overthrow
σφέτερος	their own, their
Σφίγξ	Sphinx
σφοδρός	vehement, violent, excessive
σφῦρα	a hammer
σφυρόν	the ankle
σχεδία	a raft, float
Σχεδίος	
σχέδιος	hand to hand, in or for close combat
σχεδόν	close, near, hard by, nigh
σχῆμα	form, figure, appearance
σχίζω	to split, cleave
Σχοινεύς	
Σχοίνευς	
σχοινίον	a cord
σχοινίων	the sedge-bird
σώζω	to save, keep
Σώκλευς	
Σωκλής	
σῶμα	the body
σῶς	safe and sound, alive and well, in good case
σωτήρ	a saviour, deliverer, preserver
σωτηρία	a saving, deliverance, preservation, safety
σωφρονέω	to be sound of mind
σώφρων	of sound mind
Ταίναρον	
Ταίναρος	Taenarus
τακτός	ordered, prescribed
Ταλαιμένης	
Ταλαός	
Ταλθύβιος	
Τάλος	
Τάλως	
Τάνταλος	Tantalus
ταράσσω	to stir, stir up, trouble
Τάρταρος	Tartarus
Ταρταρόω	to cast into Tartarus or hell
Ταρτησσός	
τάσσω	to arrange, put in order
Ταϋγέτη	
ταύρειος	of bulls, oxen
ταυροπόλος	worshipped at Tauris
Ταυρόπολος	
Ταῦρος	
ταῦρος	a bull
ταύτῃ	in this way.
ταφή	burial
Τάφιοι	
Τάφιος	
τάφος	
Τάφος	
τάφρος	a ditch, trench
τάφῳκατεσφαξαν	
ταχέως	
τάχος	swiftness, speed, fleetness, velocity
ταχύς	quick, swift, fleet
τε	and
Τέβρος	
Τεγέα	Tegea
Τεγεάτης	of Tegea
Τεγύριος	
τέθηπα	to be astonished, astounded, amazed
τείνω	
Τειρεσίης	
τειχέω	to build walls
τειχίζω	to build a wall
τεῖχος	a wall
τεκμαίρομαι	to fix by a mark or boundary, to ordain, decree
τέκνον	that which is borne or born, a child
τεκνοποιέω	to bear children
τεκνόω	to furnish or stock with children
τεκταίνομαι	to make, work, frame
Τελαμών	
τέλειος	having reached its end, finished, complete
τελειόω	to make perfect, complete
Τελέσιλλα	
Τελέστης	
τελετή	initiation
τελετής	
Τέλευς	
Τελευταγόρης	
τελευταῖος	last
τελευτάω	to complete, finish, accomplish
τελευτή	a finishing, completion, accomplishment
τελέω	to complete, fulfil, accomplish
Τελέων	
Τέλης	
τέλλω	to make to arise, accomplish
Τέλμιος	
τέλος	the fulfilment or completion
Τελχίν	one of the Telchines
τέμενος	a piece of land cut off, assigned as a domain
τέμνω	to cut, hew
Τένεδος	
Τένης	
Τενθρήδων	
τέος	
τέρμα	an end, boundary
τέρπω	to satisfy, delight, gladden, cheer
Τερψικράτη	
Τερψιχόρη	Terpsichore, dance-enjoying
τερψίχορος	enjoying the dance
τεσσαράκοντα	forty
τέσσαρες	four
τέταρτος	fourth
τετραίνω	to bore through, pierce, perforate
τετραπηχυαῖος	
τετράπους	four-footed
τέτραχα	in four parts
τετραχῇ	
Τευθρανίη	
Τεύθρας	
Τεῦκρος	
Τευταμίδης	
τεύχω	to make ready, make, build, work
τεχνάομαι	to make by art, to execute skilfully
τέχνη	art, skill, craft in work, cunning of hand
τέως	so long, meanwhile, the while
τῇ	here, there
Τηθύς	Tethys
τήκω	to melt, melt down
τηλεβόας	
Τηλεβόης	
Τηλέγονος	
Τηλεδίκη	
τηλεμάχος	fighting from afar.
Τηλέμαχος	
Τηλέφασσα	
Τήλεφος	
τηλικοῦτος	
τηλοῦ	afar, far off or away, in a far country
Τήμενος	
τηνικαῦτα	at that time, then
τήνοἰκησιν	
Τῆνος	
Τηρεύς	
τηρέω	to watch over, protect, guard
Τηρηίς	
τῆσπολεως	
Τίγασις	
Τίγρης	
τίθημι	to set, put, place
τιθηνέομαι	to nurse, suckle, tend as nurse
Τιθωνός	Tithonus
τίκτω	to bring into the world
Τιλφοῦσσα	
Τίμανδρα	
τιμάω	to pay honour to, hold in honour, to honour, revere, reverence
τιμή	that which is paid in token of worth or value
τιμωρέω	to help, aid, succour
τίνω	to pay a price
Τιρύνθιος	
Τίρυνς	
τις	any one, any thing, some one, some thing;
τίς	who? which?
Τισαμενός	
Τισιφόνη	
Τιτάν	the Titans
Τιτάνης	
Τιτανίς	
τιτανομαχία	
Τίτανος	
τιτρώσκω	to wound
Τιτυός	Tityus
Τίφυς	
Τιφύση	
Τληπόλεμος	
Τμῶλος	Mt. Tmolus
τοίνυν	therefore, accordingly
τοιόσδε	such a
τοιοῦτος	such as this
τόκος	a bringing forth, childbirth, parturition
τολμάω	to undertake, take heart
Τόμος	
τόνπλοῦν	
τοξεύς	
Τόξευς	
τοξεύω	to shoot with the bow
τοξικός	of or for the bow
Τοξικράτη	
τόξον	a bow
τόπελαγος	
τόπος	a place
Τορώνη	
τοσοῦτος	so large, so tall
τότε	at that time, then
τοῦΚατρεως	
τούσἱππους	
τούτωνδε	
τούτωνμιαν	
Τράγασος	
τραγικός	of or like a goat, goatish
τράπεζα	four-legged a table
Τραπεζόεις	
τραπεζώ	
τραπέω	to tread grapes
τραῦμα	a wound, hurt
τράχηλος	the neck, throat
Τραχίνιος	
Τραχίς	Trachis
τρεῖς	
τρέπω	to turn or direct
τρέφω	to thicken or congeal
τρέχω	to run
τρέω	to flee from fear, flee away
τρία	
τρίαινα	a trident
τριακοστός	the thirtieth
τριάξω	to vanquish
τριετία	
τρίζω	to utter a shrill cry, to scream, cry
Τρίηνος	
τριήρης	
Τρίκκαιος	
Τριόπης	
τριόφθαλμος	
Τρίοψ	
τρίπηχυς	three cubits long or tall
τριπλασιάζω	to triple, take three times
τρίπους	three-footed, of or with three feet
Τριπτόλεμος	
τρίς	thrice, three times
τρισχίλιοι	three thousand
τρίτος	the third
Τρίτων	Triton
τρίχα	threefold, in three parts
τριχρώματος	
Τροία	Troy
Τροίανἐλθεῖν	
Τροιζήν	Troezen
Τροίζηνος	
τροπέω	to turn
τροπή	a turn, turning
τρόπονζητῶν	
τρόπος	a turn, direction, course, way
τροφεύς	one who rears or brings up, a foster-father
τροφή	nourishment, food, victuals
τροφός	a feeder, rearer, nurse
τροχάζω	to run like a wheel, to run along, run quickly
τροχή	
τροχός	anything that runs round
τρυγών	the turtle-dove
τρῦχος	a worn out garment, a rag, shred
Τρωικός	Trojan
Τρωί̈λος	
Τρώς	Tros
τυγχάνω	to hit
Τυδεύς	Tydeus
Τυνδάρεος	Tyndareos or Tyndarus
τύπτω	to beat, strike, smite
τυραννεύω	to be a τύραννος, an absolute sovereign or despot
τυραννίς	kingly power, sovereignty
τύραννος	an absolute sovereign
Τύραννος	
Τύριος	of Tyre, Tyrian
τυρός	cheese
Τυρρηνίη	
Τυρρηνικός	
Τυρρήνιος	
Τυρρηνός	
Τυρσηνός	Tyrrhenian, Etruscan
Τυρώ	
τυφλός	blind
τυφλόω	to blind, make blind
Τυφωεύς	Typhoeus or Typhos
Τυφῶν	Typhon
Τυφώς	a whirlwind, typhoon
τῷ	therefore, in this wise, thereupon
Ὑάδες	the Hyades
Ὑάκινθος	Hyacinthus
ὑάκινθος	the hyacinth
ὑβρίζω	to wax wanton, run riot
Ὕβρις	
ὕβρις	wantonness, wanton violence or insolence
ὑβριστής	a violent, overbearing person, a wanton, insolent man
ὑγραίνω	to wet, moisten
ὕδρα	a hydra, water-serpent
ὑδρεία	a drawing water, fetching water
ὑδρεύω	to draw, fetch or carry water
ὑδρία	a water-pot, pitcher, urn
ὕδριος	
ὕδρος	a water-snake
ὕδωρ	water
ὑετός	rain
υἱός	A son
Ὑλαῖος	
ὑλαῖος	of the forest, savage
ὑλάω	to howl, bark, bay
Ὑλεύς	
ὕλη	forest-trees
Ὕλη	
ὗλις	
Ὕλλος	
ὕλλος	
ὑμέναιος	hymenaeus, the wedding or bridal song
Ὑμέναιος	
ὑπακούω	to listen, hearken, give ear
ὕπαρχος	commanding under
ὑπάρχω	to begin, make a beginning
ὑπέθεμεν	
Ὑπείροχος	
ὑπέρ	over, above, w. gen, over, beyond, w. acc.
ὑπεραποθνήσκω	to die for
ὑπερβαίνω	to step over, mount, scale
ὑπερβάλλω	to throw over or beyond a mark, to overshoot
Ὑπέρβιος	
ὑπέρβιος	of overwhelming strength or might
Ὑπερβόρεοι	the Hyperboreans
Ὑπερβόρεος	
ὑπερέβαλλονὑπερηφανιᾳ	
ὑπερέπτω	to eat away from under
ὑπερέχω	to hold
Ὑπερήνωρ	
ὑπερήνωρ	overbearing, overweening
ὑπερηφάνεια	
ὕπερθεν	from above
Ὑπερίππη	
Ὑπερίων	Hyperion, the Sun-god
ὑπέρκειμαι	to lie or be situate above
Ὑπέρλαος	
ὑπερμεγέθης	
Ὑπερμνήστρη	
ὑπεροράω	to look over, look down upon
ὑπερόριος	over the boundaries or confines, living abroad
ὑπέροχος	prominent, eminent, distinguished above
ὑπερπέτομαι	to fly over
ὑπερπηδάω	to leap over
ὑπερτενής	stretching over, laid over
ὑπερτίθημι	to set higher, erect
Ὑπέρφας	
ὑπερφύομαι	to surpass, excel
ὑπέχω	to hold or put under
ὑπισχνέομαι	to promise or engage
ὕπνος	sleep, slumber
ὑπνόω	to put to sleep
ὑπό	from under, by, c. gen. under, c. dat., towards c. acc.
ὑποβάλλω	to throw, put or lay under
ὑπόβλητος	put in another's place, counterfeit, suborned, false
ὑποβρύχιος	under water
ὑποδείκνυμι	to shew secretly
ὑποδέχομαι	to receive beneath
ὑπόδημα	a sole bound under the foot with straps, a sandal
ὑποδύομαι	
ὑποθήκη	a suggestion, counsel, warning, piece of advice
ὑπομένω	to stay behind, survive
ὑπομιμνήσκω	to remind
ὑπόὈρεστου	
Ὑποπλακίη	
ὑποπλάκιος	under mount Placus
ὑπόπτερος	winged
ὑπό-στόρεννυμι	
ὑποστρέφω	to turn round about, turn back
ὑποστροφή	a turning about, wheeling round
ὑπόσχεσις	an undertaking, engagement, promise
ὑποτίθημι	to place under
ὑποτιμάομαι	to propose a less penalty
ὑποτρέχω	to run in under
ὑποχθόνιος	under the earth, subterranean
ὑπώρεια	the foot of a mountain, the skirts of a mountain range
Ὑρίευς	
Ὑριεύς	
Ὑρίη	
Ὑρνηθώ	
Ὕρτακος	
ὗς	the wild swine
ὑστερέω	to be behind or later, come late
ὕστερον	
ὕστερονκηρυκα	
ὕστερος	latter, last
ὑφαίνω	to weave
ὕφαλος	under the sea
ὑφάπτω	to set on fire from underneath
ὑφή	a web
ὑφηγέομαι	to go just before, to guide, lead
ὑφίστημι	to place or set under
Ὕψευς	
ὑψηλός	high, lofty, high-raised
Ὑψιπύλη	
Ὕψισται	
ὕψιστος	highest, loftiest
ὕψος	height
φαγεῖν	to eat, devour
φάγος	
φαέθω	to shine
Φαίαξ	a Phaeacian
Φαίδιμος	
φαίδρα	
Φαίδρη	
Φαιή	
φαίνω	to bring to light, make to appear
φαιός	dusky, dun, gray
Φαλίης	
φανερός	open to sight, visible, manifest, evident
Φᾶνος	
Φάντης	
φάος	light, daylight
φαρμακάω	to suffer from the effect of poison, to be ill or distraught
φαρμακεύω	to administer a drug
φαρμακίς	a sorceress, witch
φάρμακον	a drug, medicine
φάρμακος	
φαρμάσσω	to treat by using
Φαρνάκη	
Φαρνάκης	
Φάρτις	
Φᾶσις	the river Phasis
φάσκω	to say, affirm, assert
Φάσσος	
φάτνη	a manger, crib, feeding-trough
Φείδιππος	
φείδομαι	to spare
Φεραί	
Φεραῖος	
Φέρεκλος	
Φερεκύδης	
Φέρης	
Φεροίτης	
Φέρουσα	
Φερσέφασσα	
φέρτατος	bravest, best
φέρω	to bear
φεύγω	to flee, take flight, run away
Φηγεύς	
φηγός	oak
φημί	to declare, make known
Φήνευς	
φθάνω	to come or do first or before
φθέγγομαι	to utter a sound or voice
φθείρω	to ruin, waste, spoil, destroy
φθία	Phthia
Φθῖος	
φθίω	to decay, wane, dwindle
φθονέω	to bear ill-will or malice, bear a grudge, be envious or jealous
φθόνος	ill-will, envy, jealousy
φθορά	destruction, ruin, perdition
φθορεύς	
Φίκιον	
φίλαιμος	
Φιλαίμων	
Φιλάμμων	
φιλία	friendly love, affection, friendship
φίλιος	of or from a friend, friendly
Φιλόδημος	
Φιλοίτιος	
Φιλοκράτης	
Φιλοκτήτης	
Φιλόλαος	
φιλομήλα	the nightingale
Φιλομήλη	
φιλονεικέω	to be fond of strife, engage in eager rivalry, be contentious
φιλονεικία	love of strife, eager rivalry, contentiousness, party-spirit
Φιλονόη	
Φιλονόμη	
φίλος	loved, beloved, dear
φῖλος	
φιλοφρονέομαι	to treat affectionately, to shew kindness to
φιλόφρων	kindly minded, kindly, friendly, affable
φίλτρον	a love-charm
φιλύρα	the lime or linden tree
Φιλύρη	
Φινεύς	
Φλέγρη	
Φλεγύης	
φλέψ	a vein
φλογίς	
φλοιός	the bark
φλόξ	a flame
φοβερός	fearful
φοβέω	to put to flight
φόβος	flight
φοιβάω	to cleanse, purify
Φοίβη	
φοῖβος	bright, radiant
φοινίκεος	purple-red, purple or crimson
Φοινίκη	
Φοῖνιξ	a Phoenician
φοιτάω	to go to and fro, up and down, to stalk
φολίς	
Φολόη	
Φόλος	
φονάω	to be athirst for blood, to be murderous
φονεύς	a murderer, slayer, homicide
φονεύω	to murder, kill, slay
φόνος	murder, homicide, slaughter
Φόρβας	
Φόρβης	
Φόρβος	
φορέω	to bear or carry constantly, to be used to carry
Φορκίδες	the daughters of Phorcys
Φόρκος	
Φόρκυς	Phorcys
Φορωνεύς	
φράζω	to point out, shew, indicate
Φράσιμος	
Φράσιος	
Φρασίος	
φράσις	speech; enunciation
φρέαρ	a well
Φρένιος	
Φρίξος	
φρῖξος	
φρονέω	to think, to have understanding, to be sage, wise, prudent
Φρόντις	
φρουρά	a looking out, watch, guard
φρουρέω	to keep watch or guard
φρουρός	a watcher, guard
φρυγία	
Φρύγιος	Phrygian, of, from Phrygia
φρύγω	to roast or fry
φρυκτός	roasted
φρῦνος	a toad
Φρύξ	a Phrygian
φυγαδεύω	to drive from a country, banish
φυγάς	one who flees
φυγή	flight
φυλάζω	to divide into tribes
Φυλάκη	
φυλακή	a watching or guarding, watch, guard, ward
φυλακός	
Φύλακος	
φύλαξ	a watcher, guard, sentinel
φύλαξις	a security
Φύλας	
φυλάσσω	to keep watch and ward, keep guard
Φυλεύς	
Φυληίς	
Φυλλίς	
Φυλομάχη	
Φυλονόη	
Φυλόνομος	
φύξιον	a place of refuge
φύξιος	
φυράω	to mix
φύρω	to mix
φύς	a son;
φυσάω	to puff or blow up, distend
Φύσιος	
φύσις	the nature, natural qualities, powers, constitution, condition
φυτεύω	to plant
φυτόν	that which has grown, a plant, tree
φυτός	shaped by nature, without art
φύω	to bring forth, produce, put forth
Φώκαια	
Φωκεύς	a Phocian
φώκη	a seal
Φωκικός	Phocian
Φωκίς	Phocis
Φῶκος	
φωλεός	a hole, den
φωνέω	to produce a sound or tone
φωνή	a sound, tone
φωνήεις	uttering a voice or speech, endowed with speech, vocal
φωράω	to search after a thief or theft, search a house
χαίρω	to rejoice, be glad, be delighted
Χαῖτος	
χαλεπός	hard to bear, painful, sore, grievous
χαλκεῖον	a smith's shop, forge, smithy
χάλκεος	of copper or bronze, brasen
χαλκεύς	a worker in copper, a smith
Χαλκιόπη	
χαλκόπους	brass-hoofed
χαλκός	copper
χαλκοῦς	a copper coin
χαλκόω	to make in bronze
Χαλκώδων	
χαρίζομαι	to say or do something agreeable
Χαρικλής	
Χαρικλώ	
χάρις	Grace
χαριστήριος	of or for thanksgiving
Χάροπος	
Χάρυβδις	Charybdis
χάσμα	a yawning hollow, chasm, gulf
χασμάω	to yawn, gape wide
χάσμη	a yawning, gaping
χεῖλος	a lip
χειμάζω	to pass the winter
χειμών	winter
χειμῶναπροσενεχθῆναι	
χείρ	the hand
Χειρίμαχος	
χειροήθης	accustomed to the hand, manageable;
χειρουργικός	of or for handiwork
χειρόω	to bring into hand, to manage, master, subdue
Χείρων	Cheiron
χελιδών	the swallow
χελώνη	a tortoise
χερνήτης	
Χερρόνησος	
Χερσιδάμας	
χερσόνησος	a land-island
χέρσος	dry land, land
χέω	to pour
χηλή	a horse's hoof
χήν	the tame goose
Χθονίη	
Χθόνιος	
Χθονίος	
χθόνιος	in, under or beneath the earth
χίλιοι	a thousand
χίλιος	
Χίμαιρα	
Χιόνη	
Χίος	Chios
χιτών	the garment worn next the skin, a frock
χιών	snow
Χλωρίς	
χοινικίς	the circle
χοῖρος	a young pig, porker
χολάω	to be full of black bile, to be melancholy mad
χολή	gall, bile
χόλος	gall, bile
χολόω	to make angry, provoke, anger
χορδή	gut-string, the string
χορεία	a dance
χορεῖος	
Χούσης	
χόω	to throw or heap up
χράομαι	consulting or using an oracle
χραύω	to scrape, graze, wound slightly
χράω	
χρεών	that which must be
χρή	it is fated, necessary
χρῆμα	a thing that one uses
χρησμός	the answer of an oracle, oracular response, oracle
χρησμῳδέω	to chant oracles
χρηστηριάζω	to give oracles, prophesy
χρίω	to touch on the surface: to rub or anoint with scented unguents
χροιά	the surface of a body, the skin; the body
Χρομίος	
Χρόμιος	
χρονίζω	to spend time
χρονικός	of or concerning time
χρόνος	time
χρυσάορος	with sword of gold
Χρυσάωρ	
χρύσεος	golden, of gold, decked or inlaid with gold
Χρύση	
Χρυσηίς	daughter of Chryses
Χρύσης	
Χρυσίππη	
Χρύσιππος	
Χρυσόθεμις	
χρυσόκερως	with horns of gold
χρυσόμαλλος	with golden wool or fleece
Χρυσοπελείη	
χρυσός	gold
χρυσόω	to make golden, gild
χρώς	the surface of the body, the skin
χωλός	lame
χώρα	the space in which a thing is
χωρέω	to make room for another, give way, draw back, retire, withdraw
χωρίον	a particular place, a place, spot, district
χωρίς	separately, asunder, apart, by oneself or by themselves
Ψαμάθη	
ψαύω	to touch
ψευδής	lying, false
ψεύδω	to cheat by lies, beguile
ψηλαφάω	to feel or grope about
Ψηρής	
ψηρός	
ψῆφος	a small stone, a pebble, rubbed and rounded
ψήφων	
ψυχαγωγέω	to lead departed souls to the nether world
ψυχή	breath
Ψωφίδιος	
Ψωφίς	
Ὠγυγία	Ogygia
Ὠγύγιος	Ogygian, of or from Ogyges
ᾠδή	a song, lay, ode
ὠδίς	the pangs or throes of labour, travail-pains
ὠθέω	to thrust, push, shove, force onwards or away
Ὠκαλέη	
Ὠκεανίς	
ὠκεανίς	of or from ocean
Ὠκεανός	Oceanus
Ὠκυθόη	
ὠκύθοος	swift-running
Ὠκυπέτη	
ὠκυπέτης	swift-flying, swift-running
Ὠκυπόδη	
ὠκυπόδης	
Ὤκυτος	
Ὠλενίη	
Ὠλένιος	
ὠλένιος	
Ὤλενος	Olenos
Ὤμαργος	
ὠμός	raw, undressed
ὦμος	ulna
ὠνέομαι	to buy, purchase
ᾠόν	eggs or
Ὦπις	
ὥρα	period
ὡραῖος	produced at the right season
Ὠρείθυια	
ὤριος	
Ὠρίων	Orion
ὦρος	a mountain
ὡς	thus, as, so that, since
ὥστε	as, as being
Ὦτος	