Field1	Field2
ἆ	ah!
̔Α	
̂̓Α	
Α	
̔́Α	
ἀαγής	unbroken, not to be broken, hard, strong
ἄατος	insatiate
ἀάω	to hurt, damage
ἀβλαβής	without harm
ἄγαθος	
ἀγαθός	good
ἀγάλλω	to make glorious, glorify, exalt
ἄγαλμα	a glory, delight, honour
ἄγαμαι	to wonder, be astonished
̓Αγαμέμνων	
ἄγαν	very, much, very much
ἀγανός	mild, gentle, kindly
ἀγαπάω	to treat with affection, to caress, love, be fond of
ἀγαπητός	beloved
̓Αγαύα	
ἀγαυός	illustrious, noble
ἀγγέλλω	to bear a message
ἄγγελος	a messenger, envoy
ἄγγος	a vessel
ἄγε	come! come on! well!
̓Αγεάνακτι	
̓Αγεάνακτος	
ἀγείρω	to bring together, gather together
ἀγελαῖος	belonging to a herd, feeding at large
ἀγέλη	a herd
ἀγεληδόν	in herds or companies
ἄγη	wonder, awe, amazement
ἀγήραος	not waxing old, undecaying
ἀγητός	admirable, wondrous
ἀγκάς	in or into the arms
̓́Αγκεα	
ἀγκή	
ἀγκίστριον	a fish-hook
ἄγκιστρον	a fish-hook
ἄγκοινα	
ἀγκοίνη	the bent arm
ἄγκος	a bend
ἀγκύλος	crooked, curved
ἀγλάαν	
ἀγλαίζω	to make bright or splendid
ἀγνοέω	not to perceive or know
ἁγνός	full of religious awe
ἄγνυμι	to break, shiver
ἀγοράζω	to be in the ἀγορά
ἀγορεύω	to speak in the assembly, harangue, speak
ἀγοστός	the flat of the hand
ἄγρα	a catching, hunting
ἀγρευτήρ	
ἀγρευτής	a hunter
ἀγρεύω	to take by hunting or fishing, to catch, take
ἀγρέω	to capture, seize
ἀγρία	
̓́Αγριε	
ἀγριέλαιος	of a wild olive
ἄγριος	living in the fields
ἄγροικος	of or in the country
ἀγροῖκος	
ἀγροιώτης	a countryman
ἀγροιῶτις	
ἀγρός	fields, lands
ἀγρότερος	wild
ἀγρυπνέω	to lie awake, be wakeful
ἀγρυπνία	sleeplessness, waking, watching
ἄγρυπνος	hunting after sleep
ἄγρωστις	a grass that mules fed on
ἀγχίαλος	near the sea
ἀγχίθυρος	next door
̓Αγχίσην	
ἀγχόθι	near
ἀγχόμορος	
ἄγχω	to compress, press tight
ἄγω	to lead or carry, to convey, bring
ἀγών	a number of people brought together, a gathering, assembly
ἄγωνος	
ἀδάκρυτος	without tears
ἀδαμάντινος	adamantine
ἀδάμας	
ἀδελφή	a sister
ἀδελφός	sons of the same mother
ἅδην	to eat their fill
ἀδηφάγος	eating one's fill, gluttonous
ἀδίαντον	
ἀδίαντος	unwetted
ἀδικέω	to do wrong
ἄδικος	wrong-doing, unrighteous, unjust
ἀδινός	close-packed
̔́Αδιον	
ἄδολος	without fraud, guileless
ἅδος	satiety, loathing
̓Αδρήστοιο	
̔Αδύ	
̓́Αδων	
̓́Αδωνι	
Αδωνιάζουσαι	
̓Αδώνιδι	
̓́Αδωνιν	
̓́Αδωνις	
ἀδώρητος	
ἀεθλητῆρες	
ἀεί	always, for ever
ἄει	
ἀείδω	to sing
ἀεικής	unseemly, shameful
ἄειρος	
ἀείρω	to lift, heave, raise up
ἀέκων	against one's will, unwilling
ἀέλιος	
ἀέναος	ever-flowing
ἀενάων	
ἀέξω	to increase, enlarge, foster, strengthen
ἀεργός	not-working, idle
ἀέργω	
ἀετός	an eagle
ἅζομαι	to stand in awe of, dread
ἄζυγος	unwedded
ἄζυξ	unyoked, unpaired, unmarried
ἀηδονιδεύς	a young nightingale
ἀηδονίς	a nightingale
ἀηδών	the songstress
ἄημι	to breathe hard, blow
ἀήρ	the lower air, the air
ἀήτη	
ἀήτης	a blast, gale
̓Αθάνα	
̓Αθανάας	
̓Αθαναία	
̓Αθαναίαν	
̓Αθάναν	
̓Αθάνας	
ἀθάνατος	undying, immortal
̓Αθανάτων	
ἀθέσφατος	beyond even a god's power to express: ineffable, aweful
̓Αθηναῖος	
ἄθλα	
ἀθλεύω	to contend for a prize, combat, wrestle
ἄθλημα	a contest
ἆθλον	the prize of contest
ἆθλος	a contest for a prize
ἀθλοφόρος	bearing away the prize, victorious
ἀθρέω	to look at, gaze at, observe, perceive
ἀθρόος	in crowds or masses, crowded together
ἀθρώποισι	
̓́Αθω	
αἴ	ha!
αἶα	
Αἶα	
αἰάζω	to cry αἰαῖ, to wail
αἰαῖ	ah!
Αἰακίδης	son of Aeacus
Αἴας	Ajax
αἴγειρος	the poplar
Αἰγιάλευς	
Αἰγιαλεύς	
αἰγιαλόνδε	
αἰγιαλός	the sea-shore, beach, strand
αἰγιβάτης	
αἴγιλος	a herb of which goats are fond
αἰγίοχος	Aegis-bearing
αἰγίπυρος	a plant
αἰγυπτία	
Αἰγύπτιος	Egyptian
Αἰγυπτιστί	in the Egyptian tongue
Αἴγυπτος	the river Nile
Αἴγων	
Αἴγωνος	
̓Αίδα	
̔́Αιδα	
̓Αίδαν	
̔́Αιδαν	
̓Αίδαο	
αἰδέομαι	to be ashamed to do
̓Αίδην	
̔́Αιδης	
αἰδοῖος	regarded with reverence, august, venerable
Αἰδωνῆος	
αἰθαλίων	swarthy, dusky
αἰθαλόεις	smoky, sooty
αἴθε	would that
Αἰθίοψ	burnt-face
αἶθος	a burning heat, fire
αἰθος	
αἰθριοκοιτέω	to sleep in open air
αἴθριος	clear, bright, fair
αἴθω	to light up, kindle
αἰκάλλω	to flatter, wheedle, fondle
αἴκε	
αἴκεν	
αἷμα	blood
αἱμασιά	a wall
αἱμάσσω	to make bloody stain with blood
αἱματόεις	blood-red or of blood
αἱμοβόρος	blood-sucking, greedy of blood
Αἷμος	
Αἵμων	
αἰνέω	to tell or speak of
αἴνη	praise, fame
αἰνόθρυπτος	sadly enervated
αἰνολέων	a dreadful lion
αἰνόμορος	doomed to a sad end
αἶνος	a tale, story
αἰνός	dread, dire, grim
αἰνοτόκεια	unhappy in being a mother
αἴνυμαι	to take, take off, take hold of
αἴξ	a goat
αἰολικόν	
αἰολομίτρης	with glancing or glittering girdle
αἰολόπωλος	with quick-moving steeds
αἰόλος	quick-moving
αἰπεινός	high, lofty
αἰπολέω	to tend goats
αἰπόλος	a goatherd
αἴπολος	
αἰπος	
αἶπος	a height, a steep
αἰπύς	high and steep, lofty
αἱρέω	to take with the hand, grasp
αἴρω	to take up, raise, lift up
Αἶσα	the goddess of destiny
Αἰσάροιο	
αἰσθάνομαι	to perceive, apprehend by the senses, to see, hear, feel
αἴσιος	boding well, auspicious
αἶσις	
Αἰσονίδας	
αἰσυμνήτης	a regulator
Αἰσχίνης	
ἀίτας	a beloved youth, favourite
αἰτέω	to ask, beg
αἰτήμεθα	
Αἴτνη	
αἰφνίδιος	unforeseen, sudden
αἰχμητής	a spearman
αἶψα	quick, with speed, on a sudden
ἀίω	
αἰών	a period of existence
αἰωρέω	to lift up, raise
ἀκάματος	without sense of toil
ἄκανθα	a thorn, prickle
ἀκανθίς	the goldfinch
ἄκανθος	
ἀκηδέω	to take no care for, no heed of
ἀκήλητος	to be won by no charms, proof against enchantment, inexorable
ἀκήρατος	unmixed, uncontaminated, undefiled
̓́Ακιδος	
ἄκικυς	powerless, feeble
ἀκίρας	
ἀκλεής	without fame, inglorious, unsung
ἄκλητος	uncalled, unbidden
ἀκμάζω	to be in full bloom, be at one's prime or perfection
ἀκμή	a point, edge
ἀκοίμητος	sleepless
ἄκοιτις	a spouse, wife
ἀκοντιστής	a darter, javelin-man
ἄκουσις	
ἀκούω	to hear
ἄκρα	a headland, foreland, cape
ἀκράτιστος	having breakfasted
ἄκρατος	unmixed, sheer
ἀκρέμων	a branch, twig, spray
ἀκρέσπερος	at eventide
ἄκρηβος	in earliest youth
ἀκριβής	exact, accurate, precise, made or done to a nicety
ἀκριδοθήρα	
ἀκρίς	a locust
ἄκριτος	undistinguishable, unarranged, disorderly
ἀκρόκομος	with hair on the crown
ἄκρον	the highest or furthest point
ἀκρόνυχος	at night-fall, at even
ἄκρος	at the furthest point
ἀκρόχλοον	
ἄκρων	
ἀκρώνυχος	with nails at the extremities
ἀκρώρεια	a mountain-ridge
ἀκτή	a headland, foreland, promontory, shore
ἀκτήμων	without property, poor
ἄκτιον	
ἄκτιος	haunting the shore
ἀκτίς	a ray, beam
ἄκυλος	an acorn
ἀκωκή	a point
ἄκων	a javelin, dart
ἀλαᾶς	
ἀλάβαστρον	a box or casket of alabaster
ἀλάθεα	
ἀλακάτα	
ἀλάομαι	to wander, stray or roam about
ἅλας	salt
ἄλαστος	not to be forgotten, insufferable, unceasing
ἅλατο	
ἀλγέω	to feel bodily pain, suffer
̓Αλγέω	
ἄλγος	pain
ἀλδήσκω	to grow, wax
ἀλέγω	to trouble oneself, have a care
ἄλειφαρ	anointing-oil, unguent, oil
ἀλέκτωρ	a cock
̓́Αλεντα	
̔́Αλεντα	
̓Αλέξανδρος	
̓Αλεύα	
ἄλευρον	wheaten flour
ἀλήθεια	truth
ἀληθής	unconcealed, true
ἀληθινός	agreeable to truth
ἀλήνωρ	
ἀλίβατος	
ἁλιεύς	one who has to do with the sea
ἁλίζω	
ἁλικία	
ἁλικιώτας	
ἁλίκον	
ἁλίκος	
ἁλιόκαυστον	
ἅλιος	
ἅλις	in heaps, crowds, swarms, in abundance, in plenty
ἀλιτρός	sinful, sinning
ἁλίτρυτος	sea-beaten, sea-worn
ἀλκή	strength
ἄλκιμος	strong, stout
̓Αλκίππας	
̓Αλκμήνα	
̓Αλκμήναν	
̓Αλκμήνας	
̓Αλκμήνη	
̓Αλκμήνης	
ἀλκυών	the kingfisher
ἀλλά	otherwise, but
̔́Αλλεται	
ἄλλῃ	in another place, elsewhere
ἀλλήλων	of one another, to one another, one another
ἄλλοθεν	from another place
ἅλλομαι	to spring, leap, bound
ἄλλος	alius, another, one besides
ἄλλοσε	to another place, elsewhither
ἀλλότριος	of or belonging to another
ἄλλου	
ἀλλοφρονέω	to think of other things, to give no heed
ἄλλυδις	elsewhither
ἄλλωθεν	
ἄλλως	in another way or manner
ἁλμυρός	salt, briny
ἀλοάω	to thresh, thresh out
ἀλοσύνας	
ἄλοχος	a bedfellow, spouse, wife
ἅλς	a lump of salt
ἄλσις	
ἄλσος	a glade or grove
ἀλύσκω	to flee from, shun, avoid, forsake
ἀλύσσω	to be uneasy, be in distress
̓Αλφειοῖο	
̓Αλφεόν	
̓Αλφεσιβοίης	
ἄλφιτον	peeled or pearl-barley
ἀλῳάδος	
ἀλωεύς	
ἀλωή	a threshing-floor
ἀλώπηξ	a fox
ἅμα	at once, at the same time
ἀμαθύνω	to level with the sand, utterly destroy
ἀμαιμάκετος	irresistible
ἀμαλδύνω	to soften
ἀμαλλοδετήρ	a binder of sheaves
ἀμαλλοδέτης	
ἁμαξιτός	
ἆμαρ	
ἀμάρυγμα	a sparkle, twinkle
̓Αμαρυλλί	
̓Αμαρυλλίδα	
̓Αμαρυλλίδι	
ἀμαυρός	dimly seen, dim, faint, baffling sight
ἀμάω	
ἀμβροσία	
ἀμβροσίη	ambrosia
ἀμβρόσιος	immortal
ἀμείβω	to change, exchange
ἀμείλικτος	unsoftened, cruel
ἀμείνων	better, abler, stronger, braver
ἀμέλγω	to milk
ἀμενηνός	powerless, fleeting, feeble
ἀμέργω	to pluck or pull
ἁμές	
ἄμετρος	without measure, immense, excessive, boundless
ἀμητήρ	a reaper
ἀμηχανέω	to be at a loss for
ἀμήχανος	without means
ἀμιθρέω	
ἇμιν	
ἁμῖν	
ἅμισυ	
ἀμμέγα	
ἀμμετέρας	
ἄμμεων	
ἄμμιγα	
ἄμμος	sand
ἀμνάς	a lamb
ἄμναστοι	
ἀμνεῖος	of a lamb
ἀμνίς	a ewe-lamb
ἀμνός	a lamb
ἀμοιβαδίς	by turns, alternately
ἀμοιβαῖος	giving like for like, retributive
ἄμοιρος	without share in
ἀμολγεύς	a milk-pail
ἀμόλγιον	a milk-pail
ἁμός	
ἄμοτον	
ἄμοτος	raging, savage
ἄμπ	
ἀμπέλαγος	
ἀμπελεών	
ἄμπελος	a vine
ἀμπέλος	
ἀμπελών	a vineyard
ἀμπεχόνη	a fine robe
ἀμπέχονον	
ἄμπν	
ἄμπυξ	a woman's head-band, snood
̓Αμυκλαίων	
ἀμύκλας	
̓Αμύκοιο	
̓́Αμυκος	
ἄμυλος	not ground at the mill
ἀμύμων	blameless, noble, excellent
̓Αμύντας	
̓Αμύντιχος	
ἄμυξις	
ἀμύσσω	to scratch, tear, wound, lacerate, mangle
ἀμυχή	a scratch, skin-wound
ἀμυχμός	
ἀμφαγείρομαι	to gather round
ἄμφενα	
ἀμφί	on both sides
ἀμφίθυρος	with double entrance
̓Αμφικλέους	
ἀμφιλαφής	taking in on all sides, widespreading
ἀμφιπιέζω	to squeeze all round, hug closely
ἀμφιπολέω	to attend constantly, to attend on, watch, guard
ἀμφίπολος	busied about, busy
ἀμφιστέλλομαι	to fold round oneself
ἀμφιτίθημι	to put round
̓Αμφιτρίτης	
̓Αμφιτρύων	
̓Αμφιτρύωνα	
̓Αμφιτρυωνιάδαο	
̓Αμφιτρυωνιάδας	
̓Αμφιτρυωνιάδῃ	
̓Αμφιτρυωνιάδης	
̓Αμφιτρύωνος	
ἀμφότερος	each or both of two
ἀμφοτέρως	in both ways
ἄμφω	
ἄμφωτος	two-eared, two handled
ἄμωμος	without blame, blameless
ἄν	
ἀν	
ἀνά	up, upon
ἀνά-ἀάω	
ἀνά-ἀφύσσω	
ἀναβαίνω	to go up, mount, to go up to
ἀναβάλλω	to throw or toss up
ἀναβλύζω	to spout up
ἀναγιγνώσκω	to know well, know certainly
ἀναγκαῖον	a place of constraint, a prison
ἀναγκαῖος	with or by force
ἀνάγκη	force, constraint, necessity
ἀνά-ἐφύω	
ἀνάθεμα	anything devoted to evil, an accursed thing
ἀνάθρεμμα	a nursling
ἀναιδής	shameless
ἀναίνομαι	to reject with contempt, turn one's back on, spurn
ἀναιρέω	to take up, raise
ἀναίρω	to lift up
ἀνάκειμαι	to be laid up
ἀνά-κλέπτω	
ἀνακόπτω	
ἀνακράζω	to cry out, lift up the voice
̓Ανακρέοντος	
ἀνακρούω	to push back, stop short, check
ἀναλάζομαι	to take again
ἀναλάμπω	to flame up, take fire
ἀνάλατο	
ἀναμέλπω	to begin to sing
ἀναμετρέω	to re-measure the road
ἀνάμιγα	promiscuously
ἀνανέμω	to divide anew
ἀνάνευσις	
ἀνανεύω	to throw the head back
ἀνάνυτα	
ἄναξ	a lord, master
ἀνάξιος	unworthy, not deemed or held worthy of
ἄναξις	
̓Αναξώ	
ἀνά-ὁράω	
ἀναπαύω	to make to cease, to stop or hinder from
ἀνά-πεδάω	
ἀναπλέκω	to enwreath
ἀναπληρόω	to fill up
ἀναπνέω	to breathe again, take breath
̓Ανάπω	
̓Ανάπῳ	
ἀνάριθμος	without number, countless, numberless
ἀνάριστος	
ἀναρπάζω	to snatch up
ἀναρρήγνυμι	to break up
ἀνάρσιος	not fitting, incongruous
ἀνάσσω	to be lord, master, owner, to rule, in
ἀνά-σχέθω%	
ἀνασχίζω	to rip up
ἀνατέλλω	to make to rise up or to grow up
ἀνατίθημι	to lay upon
ἀνατλῆναι	to bear up against, endure
ἀνατολή	a rising, rise
ἀνατρέπω	to turn up or over, overturn, upset
ἀνατρέχω	to run back
ἀναύω	to cry aloud
ἀναφαίνω	to make to give light, make to blaze up
ἀναφέρω	to bring or carry up
ἀνά-φύω	
ἀναχάζω	to make to recoil, force back
ἀναχέω	to pour forth
ἀναψύχω	to cool, to revive by fresh air, to refresh
ἁνδάνω	to please, delight, gratify
ἄνδηρον	a raised border, flower-bed
ἄνδιχα	asunder, in twain
ἀνδρεῖα	
ἀνδρεία	manliness, manhood, manly spirit
ἀνδρεῖος	of or for a man
ἀνδριάς	the image of a man, a statue
ἀνδρίον	a manikin
ἀνδρίς	
ἀνδριστί	like a man, like men
ἀνδρόω	to rear up into manhood
ἄνειμι	to go up
ἀνέλκω	to draw up
ἀνέλπιστος	unhoped for, unlooked for
ἄνεμος	wind
ἀνεμόω	to expose to the wind:—
ἀνεμώλιος	windy
ἀνεμώνη	the wind-flower, anemone
ἀνέξοδος	with no outlet, allowing no return
ἀνέρομαι	to enquire of, question
ἄνερος	
ἀνερύω	to draw up, haul up
ἀνερωτάω	to ask or inquire of, question
ἄνευ	without
ἀνέχω	to hold up
ἀνεψιός	a first-cousin, cousin
ἄνηβος	not yet come to man's estate, beardless
ἄνηθον	anise, dill
ἀνήρ	a man
̓Ανήρ	
ἀνήσσατοι	
ἀνήτινον	
ἄνθεμα	
ἄνθεμον	costliest
ἀνθέρικος	
ἀνθέω	to blossom, bloom
ἄνθος	a blossom, flower
ἄνθρωπος	man
ἀνία	grief, sorrow, distress, trouble
ἀνιάζω	to grieve, distress
ἀνιάομαι	to cure again, repair
ἀνιαρός	grievous, troublesome, annoying
ἀνιάω	to grieve, distress
ἀνίημι	to send up or forth
ἀνίκητος	unconquered, unconquerable
ἀνίστημι	to make to stand up, raise up
ἀνοίγνυμι	to open
ἄνοος	without understanding, foolish, silly
ἀνορθόω	to set up again, restore, rebuild
ἀνούατος	without ear: without handle
̓́Ανσταθ'	
ἀνταμείβομαι	to exchange
ἀντάξιος	worth just as much as
ἀντηχέω	to sound or sing in answer
ἀντί	over against, opposite. c. gen.
ἀντιάω	to go for the purpose of meeting
̓Αντιγόνας	
ἀντίον	
ἀντίος	set against
̓Αντιόχοιο	
ἀντιφιλέω	to love in return
ἀντλέω	to bale out bilge-water, bale the ship
ἄντομαι	to meet
ἄντρον	
ἄντυξ	the edge or rim of anything round or curved
ἄνυμες	
ἀνυπόδητος	unshod, barefoot
ἀνυσίεργος	
ἄνυσις	accomplishment
ἄνυτο	
ἀνύω	to effect, achieve, accomplish, complete
ἄνω	
ἄνωγα	to command, order
ἄνωθεν	from above, from on high
ἄξενος	inhospitable
ἄξιος	weighing as much, of like value, worth as much as
ἀοιδᾶσζατεισ'	
ἀοιδή	song, a singing
ἀοίδιμος	sung of, famous in song
ἀοιδός	a singer, minstrel, bard
ἀολλής	all together, in throngs, shoals or crowds
̓Αονίου	
ἄορ	a hanger, sword
ἀοσσέω	to help
ἀπάγχω	to strangle, throttle
ἀπάλαλκε	to ward off
ἁπαλός	soft to the touch, tender
ἀπαμείβομαι	to reply, answer
ἀπάνευθε	afar off, far away
ἀπάρθενος	no more a maid
ἀπάρχω	
ἅπας	quite all, the whole
ἀπατάω	to cheat, trick, outwit, beguile
ἀπάτη	a trick, fraud, deceit
ἀπαυδάω	to forbid
ἀπειλέω	
ἄπειμι	
ἀπεῖπον	to speak out, tell out, declare
ἀπειρέσιος	boundless, immense, countless
ἀπείριτος	
ἄπειρος	
ἀπέρχομαι	to go away, depart from
ἀπεχθάνομαι	to be hated, incur hatred, be roused to hatred
ἀπεχθής	hateful, hostile
ἀπέχθομαι	to be hated, incur hatred
ἀπηνής	ungentle, harsh, rough, hard
̓Απίδα	
ἄπιον	a pear
ἄπιος	
̂̓Απις	
ἄπληστος	not to be filled, insatiate
ἄπνευστος	breathless
ἀπό	from, away from. c. gen.
ἀπό-ἁλίσκομαι	
ἀποβαίνω	to step off from
ἀποβάλλω	to throw off
ἀπόβλητος	to be thrown away
ἀποβρίζω	to go off to sleep, go sound asleep
ἀποδατέομαι	to portion out to
ἀποδέρω	to flay or skin completely
ἀποδημέω	to be away from home, be abroad or on one's travels
ἀποδύνω	
ἀπό-δύω	
ἀποθέω	to run away
ἀποθύμιος	not according to the mind, unpleasant, hateful
ἀποικέω	to go away from home, to settle in a foreign country, emigrate
ἀποίχομαι	to be gone away, to be far from
ἀποκλάζω	
ἀποκλείω	to shut off from or out of, debar
ἀποκλίνω	to turn off or aside
ἀπόκομμα	a splinter, chip, shred
ἀπολείπω	to leave over or behind
ἀπολήγω	to leave off, desist from
ἀπόλλυμι	to destroy utterly, kill, slay
̓Απόλλων	
̓Απόλλωνος	
ἀπολύω	to loose from
ἀπομάσσω	to wipe clean
ἀποπαύω	to stop or hinder from, make to cease from
ἀποπέμπω	to send off or away, to dismiss
ἀπόπεμψις	a sending off, dispatching
ἀποπλάζω	to lead astray from
ἀπόπροθε	from afar, afar off, far away
ἀπόπροθεν	
ἀπόπροθι	far away
ἀποπτύω	to spit out
ἀπορρέω	to flow or run off, stream forth
ἀποσβέννυμι	to put out, extinguish, quench
ἀποσεύω	to chase away
ἀποσκυλεύω	to carry off as spoil from τί τινος
ἀποσπένδω	to pour out wine
ἀποστάζω	to let fall drop by drop, distil
ἀποστενόω	to straiten, block up
ἀποστέργω	to love no more
ἀποσύρω	to tear away
ἀποτέμνω	to cut off, sever
ἀποτίθημι	to put away, stow away
ἀπότιλμα	a piece plucked off
ἄποτμος	unhappy, ill-starred
ἀποτρίβω	to wear out
ἀποτρώγω	to bite or nibble off
ἄπους	without foot or feet
ἀπό-ὕω	
ἀποφέρω	to carry off or away
ἀποφθίνω	to perish utterly, die away
ἄπρακτος	doing nothing, ineffectual, unprofitable
ἀπρεπής	unseemly, unbecoming, indecent, indecorous
ἀπρίξ	with closed teeth
ἅπτω	to fasten, bind fast
ἀπύ	
ἀπφῦν	
ἀπφῦς	
ἄπωθεν	from afar
ἀπωθέω	to thrust away, push back
ἀπώτερος	
ἀπωτέρω	further off
ἄρα	
ἆρα	particle introducing a question
ἀραβέω	to rattle, ring, clash
ἀραιός	thin, narrow, slight, slender
ἀράομαι	to pray to
ἀραρίσκω	to join, join together, fasten
ἀράσσω	to strike hard, smite
̓́Αρατε	
̓́Αρατος	
ἀράχνη	a spider's web
ἀράχνης	a spider
ἀράχνιον	a spider's web
ἀρβύλη	a strong shoe or half-boot
ἀρβυλίς	
ἀργαλέος	painful, troublous, grievous
̓́Αργει	
̓Αργεία	
̓Αργείαισι	
̓Αργείας	
̓Αργείου	
̓Αργείῳ	
̓Αργείων	
̓́Αργεος	
ἀργής	bright, glancing
ἀργηστής	
̓Αργόθεν	
̓́Αργος	
ἀργυραμοιβός	a money-changer, banker
ἀργύρεος	silver, of silver
ἀργύριον	a piece of silver, a silver coin
ἄργυρος	white metal
̓Αργώ	
ἄρδις	the point of
ἄρδω	to water
̓Αρέθοισα	
̓Αρέθοισαν	
ἄρειος	devoted to Ares, warlike, martial
ἀρείων	better, stouter, stronger, braver, more excellent
ἀρέμ	
ἄρεσκος	pleasing
ἀρέσκω	to make good, make up
ἀρετή	goodness, excellence
ἀρήγω	to help, aid, succour
Ἄρης	Ares
̓Αριάδνας	
ἀρίζηλος	conspicuous, very distinct
ἀριθμέω	to number, count or reckon up
ἀριθμητός	easily numbered, few in number
ἀριθμός	number
ἀρίσημος	very notable
ἀριστερός	left, on the left
ἀριστεύς	the best man
ἀριστεύω	to be best or bravest
̓́Αριστις	
ἄριστον	the morning meal, breakfast
ἄριστος	best
ἀριστοτόκος	
ἀριφραδής	easy to be known, very distinct, manifest
̓Αρκαδίη	
̓Αρκαδικοί	
̓Αρκάσι	
ἄρκευθος	
ἀρκέω	to ward off, keep off
ἄρκιος	sufficient, sure, certain
ἄρκος	
ἄρκτος	a bear
ἅρμα	a chariot
ἁρμαλιά	
ἁρματοπηγός	a wheelwright, chariot-maker
ἄρμενα	the tackling or rigging
ἀρμοῖ	
ἁρμονία	a fastening
ἀρνακίς	a sheep's skin
ἀρνός	a lamb
ἄρνων	
ἄρον	
ἄρος	
ἀροτρεύς	a ploughman
ἄροτρον	a plough
ἄρουρα	tilled or arable land, seed-land, cornland
ἀρόω	to plough
ἁρπάζω	to snatch away, carry off
̔Αρπαλύκῳ	
̓Αρραβίας	
ἄρρηκτος	unbroken, not to be broken
ἀρρηνής	fierce, savage
ἄρσην	male
̓Αρσινόα	
ἀρτάω	to fasten to or hang
̓́Αρτεμι	
̓Αρτέμιδος	
̓́Αρτεμιν	
̓́Αρτεμις	
ἀρτέομαι	to be prepared, get ready, make ready
ἄρτι	just, exactly
ἀρτιγλυφής	newly carved
ἀρτίζω	to get ready, prepare
ἀρτιπαγής	just put together or made
ἄρτος	a cake or loaf of wheat-bread
ἀρχαῖος	from the beginning
̓́Αρχετε	
ἀρχή	a beginning, origin, first cause
ἀρχηγός	beginning, originating
̓Αρχίας	
̓Αρχίλοχον	
ἀρχός	a leader, chief, commander
ἄρχω	to be first
ἀρωγός	aiding, succouring, propitious, serviceable
ἀσάομαι	to feel loathing or nausea, to be disgusted or vexed at
ἄσκαλος	unhoed
ἀσκητής	one who practises any art or trade
ἀσκητός	curiously wrought
ἀσπάλαθος	aspalathus
ἀσπάσιος	welcome, gladly welcomed
ἀσπιδιώτης	shield-bearing, a warrior
ἀσπίς	a round shield
ἆσσον	nearer, very near
̓Ασσυρίω	
ἀστεμφής	unmoved, unshaken
ἀστή	
ἀστήρ	a star
ἀστικός	of a city or town
ἄστιος	
̓Αστοῖς	
ἄστοργος	without natural affection
ἀστός	a townsman, citizen
ἀστράγαλος	one of the neck-vertebrae
ἄστρεπτος	unbending, inflexible
ἄστρον	the stars
ἄστυ	a city, town
ἄστων	
ἁσυχᾷ	
ἀσφαλής	not liable to fall, immoveable, steadfast, firm
̓Ασφαλίων	
ἄσφαλτον	
ἄσφαλτος	asphalt, bitumen
ἀσφόδελος	asphodel, king's-spear
ἀσχαλάω	to be distressed, grieved
̓Αταλάντα	
ἀτάρ	but, yet
ἀταρτηρός	mischievous, baneful
ἀτασθαλία	presumptuous sin, recklessness, arrogance
ἀτάσθαλος	presumptuous, reckless, arrogant
ἅτε	just as, so as
ἀτειρής	not to be worn away, indestructible
ἄτερ	without
ἀτέραμνος	unsoftened
ἀτερπής	unpleasing, joyless, melancholy
ἀτιμαγελέω	to forsake the herd
ἀτιμαγέλης	despising the herd
ἀτιμάω	to dishonour, treat lightly
ἄτιμος	unhonoured, dishonoured
ἀτιτάλλω	to rear up
ἄτλητος	not to be borne, insufferable
ἆτος	
ἀτρακτυλλίς	
ἀτραπός	a path with no turnings
̓Ατρείδαισι	
ἀτρεκής	real, genuine
ἀτρέμας	without trembling, without motion
̓Ατρέος	
ἄτριον	
ἄτριπτος	not worn by work
ἄτροπος	unchangeable, eternal
ἄτρυτος	not worn away, untiring, unwearied
̓Αττικόν	
ἀτύζω	to be distraught from fear, mazed, bewildered
αὖ	
Αὐγείας	
αὔγειον	
αὐγή	the light of the sun, sunlight
Αὐγηϊάδης	
αὐδάζομαι	to cry out, speak
αὐδάω	to utter sounds, speak
αὐδή	the human voice, speech
αὐερύω	to draw back or backwards
αὖθι	on the spot, here, there
αὖθις	back, back again
αὖλαξ	a furrow
αὐλεία	
αὔλειος	of or belonging to the αὐλή or court
αὐλέω	to play on the flute
αὐλή	the court-yard
αὐλητρίς	a flute-girl
αὐλίζομαι	to lie in the court-yard
αὔλιος	of or for farm-yards, rustic
αὖλις	a place for passing the night in, a tent, roosting-place
αὐλός	a flute
αὐξάνω	to make large, increase, augment
αὖος	dry
αὔρα	air in motion, a breeze
αὔριον	to-morrow
αὐσταλέος	sunburnt, squalid
αὕτα	
αὖτε	again
ἀυτέω	to cry, shout
ἀυτή	a cry, shout
αὐτίκα	forthwith, straightway, at once
αὐτόγα	
αὐτοένει	
αὐτόθεν	from the very spot
αὐτόθι	on the spot
αὐτόματος	acting of one's own will, of oneself
Αὐτονόη	
αὐτός	self
αὔτος	
αὐτοῦ	at the very place, just here, just there
αὐτόφλοιος	with the bark on
αὐτοφυής	self-grown
αὔτως	in this very manner, even so, just so, as it is
αὐχήν	the neck, throat
αὐχμηρός	dry, dusty, rough, squalid
αὐχμός	drought
αὔω	
ἄφαντος	made invisible, blotted out, forgotten
ἀφάπτω	to fasten from or upon
ἄφαρ	straightway, forthwith, at once, quickly, presently
̓Αφαρηίου	
̓Αφαρῆος	
ἀφαυρός	feeble, powerless
ἀφέρπω	to creep off, steal away, retire
ἀφήκω	to arrive at
ἅφθα	
ἄφθιτος	not liable to perish, imperishable
ἄφθονος	without envy
ἀφίημι	to send forth, discharge
ἀφίκευσο	
ἀφικνέομαι	to come to
ἀφνειός	rich, wealthy
ἀφνίδιος	unforeseen, sudden
̓Αφροδίτα	
̓Αφροδίτᾳ	
̓Αφροδίτας	
ἀφύσσω	to draw
̓Αχαιιάδων	
̓Αχαιοί	
̓Αχαιός	
̓Αχαιῶν	
̓Αχαρνεύς	
ἄχερδος	a wild prickly shrub, a wild pear
̓Αχέροντα	
̓Αχέροντι	
̓Αχέροντος	
ἀχεύω	grieving, sorrowing, mourning
ἀχέω	
ἀχήν	poor, needy
ἄχθομαι	to be loaded
̓Αχιλεύς	
̓Αχιλῆα	
̓Αχιλλέϊοι	
ἄχος	pain, distress
ἄχραντος	undefiled, immaculate
ἀχρεῖος	useless, unprofitable, good for nothing
ἄχρι	to the uttermost, utterly
ἄχυρον	husks, chaff, bran
ἄχυρος	
ἀχυρός	a chaff-heap
ἄψ	backwards, back, back again
ἄψορρος	going back, backwards
̓Αῶ	
ἄω	
ἀῶθεν	
ἀωρί	at an untimely hour, too early
ἄωρος	
̓Αώς	
ἀώσβουκολιασδωμεσθα	
ἄωτον	fine wool, flock
ἄωτος	
βαδίζω	to go slowly, to walk
βάζω	to speak, say
βαθέως	
βάθος	depth or height
βαθύκολπος	with dress falling in deep folds
βαθύς	deep or high
βαθύσκιος	deep-shaded
βαία	
βαίνω	to walk, step
βαίτη	a shepherd's or peasant's coat of skins
βαίτης	
βάκτρον	
Βάκχη	a Bacchante
Βάκχος	Bacchus
βάλανος	an acorn
βάλλις	
βάλλω	to throw
βάπτω	to dip in water
βάρβιτος	a musical instrument of many strings
βάρδιστος	
βαρέω	to weigh down, depress
βαρύγουνος	heavy-kneed, lazy
βαρυμάνιος	
βαρύνω	to weigh down, oppress by weight, depress
βαρύς	heavy
βαρύφρων	weighty of purpose, grave-minded
βασιλεία	a kingdom, dominion
βασίλεια	a queen, princess
βασίλειον	a kingly dwelling, palace
βασίλειος	of the king, kingly, royal
βασιλεύς	a king, chief
βασιλεύω	to be king, to rule, reign
βασιλίζω	to be of the king's party
βασίλισσα	
βασκαίνω	to slander, malign, belie, disparage
βαστάζω	to lift, lift up, raise
βατέω	to tread, cover
βάτης	
βάτον	
βάτος	
βάτραχος	a frog
Βάττος	stammerer
βαύζω	to cry βαά βαά, to bark
βδέλλα	a leech
βέβαλοι	
βέβηλος	allowable to be trodden, permitted to human use
Βέβρυκες	
βέλεμνον	a dart, javelin
Βελλεροφῶν	
βέλος	a missile
βέλτιστος	best
Βεμβιναίους	
Βερενικεία	
Βερενίκη	
βία	bodily strength, force, power, might
βιάζω	to constrain
Βίας	
βιάω	to constrain
βίβλινος	, Biblian wine
βιβρώσκω	to eat, eat up
βίος	life
βιόω	to live, pass one's life
βλάπτω	to disable, hinder, stop
Βλεμύων	
βλέπος	a look
βλέπω	to see, have the power of sight
βλέφαρον	mostly in pl. the eyelids
βληχάομαι	to bleat
βλήχων	pennyroyal
βλοσυρός	grim, fierce
βλώσκω	to go or come
βόα	
βόαυλος	an ox-stall
βοάω	to cry aloud, to shout
βοείη	an ox-hide, ox-hide shield
βόειος	of an ox or oxen
βοεύς	a rope of ox-hide
βοή	a loud cry, shout
βοηθόος	hasting to the battle-shout, hasting to battle
βοηνόμος	
βολβός	a bulb
βόλος	a throw with a casting-net, a cast
βομβέω	to make a booming, humming noise, to sound deep or hollow
Βομβύκα	
βορέαο	
Βορέας	the North wind
βόσις	food
βοσκησεῖσθε	
βόσκω	to feed, tend
βόσκὡν	
βοτάνη	grass, fodder
βοτήρ	a herdsman, herd
βοτόν	a beast
βοτρυόπαις	grape-born, child of the grape
βουκαῖος	cowherd
βουκολέω	to tend cattle
βουκολιάζομαι	to sing or write pastorals
βουκολιαστής	a pastoral poet
βουκολικός	pastoral
βουκόλιον	a herd of cattle
βουκολίσκος	
βουκόλος	a cowherd, herdsman
βούκολος	
βουκόλοσἑρπε	
βοῦκος	
βουλεύω	to take counsel, deliberate, concert measures
βουλή	will, determination
βούλομαι	to will, wish, be willing
Βουπράσιος	
Βούριναν	
βοῦς	cow
βούτης	a herdsman
βούτομον	butomus, the flowering rush
βούτομος	
βραβίλοιο	
βραβίλοισι	
βραγχί'	
βραϊδίως	
βράκος	a rich woman's-garment
Βρασίλα	
βραχίων	the arm
βραχύς	short
βρέφος	the babe in the womb
βρίθω	to be heavy or weighed down with
βροτόομαι	to be stained with gore
βροτός	a mortal man
βρόχθος	the throat
βρόχος	a noose or slip-knot, for hanging or strangling
βρύον	a kind of mossy sea-weed
βρυχάομαι	to roar, bellow
Βυβλίδος	
βυθός	the depth
βύρσα	the skin stripped off, a hide
βύσσος	a fine flax
βῶλα	
βῶλαξ	
βῶλος	a lump of earth, a clod
βωμός	any raised platform, a stand
βῶς	
βωστρέω	to call on
Βάττος	
Βουκολιασταί	
γαῖα	a land, country
Γαῖα	
γάλα	milk
γαλαθηνός	sucking, young, tender
Γαλάτεια	
γαλέη	a weasel, marten-cat or polecat
γαλήνη	stillness of the sea, calm
γαμβρά	
γαμβρός	any one connected by marriage
γαμέω	to marry
γάμος	a wedding, wedding-feast
Γανυμήδης	
γάρ	for
γαστήρ	the paunch, belly
γαυλός	a milk-pail
γαυριάω	to bear oneself proudly, prance
γαῦρος	exulting in
γε	at least, at any rate
γείνομαι	to be born
γείτων	one of the same land, a neighbour
γελάοισα	
γελάω	to laugh
γέλως	laughter
γέμω	to be full
γενεά	race, stock, family
γενειάζω	
γενειάς	a beard
γενειάτης	bearded
γενειάω	to grow a beard, get a beard
γένειον	the part covered by the beard, the chin
γενέτης	the begetter, father, ancestor
γένος	race, stock, family
γένυς	the under jaw
γεραιός	old
γεραίρω	to honour or reward with
γέρανος	a crane
γέρας	a gift of honour
γερόντιον	a little old man
γέρρον	anything made of wicker-work
γέρων	an old man
γεύμεθα	
γεύω	to give a taste of
γεώλοφος	crested with earth
γῆ	earth
γηθέω	to rejoice
γηραιός	aged, in old age
γηραλέος	
γῆρας	old age
γηράσκω	to grow old, become old
γηρύω	to sing or say, speak, cry
γίγνομαι	to come into being
γιγνώσκω	to learn to know, to perceive, mark, learn
Γλαύκη	
γλαυκός	gleaming, silvery
γλαύξ	the owl
γλαφυρός	hollow, hollowed
γλυκερός	
γλύκιος	
γλυκύκαρπος	bearing sweet fruit
γλυκύμαλον	sweet-apple
γλυκύς	sweet
γλύφανος	a tool for carving, knife, chisel
γλύφω	to carve, cut out with a knife
γλῶσσα	the tongue
γναθμός	the jaw
γνώμη	a means of knowing, a mark, token
γνῶσις	a judicial inquiry
γοάω	to wail, groan, weep
Γολγώς	
γονεύς	a begetter, father
γονή	produce, offspring
γόνος	that which is begotten, offspring, a child
γόνυ	the knee
γοργόομαι	to be hot or spirited
Γοργώ	the Gorgon
γοῦν	at least then, at any rate, any way
γραῖα	an old woman
γραίη	
γραῖος	raisins
γράμμα	that which is drawn
γραμμή	the stroke
γραπτός	marked as with letters
γράφω	to scratch, scrape, graze
γριπεύς	
γρίπων	a fisherman
γύης	
γυῖον	a limb
γυιόω	to lame
γυμνάζω	to train naked, train in gymnastic exercise
γυμνάσιον	bodily exercises
γυμναστής	a trainer of professional athletes
γυμνός	naked, unclad
γυμνόω	to strip naked
γύναικες	
γυναικοφίλης	woman-loving
γύναιξιν	
γυνή	a woman
γύννις	a womanish man
δᾶ	by earth
δαγύς	a wax doll, puppet
δαί	what? how
δαιδάλεος	cunningly or curiously wrought
δαίδαλμα	a work of art
δαιμόνιον	the Deity
δαιμόνιος	of or belonging to a δαίμων
δαίμων	a god, goddess
δαίνυμι	to divide
δάιος	hostile, destructive, dreadful
δαίς	
δαίτηθεν	from a feast
δαίτης	
δαίφρων	battle
δαίω	
δάκνω	to bite
δακρυόεις	tearful, much-weeping
δάκρυον	a tear
δακρύω	to weep, shed tears
δάκτυλος	a finger
Δᾶλον	
δαμάζω	to overpower
δαμάλη	
δαμάλης	a young steer
δάμαλις	a heifer
Δάματερ	
Δαμάτερι	
Δάματρος	
Δαμοίτας	
δαμότισιν	
δασπλῆτις	horrid, frightful
δασύθριξ	thick-haired, hairy
δάσυθριξ	
δασυκέρκος	
δάφνη	the laurel
Δάφνις	
δαφοινός	blood-red, tawny
δαψιλής	abundant, plentiful
δάω	to learn
δέ	but
δε	
δέδμανθ'	
δεδοίκαμες	
δεῖ	it is binding on
δειδίσσομαι	to frighten, alarm
δείδω	to fear
δειελινός	at evening
δείελος	of or belonging to evening
δεικανάω	to point out, shew
δείκνυμι	to bring to light, display, exhibit
δειλαῖαι	
δειλαῖε	
δείλαιος	wretched, sorry, paltry
δείλη	afternoon
δειλινός	
δειλός	cowardly, craven
δεῖμα	fear, affright
δειμαίνω	to be afraid, in a fright
δεινός	fearful, terrible, dread, dire
δεινόω	to make terrible: to exaggerate
δειπνέω	to make a meal
δεῖπνον	the principal meal
δεῖπνος	
δειρή	the neck, throat
δέκα	ten
δεκάμηνος	ten months old
δέκατος	tenth
δεκατόω	to take tithe of
δέλητα	
Δέλφιδι	
Δέλφιδος	
Δελφικός	Delphic
Δέλφιν	
Δέλφις	
Δελφίς	
δέμνιον	the bedstead or matrass
δέμω	to build
δενδρήεις	woody
δενδρίον	
δένδρον	a tree
δεξιά	the right hand
δεξιός	on the right hand or side
δεξιτερός	right, the right
δέον	that which is binding, needful, right, proper
δέος	fear, alarm, affright
δέπας	a beaker, goblet, chalice
δέρκομαι	to see clearly, see
δέρμα	the skin, hide
δεσμεύω	to fetter, put in chains
δεσμός	anything for binding, a band, bond
δέσποινα	the mistress, lady of the house
δεσπότης	a master, lord, the master of the house
Δευκαλίων	
δεῦρο	hither
δεύτατος	the last
δεῦτε	hither! come on! come here!
δεύτερος	second
δέχομαι	to take, accept, receive
δέω	
δή	exactness
δηθά	for a long time
δηιόω	to cut down, slay
δηλέομαι	to hurt, do a mischief to
Δήλιος	Delian
δῆλος	visible, conspicuous
Δημήτηρ	Demeter
Δημομέλης	
δῆμος	a country-district, country, land
δημότης	one of the people, a commoner, plebeian
δηναιός	long-lived
δήξυνα	
Δηοῖ	
δἠποθάνω	
δηριάομαι	to contend, wrangle
διά	through c. gen. through, by means of c. acc.
διάγω	to carry over or across
διαδέρκομαι	to see through
διαδηλέομαι	to do great harm to, tear to pieces
διαδύνω	to slip through
διαειδής	
διαείδω	
διαθρύπτω	to break in sunder, break in pieces, shiver
διαίνω	to wet, moisten
διαιτάω	to feed in a certain way, to diet
διακόσιοι	two hundred
διακρίνω	to separate one from another
διάκριτος	separated: choice, excellent
διαλακτίζω	to kick away, spurn
διαλέγω	to pick out one from another, to pick out
διάλλαξις	
διαλλάξις	
διαλλάσσω	to change one with another, interchange
διαλύω	to loose one from another, to part asunder, undo
διαμπερής	
διαπέρθω	to destroy utterly, sack, lay waste
διαπιαίνω	to make very fat
διαπόντιος	beyond sea
διαπρό	right through
διασχίζω	to cleave or rend asunder
διατείνω	to stretch to the uttermost
διατρέχω	to run across or over
διαφαίνω	to shew through, let
διαχέω	to pour different ways, to disperse
διαχρησεῖται	
δίγληνος	with two eye-balls
δίδακτρα	
διδάσκαλος	a teacher, master
διδάσκω	to teach
δίδημι	to bind, fetter
διδυματόκος	bearing twins
δίδυμος	double, twofold, twain
δίδωμι	to give
δίειμι	to go to and fro, roam about
διεκρανάσατε	
διεξάιξεβαθυν	
διερός	fresh, active, nimble
διέρχομαι	to go through, pass through
διέτμαξεν	
δίζημαι	to seek out, look for
δίζω	to be in doubt, at a loss
Δίη	
διίστημι	to set apart, to place separately, separate
δικάζω	to judge, to give judgment on
δίκη	custom, usage
δικλίς	double-folding
δίκτυον	a casting-net, a net
δίκτυς	
Δίκων	
δίνασε	
δινεύω	to whirl or twirl round
δίνη	a whirlpool, eddy
διό	wherefore, on which account
Διοκλέης	
Διοκλείδης	
Διομήδης	Jove-counselled;
Διονύσος	
Διόνυσος	Dionysus
δῖος	god-like, divine
Διόσκοροι	the sons of Zeus
Διόσκουροι	
Διόφαντος	
δίπλαξ	twofold, double, in double folds
διπλάσιος	twofold, double, twice as much as, twice as many as, as long as
διπλασίων	
δίς	twice, doubly
δίφραξ	a seat, chair
δίφρος	the chariot-board
δίχα	in two, asunder
δῖψος	
δίω	to run away, take to flight, flee
διώκω	to pursue
Διωναῖος	
Διώνη	
δμῶος	
δμώς	a slave taken in war
δοιάς	
δοιή	doubt, perplexity
δοιοί	two, both
δοιώ	
δοκεύς	
δοκεύω	to keep an eye upon, watch narrowly
δοκέω	videor mihi, to think, suppose, imagine, expect
δοκή	a vision, fancy
δοκίμοι	
δόκιμος	assayed, examined, tested
δοκόν	
δοκός	a bearing-beam
δοκώ	
δολομάχανον	
δόλος	a bait
δόμος	a house
δόναξ	a reed
δονέω	to shake
δόρπον	the evening meal
δόρπος	
δόρυ	a stem, tree
δορυσσόος	charging with the lance
δούλη	
δοῦλος	a born bondman or slave
δοῦπος	any dead, heavy sound, a thud
δοχμός	slantwise
δράγμα	as much as one can grasp, a handful, truss
Δρακάνῳ	
δράκων	a dragon
δράσσομαι	to grasp
δρέπω	to pluck, cull
δριμύς	piercing, sharp, keen
δρόμος	a course, running, race
δροσόεις	
δρόσος	dew
δρύινος	oaken
δρυμός	an oak-coppice;
δρῦς	a tree
δρυτόμος	a wood-cutter
δύη	woe, misery, anguish, pain
δύναμαι	to be able, capable, strong enough
δυνάμαν	
δυνατός	strong, mighty, able
δύο	two
δυοκαίδεκα	twelve
δυσάμμορος	most miserable
δύσερως	sick in love with
δύσις	a setting of the sun or stars
δυσμενέων	bearing ill-will, hostile
δυσμενής	full of ill-will, hostile
δύσμορος	ill-fated, ill-starred
δυσπαθέω	to suffer a hard fate
δυσσεβέω	to think or act ungodly
δυσσεβής	ungodly, impious, profane
δύσσοος	
δύσσους	hard to save, ruined
δύστηνος	wretched, unhappy, unfortunate, disastrous
δυστοκέω	to be in sore travail
δύω	to strip off
δυώδεκα	twelve
δώδεκα	twelve
δωδεκαταῖος	on the twelfth day
δωδέκατος	the twelfth
δῶλος	
δῶμα	a house
δωρέω	to give, present
Δωριέεεσσι	
Δωριέεσσι	
Δωρικός	Doric
Δώριος	Dorian
Δωρίς	Dorian
δωρίσδεν	
Δωριστί	in Dorian fashion
δῶρον	a gift, present
δωρύττομαι	
δωτίνη	a gift, present
Δαμοίτας	
Δάφνις	
ἕ	sui.
ἔα	ha! oho!
ἐάν	if haply
ἔαρ	spring
ἐαρινός	spring-
ἐάω	to let, suffer, allow, permit
ἕβδομος	seventh
ἔβενος	the ebony-tree, ebony
̔́Εβρον	
ἐγγυάω	to give or hand over as a pledge
ἐγγύθεν	from nigh at hand
ἐγγύθι	hard by, near
ἐγγύς	near, nigh, at hand
ἐγείρω	to awaken, wake up, rouse
ἐγέρσιμος	from which one wakes
ἐγκαναχάομαι	to make a sound
ἔγκατα	the inwards, entrails, bowels
ἐγκατατίθεμαι	put
ἔγκειμαι	to lie in, be wrapped in
ἐγκέφαλος	that which is within the head, the brain
ἐγκρατής	in possession of power
ἐγκροτέω	to strike on
ἐγκύρω	to fall in with, light upon, meet with
ἐγκώμιος	in or of the same village, native
ἔγρω	
ἐγχέω	to pour in
ἔγχος	a spear, lance
ἔγχριστος	rubbed in as an ointment
ἐγώ	ego
ἔγωγα	
ἐγώγε	
ἕδνον	a wedding-gift
ἑδνόω	to promise for wedding-presents, to betroth
ἐδοκεῦμες	
ἕδος	a sitting-place
ἕδρα	a sitting-place
ἑδριάω	to seat or set
ἑδροστρόφος	a wrestler who throws his adversary by a cross-buttock
ἔδω	to eat
ἐδωδή	food, meat, victuals
ἕζομαι	to seat oneself, sit
ἔθειρα	hair
ἐθειράζω	to have long hair
ἐθέλω	to will, wish, purpose
ἔθνος	a number of people accustomed to live together, a company, body of men
εἰ	whether.
εἶα	on! up! away!
εἱαμενή	a river-side pasture, meadow
εἰαμενή	
εἶδαρ	food
εἰδοί	Idus
εἴδομαι	are visible, appear
εἴδομες	
εἶδον	to see, perceive, behold
εἶδος	that which is seen, form, shape, figure
εἰδύλλιον	a short descriptive poem
εἰη	
εἶθαρ	at once, forthwith
εἴθε	would that!
εἰκάζω	to make like to, represent by a likeness, portray
εἰκῇ	without plan or purpose, heedlessly, rashly, at random, at a venture
εἰκός	like truth
εἰκοσάμηνος	twenty months old
εἴκοσι	twenty
εἴκω	to yield, give way, draw back, retire
εἰκών	a likeness, image, portrait
Εἰλείθυια	Ilithyia
εἰλεός	a lurking-place, den, hole
εἰλίπους	rolling in their gait, with rolling walk
εἰλιτενής	
εἴλω	to roll up, pack
εἷμα	a garment
εἰμές	
εἰμί	to be, to exist
εἶμι	to go
εἰνάλιος	
εἰνόδιος	
εἶπον	to speak, say
εἶπος	
εἰροπόκος	wool-fleeced, woolly
εἵρπομες	
εἷς	
εἰς	into, to c. acc.
εἰσάγω	to lead in or into, to introduce
εἰσαθρέω	to discern, descry
εἰσαίω	to listen or hearken to
εἰσακούω	to hearken or give ear to one
εἰσαφικάνω	to come to
εἰσβλέπω	to look at, look upon
εἰσ-εἶδον	
εἴσειμι	to go into
εἰσέρχομαι	to go in or into, enter
εἰσέτι	still yet
εἰσίημι	to send into
εἰσκαλέω	to call in
ἐίσκω	to make like
εἰσ-μάσσω	
εἰσοράω	to look into, look upon, view, behold
εἴσπνηλος	
εἰστρέχω	to run in
εἴσω	to within, into
εἶτα	then, next
εἴτε	
εἴτι	
ἐκ	from out of
̓́Εκ	
̓Εκ	
̔Εκάβας	
ἑκάς	far, afar, far off
ἕκαστος	every, every one, each, each one
̔Εκάτα	
ἑκατόν	a hundred
ἑκατοντάς	a hundred
ἐκβαίνω	to step out of or off from
ἐκβάλλω	to throw or cast out of
ἐκγελάω	to laugh out, laugh loud
ἐκδιδάσκω	to teach thoroughly
ἐκ-ἕζομαι	
ἐκεῖθι	
ἐκεῖνος	the person there, that person or thing
ἐκ-ἕννυμι	
ἕκηλος	at rest, at one's ease
ἐκκαθαίρω	to cleanse out
ἐκκενόω	to empty out, leave desolate
ἐκκναίω	to wear out
ἔκκριτος	picked out, select
ἐκλελάθοντα	
ἐκλέπω	to bring
ἐκλήγω	to cease utterly
ἔκλυσις	release or deliverance from
ἐκλύω	to loose, release, set free, from
ἐκμαίνω	to drive mad
ἐκμαραίνω	to make to wither away
ἐκμάσσατο	he devised or invented
ἐκμάσσω	to wipe off, wipe away
ἐκνίζω	to wash out, purge away
ἔκπαγλος	terrible, fearful
ἐκπλέω	to sail out, sail away, weigh anchor
ἐκπονέω	to work out, finish off
ἐκποτάομαι	to fly out or forth
ἐκπτύω	to spit out of
ἐκρήγνυμι	to break off, snap asunder
ἐκσαλάσσω	to shake violently
ἐκσοβέω	to scare away
ἐκτανύω	to stretch out
ἐκτάσα	
ἐκτείνω	to stretch out
ἐκτελέω	to bring quite to an end, to accomplish, achieve
ἐκτελής	brought to an end, perfect
ἐκτόθεν	
ἔκτοθεν	from without, outside
ἔκτοσθε	outside
̔́Εκτωρ	
ἐκφεύγω	to flee out or away, escape
ἐκφυσάω	to blow out
ἑκών	willing, of free will, readily
ἐλαία	the olive-tree
ἔλαιον	olive-oil
ἔλαιος	the wild olive
ἐλαιόω	
ἐλάσσων	smaller, less
ἐλαύνω	to drive, drive on, set in motion
ἔλαφος	a deer
ἐλαφρός	lightly, buoyantly
ἐλεαίρω	to take pity on
ἐλεεινός	finding pity, pitied or moving pity, pitiable, piteous
ἐλεέω	to have pity on, shew mercy upon
̔Ελένᾳ	
̔Ελένα	
̔Ελέναν	
̔Ελένας	
̔Ελένῃ	
ἑλένη	
Ἑλένη	
ἐλεύθερος	free
ἐλεφάντινος	of ivory, ivory
ἐλέφας	the elephant
ἕλη	
̔Ελίκας	
̔Ελίκηθεν	
̔Ελίκης	
ἑλικτός	curved, twisted, wreathed
̔Ελικῶνι	
̔Ελικωνιάσι	
ἐλινῦσαι	
ἕλιξ	anything which assumes a spiral shape
̓Ελισοῦντος	
ἑλίσσω	to turn round, to turn
ἑλίχρυσος	a creeping plant with yellow flower or fruit
ἑλκέω	to drag about, tear asunder
ἕλκος	a wound
ἑλκόω	to wound sorely, lacerate
ἕλκω	to draw, drag
̔Ελλάσποντον	
ἐλλοπιεύω	to fish
ἐλπίς	hope, expectation
ἔλπω	to make to hope
ἐμαλοφόρει	
ἐμαυτοῦ	of me, of myself
ἐμβάλλω	to throw in, put in
ἐμβασιλεύω	to be king in or among
ἔμε	
ἔμεθεν	
ἐμέω	to vomit, throw up
ἐμμαίνομαι	to be mad at
ἐμμελής	sounding in unison, in tune or time, harmonious
ἔμμηνος	in a month, done or paid every month, monthly
ἔμμητρος	with pith in it
ἔμον	
ἐμός	mine
ἔμπας	notwithstanding, nevertheless
ἔμπεδος	in the ground, firm-set, steadfast
ἐμπερόνημα	a garment fastened with a brooch
ἔμπικρος	
ἐμπίπλημι	to fill quite full
ἐμπίπτω	to fall in or upon or into
ἔμπλεος	quite full of
ἐμπλέω	to sail in
ἐμφύλιος	kinsfolk
ἐμφύω	to implant
ἔμψυχος	having life in one, alive, living
ἐν	in, among. c. dat.
̓́Εν	
ἐναλίγκιος	like, resembling
ἐνάλιος	in, on, of the sea
ἔναλλος	changed, contrary
ἐναντίον	
ἐναντίος	opposite
ἐναρίθμιος	in the number, to make up the number
ἕνδεκα	eleven
ἑνδεκαταῖος	on the eleventh day
ἑνδέκατος	the eleventh
ἐνδέμω	to wall up
ἐνδέω	
ἐνδιαθρύπτομαι	to play the prude towards, trifle with
ἐνδιάω	to stay in the open air;
ἐνδίδωμι	to give in
ἐνδινέω	to revolve, go about
ἔνδιος	at midday, at noon
ἔνδοθεν	from within
ἔνδοθι	within, at home
ἔνδοι	
̓́Ενδοι	
ἔνδον	in, within, in the house, at home
ἐνδυκέως	thoughtfully, carefully, sedulously
̓Ενδυμίων	
ἐνέζομαι	to have one's abode in
ἔνεκ'	
ἕνεκα	on account of, for the sake of, because of, for
ἔνεκεν	
ἐνέπω	to tell, tell of, relate, describe
ἐνεργέω	to be in action, to operate
ἐνερείδω	to thrust in, fix in
ἔνερθε	from beneath, up from below
ἐνεύδω	to sleep in or on
ἐνῆμαι	to be seated in
ἔνθα	there
ἐνθάδε	thither, hither
ἔνθεν	on the one side
ἐνιαυτός	any long period of time, a cycle, period
ἐνιδρύω	to set in
ἐνίζω	to sit in or on
ἐνίημι	to send in or into
ἐνίπτω	to reprove, upbraid
ἐνναέτης	an inhabitant
ἐνναετής	nine years old
ἐνναίω	to dwell in
ἐννέα	nine
ἐννεακαίδεκα	nineteen
ἐννεάς	a body of nine
ἐννεάφωνος	
ἕννυμι	to put clothes on
ἐνόδιος	in
ἐνοικέω	to dwell in
ἐνόρχης	a he-goat
ἕνος	belonging to the former of two periods, last year's
ἐνοχλέω	to trouble, disquiet, annoy
ἐντανύω	to stretch or strain tight
ἐνταῦθα	here, there
ἐντίθημι	to put in or into
ἔντοσθε	from within
Ἐνυάλιος	the Warlike
ἐνύπνιον	a thing seen in sleep
ἐνύπνιος	in dreams appearing
ἐνυφαντός	inwoven
ἐν-χόω	
ἔνωμος	
ἐνώπιος	face to face
ἐξ	
ἑξαετής	six years old
ἐξαιρέω	to take out of
ἐξαίρω	
ἐξαίφνης	on a sudden
ἐξάλατο	
ἐξανέχω	to hold up from
ἐξανύω	to accomplish, fulfil, make effectual
ἐξαπίνης	
ἐξαράομαι	to utter curses
ἐξάρχω	to begin with, make a beginning of
ἐξαῦτις	over again, once more, anew
ἐξεγείρω	to awaken
ἐξείλλω	to disentangle
ἐξεῖπον	to speak out, tell out, declare
ἐξελαύνω	to drive out from
ἐξεπόνασα	
ἐξεπόνασας	
ἐξεπόνασεν	
ἐξερύω	to draw out of
ἐξέρχομαι	to go or come out of
ἐξερωέω	to swerve from the course
ἔξεστι	it is allowed, it is in one's power, is possible
ἐξετάζω	to examine well or closely, inquire into, scrutinise, review
ἐξευρίσκω	to find out, discover
ἑξήκοντα	sixty
ἕξις	a having, possession
ἐξόζω	to smell
ἐξόπιθεν	behind, in rear
ἔξοχος	standing out
ἔξω	out
ἔοικα	to be like
ἑορτή	a feast or festival, holiday
ἑός	his, her own
ἐπάβολος	
ἐπάγνυμι	to break
ἐπαγροσύνη	
ἐπάγω	to bring on
ἐπαείδω	to sing to or in accompaniment
ἐπαιάζω	to cry
ἐπαινέω	to approve, applaud, commend
ἐπαίρω	to lift up and set on
ἐπαίσσω	to rush at or upon
ἐπακούω	to listen or hearken to, to hear
ἐπάμερος	
ἐπαμύνω	to come to aid, defend, assist
ἐπανέρχομαι	to go back, return
ἐπανθέω	to bloom, be in flower
ἐπάνωθεν	from above, above
ἐπάξα	
ἐπαξόνιος	upon an axle
ἐπαρκέω	to ward off
ἐπαυτέω	to creak besides
ἐπεγείρω	to awaken, rouse up
ἐπεί	after that, after (postquam), since, when (quum)
ἐπείγω	to press down, weigh down
ἔπειμι	to be upon
ἔπειτα	thereupon
̓Επειῶν	
ἐπελαύνω	to drive upon
ἐπεμπίπτω	to fall upon besides, attack furiously
ἐπέοικε	to be like, to suit
ἐπέρχομαι	to come upon, come near, come suddenly upon
ἐπέχω	to have or hold upon
ἐπηετανός	abundant, ample, sufficient
ἐπήκοος	
ἐπήν	
ἐπήρατος	lovely, charming
ἐπηρεφής	overhanging, beetling
ἐπί	on, upon with gen., dat., and acc.
ἐπί-ἀείρω	
ἐπιβαίνω	to go upon
ἐπιβήτωρ	one who mounts
ἐπιβρίθω	to fall heavy upon, fall heavily
ἐπιβρύω	to burst forth
ἐπιβώμιος	on or at the altar
ἐπιβωτᾷ	
ἐπιγνώμων	an arbiter, umpire, judge
ἐπιγουνίς	the part above the knee, the great muscle of the thigh
ἐπιγράφω	to mark the surface, just pierce, graze
ἐπίδειξις	a shewing forth, making known
ἐπιδέξιος	towards the right
ἐπίδεξις	
ἐπιδευής	in need or want of
ἐπιδόρπιος	for use after dinner
ἐπιέννυμι	to put on besides or over
ἐπιζεύγνυμι	to join at top
Ἐπιθάλαμιος	
ἐπιθυμέω	to set one's heart upon
ἐπίκειμαι	to be laid upon
ἐπικερτομέω	to mock
ἐπικλύζω	to overflow
ἐπικουρέω	to act as an ally
ἐπιλαμβάνω	to lay hold of, seize, attack
ἐπιλήθω	to cause to forget
ἐπιμαίομαι	to strive after, seek to obtain, aim at
ἐπιμελέομαι	to take care of, have charge of, have the management of
ἐπιμέμφομαι	to cast blame upon
ἐπίμετρον	over-measure, excess
ἐπιμηθής	thoughtful
ἐπιμύζω	to murmur at
ἐπιμωματός	
ἐπινεύω	to nod
ἐπινέω	
ἐπινήχομαι	to swim upon
ἐπινίσσομαι	to go over
ἐπίνομες	
ἐπίορκος	sworn falsely
ἐπίουρος	an over-keeper, a guardian, watcher, ward
ἐπιπάσσω	to sprinkle upon or over
ἐπίπαστος	sprinkled over
ἐπιπλαταγέω	to applaud loudly
ἐπιπλέω	to sail upon or over
ἐπιπρέπω	to be manifest on the surface, to be conspicuous
ἐπιπταίρω	to sneeze at
ἐπιρραίνω	to sprinkle upon or over
ἐπιρρέζω	to offer sacrifices at
ἐπιρρέω	to flow upon the surface, float a-top
ἐπίσκοπος	
ἐπισκύνιον	the skin of the brows
ἐπισπένδω	to pour upon or over
ἐπισπεύδω	to urge on, further or promote
ἐπίσταμαι	to know
ἐπιστάτη	
ἐπισχερώ	in a row, one after another
ἐπιτάσσω	to put upon
ἐπιτέλλω	to lay upon, enjoin, prescribe, ordain, command
ἐπίτηδες	designedly, deceitfully
ἐπιτίτθιος	at the breast, a suckling
ἐπιτρέπω	to turn towards
ἐπιτρέχω	to run upon or at
ἐπιτρόπῃς	
ἐπιτυμβίδιος	at or over a tomb
ἐπιφθύζω	to spit at
ἐπιφλέγω	to burn up, consume
ἐπίφλεξις	
ἐπιφράζω	to say besides
ἐπίφρων	thoughtful, sage
̓Επιχάλκω	
ἐπίχαρμα	an object of malignant joy
̓Επίχαρμος	
ἐπίχειρα	
ἐπίχειρον	wages of manual labour
ἐπιχέω	to pour water over
ἐπιχθόνιος	upon the earth, earthly
ἐπιχωρέω	to give way, yield
ἐπιχώριος	in or of the country
ἐποίχομαι	to go towards, approach
ἕπομαι	
ἐπομμαδίαις	
ἐπόμνυμι	to swear after, swear accordingly
ἐπόνασαν	
ἐπόρνυμι	to stir up, arouse, excite
ἐπορούω	to rush violently at or upon
ἔπος	a word
ἐπουράνιος	in heaven, heavenly
ἔποψ	the hoopoe
ἑπτάδραχμος	worth seven
ἔραζε	to earth, to the ground
ἔραμαι	to love, to be in love with
ἐράνναν	
ἐράννω	
ἐραστής	a lover
ἐραστός	beloved, lovely
ἐρατός	lovely, charming
ἐράω	
ἐργάζομαι	to work, labour
ἐργάτης	a workman
̓Εργατίνα	
ἐργατίνης	a husbandman
ἔργμα	a work, deed, business
ἔργνυμι	to confine
ἔργον	work
ἔργω	
ἔρδης	
ἔρδω	to do
ἐρεείνω	to ask
ἐρεθίζω	to rouse to anger, rouse to fight, irritate
ἐρ́εθω	
ἐρείδω	
ἐρέικη	heath, heather
ἐρείκη	
ἐρειοί	
ἐρείπω	
ἔρεισμα	a prop, stay, support
ἔρεσθαι	
ἐρέσσω	to row
ἐρετμόν	
ἐρετμός	
ἐρετμόω	to furnish with oars, set to row
ἐρεύγομαι	to spit or spew out, to disgorge
ἔρευθος	
ἐρεύθω	to make red, stain red
ἔρευνα	inquiry, search
ἐρευνάω	to seek or search for, search after, track
ἐρέω	to ask, enquire
ἐρημάζω	to be left lonely, go alone
ἐρητύω	to keep back, restrain, check
ἐριδμαίνω	to provoke to strife, irritate
ἐρίζω	to strive, wrangle, quarrel
ἐριθακίς	
ἐριθηλής	very flourishing, luxuriant
ἔριθος	a day-labourer, hired servant
ἐρικυδής	very famous, glorious, splendid
ἐρινεόν	
ἐρινεός	the wild fig-tree
̓Εριννύος	
ἔριον	wool
ἔρις	strife, quarrel, debate, contention
ἔριφος	a young goat, kid
ἕρκος	a fence, hedge, wall
̔Ερμείαο	
̔Ερμέω	
̔Ερμῆς	
ἔρνος	a young sprout, shoot, scion
ἔρομαι	to ask, enquire
̓́Ερον	
̓́Ερος	
ἔρος	
̔́Ερπεις	
ἑρπετόν	a walking animal, quadruped
ἕρπυλλος	creeping thyme
ἕρπω	to creep, crawl
ἔρρευν	
ἔρρω	to go slowly, wander about
ἔρσα	dew
ἔρσε	
ἕρση	
ἐρυθρός	red
̓Ερύκαν	
ἐρύκω	to keep in, hold back, keep in check, curb, restrain
ἐρύω	to drag along the ground, drag, draw
ἔρχομαι	to come or go
ἐρῶ	I will say or speak
ἐρωέω	to rush, rush forth
ἐρωή	any quick motion, rush, force
ἐρωία	
ἔρως	love
̓́Ερως	
̓́Ερωτα	
ἐρωτάω	to ask
̓́Ερωτες	
̓́Ερωτι	
ἐρωτικός	amatory
ἐρωτίς	a loved one, darling
̓́Ερωτος	
ἐρωτύλος	a darling, sweetheart
̓Ες	
ἐσθίω	to eat
ἐσθλός	good
ἔσθω	to eat
ἑσπέριος	at even, at eventide
ἔσσαν	
̓́Εσσεται	
ἐσσύμενος	hurrying, vehement, eager, impetuous
ἔστε	up to the time that, until
ἑστία	the hearth of a house, fireside
ἑστιάω	to receive at one's hearth or in one's house: to entertain, feast, regale
ἕστιος	
ἐσχαρεών	
ἐσχατάω	to be at the edge, on the border
ἐσχατιά	the furthest part, edge, border, verge
ἔσχατος	outermost
ἔσω	to the interior
ἔται	
ἑταίρα	a companion
ἑταῖρος	a comrade, companion, mate
̓Ετεόκλειοι	
ἐτεός	true, real, genuine
ἕτερος	one of the
ἑτέρωθεν	from the other side
ἑτέρως	in one or the other way
ἔτης	clansmen
ἐτήτυμω	
ἔτι	yet, as yet, still
ἑτοιμάζω	to make or get ready, prepare, provide
ἑτοῖμος	at hand, ready, prepared
ἔτος	a year
ἑτός	
ἔτυμος	true, real, actual
ἐτώσιος	fruitless, useless, unprofitable
εὖ	well
εὐαγέω	to be pure, holy
εὐαγής	
εὐαλάκατος	
εὔβοτος	with good pasture
εὐγένειος	well-maned
εὐγνώμων	of good feeling, kindhearted, considerate, reasonable, indulgent
εὐδαίμων	blessed with a good genius;
Εὐδάμιππον	
εὔδιος	calm, fine, clear
εὕδω	to sleep, lie down to sleep
εὐέανος	richly-robed
εὔεδρος	with beautiful seat, on stately throne
εὐειδής	well-shaped, goodly, beautiful, beauteous
εὐεργεσία	well-doing
εὐεργής	well-wrought, well-made
εὔεργον	
εὐηγενής	
εὐηλάκατος	spinning well
εὐήνεμος	well as to the winds
Εὐηρείδα	
εὖθριξ	with beautiful hair
εὐθυμέω	to be of good cheer
εὐθύς	
εὔθυς	
εὐκαμπής	well-curved, curved
εὐκέατος	easy to cleave or split
εὔκηλος	free from care, at one's ease
εὔκομος	fair-haired
εὔκριθος	rich in barley
εὔκριτος	
εὐκτός	wished for
Εὔμαιος	
Εὐμάρᾳ	
εὐμαρής	easy, convenient, without trouble
Εὐμάρης	
εὐμενέω	to be gracious
εὐμενής	well-disposed, favourable, gracious, kindly
Εὐμήδης	
εὐμήκης	of a good length, tall
εὔμηλος	rich in sheep
εὔμιτρος	with beautiful
εὔμολπος	sweetly singing
εὐνάζω	to lay or place in ambush
εὐνάω	to lay or place in ambush
Εὐνείκα	
εὐνή	a bed
Εὐνόα	
εὔοδμος	
εὔοσμος	sweet-smelling, fragrant
εὐπαγής	compact, firm, strong
εὐπατρίδης	of good or noble sire, of noble family
εὐπένθερος	with a good father-in-law
εὔπεπλος	beautifully robed
εὐπλόκαμος	with goodly locks, fairhaired
ἐυπλόκαμος	
εὔπλοξν	
εὕρησις	
εὑρίσκω	to find
εὕρομες	
εὖρον	
Εὐρύμεδον	
εὐρυμέδων	
Εὐρυμέδων	
εὐρύνω	to broaden
εὐρύς	wide, broad
Εὐρυσθεύς	
εὐρύστερνος	broad-breasted
Εὔρυτος	
εὐρώς	mould, dank decay
Εὐρώτης	
εὖσα	
εὐσεβέω	to live or act piously and religiously
εὐσεβής	righteous
Εὐσθένεος	
εὔσκιος	
εὔσκοπος	sharp-seeing, keen-sighted, watchful
εὔσοος	
εὔσους	safe and well, happy
εὔσφυρος	with beautiful ankles
εὖτε	when, at the time when
εὐτεκνία	the blessing of children, a breed of goodly children
εὐτεκνίη	
ἐύτμητος	well-cut
εὔτριχος	
εὔτυκος	ready
Εὐτυχίδος	
εὔυδρος	well-watered, abounding in water
εὔφημος	uttering sounds of good omen
εὐφραίνω	to cheer, delight, gladden
εὐφροσύνη	mirth, merriment
εὐφρόσυνος	in good cheer
εὔχομαι	to pray, offer prayers, pay one's vows, make a vow
εὖχος	the thing prayed for, object of prayer
εὐώδης	sweet-smelling, fragrant
ἔφαβος	
ἐφάλλομαι	to spring upon, assail
ἐφάμαν	
ἐφάπτω	to bind on or to
ἐφαρμόζω	to fit on or to, to fit
ἐφέζομαι	to sit upon
ἐφέρπω	to creep upon
ἐφηβικός	of or for
ἔφηβος	one arrived at puberty
ἐφήμερος	living but a day, short-lived
ἔφθασσα	
ἐφίζω	to set upon
ἐφίημι	to send to
ἐφίλαθεν	
ἐφίλασα	
ἐφίλασας	
ἐφίλασε	
ἐφίλασεν	
ἐφίμερος	longed for, desired, charming
ἐφίστημι	to set or place upon
ἐφοράω	to oversee, observe, survey
ἐφύπερθε	above, atop, above
̓Εφυραίων	
̓Εφύρας	
ἐφύω	to rain upon
ἐχέστονος	bringing sorrows
ἔχης	
ἐχθαίρω	to hate, detest
ἐχθές	yesterday
ἔχθιστος	most hated, most hateful
ἔχθρα	
ἔχθρη	hatred, enmity
ἐχθρός	hated, hateful
ἔχις	an adder, viper
ἔχω	to have or to hold
ἐψιθυρίσδομες	
ἕψω	to boil, seethe
ἕως	until, till
Εἰδύλλια	
Ἐπιγράμματα	
ζά	
ζάθεος	very divine, sacred
ζάκοτος	exceeding wroth
Ζάκυνθοσκαι	
ζαλοῖ	
ζαλῶ	
Ζανός	
ζαχρεῖος	wanting much
ζάω	to live
Ζεύς	Zeus
Ζέφυρος	Zephyrus, the west wind
ζέω	to boil, seethe
ζηλωτός	to be emulated, worthy of imitation
ζητέω	to seek, seek for
ζόη	
ζοός	
ζόφος	the gloom of the world below, nether darkness
ζυγή	
ζυγόν	anything which joins two
ζυγός	
ζωή	a living
ζώννυμι	to gird
ζῳογράφοι	
ζωός	alive, living
ζωοτόκοι	
ζωπυρέω	to kindle into flame, light up
ζωπύρια	
ζωπύριον	
ζώς	
ζωστήρ	a girdle
ζώστραισιν	
ζώω	
ἦ	in truth, truly, verily, of a surety
ἤ	
̔Η	
̂̓Η	
ἡβάω	to be at man's estate, to be in the prime of youth
ἥβη	manhood, youthful prime, youth
̔́Ηβης	
ἥγε	
ἡγεμονεύω	to be or act as
ἡγεμονέω	
ἡγέομαι	to go before, lead the way
ἠδέ	and
ἤδη	by this time, before this, already
ἥδομαι	to enjoy oneself, take delight, take one's pleasure
ἦδος	delight, enjoyment, pleasure
ἡδύς	sweet
̓Ηδωνῶν	
ἠέ	
̓Ηελίοιο	
̓Ηέλιος	
ἠέλιος	
̓Ηετίωνι	
ἠίθεος	a youth just
ἠιών	a sea-bank, shore, beach
ἦκα	slightly, a little, softly, gently
ἥκω	to have come, be present, be here
ἠλαίνω	to wander, stray
ἠλακάτη	a distaff
ἠλέματος	idle, vain, trifling
̂̓Ηλθε	
ἠλίβατος	high, steep, precipitous
ἠλίθιος	idle, vain, random
ἡλικία	time of life, age
ἡλίκος	as big as
ἥλιος	the sun
̂̓Ηλις	
̓́Ηλυθες	
ἧμαι	to be seated, sit
ἦμαρ	day
ἡμέρα	day
ἥμερος	tame, tamed, reclaimed
ἡμέτερος	our
ἠμί	I say
ἡμιγένειος	but half-bearded
ἡμίθεος	a half-god, demigod
ἡμίονος	a half-ass
ἡμίφλεκτος	half-burnt
ἦμος	at which time, when
ἡμός	
ἤν	see! see there! lo!
ἤνθομες	
ἡνίκα	at which time, when
ἧπαρ	the liver
ἥπατος	
ἤπειρος	terra-firma, the land
ἠπειρωτικός	continental
ἤπιος	gentle, mild, kind
̔́Ηρᾳ	
ἤρα	acceptable gifts, kindnesses
̔Ηρακλέα	
̔Ηρακλέην	
Ἡρακλέης	Heracles
̔Ηρακλέης	
̔Ηρακλέι	
̔Ηρακλείδας	
̔Ηρακλέος	
̔Ηρακλῆα	
̔Ηρακληείη	
̔Ηρακλῆι	
̔Ηρακλῆος	
Ἡρακλίσκος	
ἠράσσαο	
ἠρέμα	stilly, quietly, gently, softly
̔́Ηρη	
̔́Ηρῃ	
̔́Ηρην	
̔́Ηρης	
ἦρι	early
ἠριγένεια	early-born, child of morn
ἠρίον	a mound, barrow, tomb
ἦρος	
ἡρωίνη	a heroine
ἥρως	warriors
̂̓Ης	
ἥσσων	less, weaker, less brave
ἡσυχία	stillness, rest, quiet
ἥσυχος	still, quiet, at rest, at ease, at leisure
̓́Ητοι	
ἤτοι	now surely, truly, verily
ἦτορ	the heart
ἤτριον	the warp in a web
ἠύτε	as, like as
̔Ηφαίστοιο	
ἠχέω	to sound, ring, peal
ἠχή	a sound or noise
ἠχώ	a sound
ἠῶθεν	from morn
ἠώς	the morning red, daybreak, dawn
θᾶκος	a seat, chair
θάλαμος	an inner room or chamber
θαλάρως	
θάλασσα	the sea
θαλέθω	to bloom, flourish
θαλερός	blooming, fresh
θαλία	abundance, plenty, good cheer
θαλλός	a young shoot, young branch
θάλλω	to bloom, abound, to be luxuriant
θάλος	young persons
θάλπω	to heat, soften by heat
θαλύσια	the firstlings of the harvest, offerings of first fruits
θαλυσιάς	of or for the
θαμβέω	to be astounded, amazed
θάμνος	a bush, shrub
θάνατος	death
θανατόω	to put to death
θάομαι	to wonder at, admire
θάπτω	to pay the last dues to a corpse, to honour with funeral rites
θαρσαλέος	bold, of good courage, ready, daring, undaunted
θαρσέω	to be of good courage, take courage
θάρσος	courage, boldness
θαρσύνω	to encourage, cheer
θάσσων	quicker, swifter
θαῦμα	whatever one regards with wonder, a wonder, marvel
θαυμάζω	to wonder, marvel, be astonied
θάψος	a plant or wood used for dyeing yellow
θέα	a seeing, looking at, view
θεά	a goddess
θέαμα	that which is seen, a sight, show, spectacle
θεάομαι	to look on, gaze at, view, behold
θέειον	(sulphur).
θεεῖος	
θεία	
θείνω	to strike, wound
θεῖον	
θεῖος	
θειόω	to smoke with brimstone, fumigate and purify thereby
θέλγω	to stroke or touch with magic power
θέμενἐστι	
θέμις	that which is laid down or established by custom
θεμιτός	allowed by the laws of God and men, righteous
θεός	God
θέος	
θεριστής	a reaper, harvester
θεριστός	
θερίστριον	a light summer garment
θερμός	hot, warm
θέρος	summer, summertime
θέρσεισ'	
θέρω	to heat, make hot
θεσπέσιος	divinely sounding, divinely sweet
θεσπίζω	to declare by oracle, prophesy, divine
Θεσσαλικός	
Θεσσαλός	a Thessalian
Θεστιάς	
Θεστυλί	
Θέτις	Thetis
Θευγένιδος	
Θεύγενις	
Θευχαρίδα	
θέω	to run
θεωρέω	to look at, view, behold
Θῆβαι	Thebes
Θήβη	
θηητός	gazed at, wondrous, admirable
θήκη	a case to put anything in, a box, chest
θηλάζω	to suckle
θηλύνω	to make womanish, to enervate
θῆλυς	female
θηλυτόκος	giving birth to girls
θήν	surely now
θήρ	a wild beast, beast of prey
θήρα	a hunting of wild beasts, the chase
θηράω	to hunt or chase
θηρίον	a wild animal, beast
Θησεύς	Theseus
θίασος	a band or company marching through the streets with dance and song
θιγγάνω	to touch, handle
θίς	a heap
θλίβω	to press, squeeze, pinch
θνήσκω	to die, be dying
θνητός	liable to death, mortal
θοάζω	to move quickly, ply rapidly
θολερός	muddy, foul, thick, troubled
θολία	a conical hat with a broad brim
θοός	swift
θοόω	to make sharp or pointed
θορυβέω	to make a noise or uproar
Θούριος	
Θραΐσσᾳ	
Θρᾳκιστί	in Thracian fashion
Θρᾷξ	a Thracian;
Θρᾷσσα	a Thracian woman
θρασύς	bold, spirited, courageous, confident
θρηνέω	to sing a dirge, to wail
θρίξ	the hair of the head
θρόνον	flowers embroidered on cloth, patterns
θρόνος	a seat, chair
θρυλέω	to make a confused noise, chatter, babble
θρύον	a rush
θρύπτω	to break in pieces, break small
θρῴσκω	to leap, spring
θύα	
θυγάτηρ	a daughter
θυία	an African tree with scented wood
θυμαλγής	heart-grieving
θυμαρέω	to be well-pleased
Θύμβρις	the Tiber
θύμον	thyme
θυμός	the soul
θύμος	
θυμόω	to make angry
θύννος	the tunny-fish
θύος	a sacrifice, offering
θύρα	a door
Θύρσι	
Θύρσιδος	
Θύρσις	
θύω	
θυώδης	smelling of incense, sweet-smelling
Θυώνιχε	
Θυώνιχον	
θωρήσσω	to arm with breastplate
θώς	the jackal
θὥτερον	
Θύρσις	
Θυώνιχος	
ἰά	a voice, cry
ἴα	
ἰαίνω	to heat
ἰάλεμος	a wail, lament, dirge
ἴαμβος	an iambus
̓Ιάονος	
̓Ιαόνων	
ἰάπτω	to send on, put forth
ἴασις	healing, a mode of healing, cure, remedy
̓Ιασίωνα	
ἰατήρ	doctor, healer
ἰατρός	one who heals, a mediciner, physician or surgeon
ἰαύω	to sleep, to pass the night
ἰαχέω	to cry, shout, shriek
ἰάχω	to cry, shout, shriek
ἰγνύα	the part behind the thigh and knee, the ham
̓Ιδάλιον	
̓́Ιδαν	
̓́Ιδας	
ἰδέ	and
ἰδέα	form
ἴδη	a timber-tree
ἴδιος	one's own, pertaining to oneself
ἰδρεία	skill
ἴδρις	experienced, knowing, skilful
ἱδρύω	to make to sit down, to seat
ἱδρώς	sweat
ἴδων	
ἱερά	
ἱεραί	
ἱέραξ	a hawk, falcon
ἱεράομαι	to be a priest or priestess
ἱερεύς	a priest, sacrificer
ἱερή	
ἴερον	
ἱερόν	
ἱερόνἀλλα	
ἱερός	super-human, mighty, divine, wonderful
ἱερόω	to hallow, consecrate, dedicate
̔Ιέρων	
Ἱέρων	
̔Ιέρωνα	
̔Ιέρωνι	
ἵζω	to make to sit, seat, place
ἵημι	to set a going, put in motion
̓Ιησονίης	
̓Ιήσονος	
̓Ιήσων	
ἰθύνω	to make straight, straighten
ἰθύς	
ἰκανός	
ἱκανόω	to make sufficient, qualify
ἱκάνω	to come, arrive
̓Ικαρίαισι	
ἴκελος	like, resembling
ἵκετις	
ἱκνέομαι	to come
ἵκω	to come to
ἱλάομαι	
ἴλαος	propitious, gracious
ἵλαος	
ἱλάσκομαι	to appease
ἵλημι	be gracious!
̓Ιλιάδας	
̓́Ιλιον	
̓́Ιλου	
ἱμάς	a leathern strap or thong
ἱμείρω	to long for, yearn after, desire
̔Ιμέρα	
ἱμερόεις	exciting love or desire, lovely, delightsome, charming
ἵμερος	a longing or yearning after
ἰμεροφώνων	
ἱμερτός	longed for, lovely
ἵνα	in that place, there
ἰνδάλλομαι	to appear like, look like
ἰνίον	the muscle at the back of the neck, the nape of the neck
̓Ινώ	
ἰξύς	the waist
ἴον	the violet
ἰός	
ἴουλος	the young hair at the side of the face, the whiskers
̔Ιππαλίδας	
ἵππειος	of a horse or horses
ἱππεύς	a horseman
ἱππήλατος	fit for horsemanship or driving
ἱππόβοτος	grazed by horses
ἱπποδιώκτης	a driver or rider of steeds
̔Ιπποκίωνι	
ἱππόκομος	decked with horse-hair
ἱππομανής	in which horses take mad delight
̔Ιππομένης	
ἵππος	a horse, mare
ἱπποτρόφος	horse-feeding, abounding in horses
̔Ιππῶναξ	
̂̓Ιρις	
ἶρον	
ἱρός	
ἴς	a muscle
ἴσησθ'	
̓Ισθμοῦ	
ἴσκε	he said, he spake
ἴσκω	to make like
ἰσομάτωρ	like one's mother
ἰσοπαλής	equal in the struggle, well-matched
ἴσος	equal to, the same as
ἰσοφαρίζω	to match oneself with, be a match for, cope with
ἰσόω	to make equal
ἱστάω	
ἵστημι	to make to stand
ἱστίον	any web, a sail
ἱστός	anything set upright
ἰσχάς	a dried fig
ἰσχίον	the hip-joint
ἰσχνός	dry, withered, lean, meagre
ἴσχω	to hold, check, curb, keep back, restrain
ἴσως	equally, in like manner
ἰτέινος	of willow
ἴτης	
ἴτον	
ἶυγξ	
̓̂Ιυγξ	
ἰυκτής	one who shouts or yells
ἴφθιμος	stout, strong, stalwart
̓Ιφικλέης	
̓Ιφικλείης	
̓Ιφικλῆα	
̓Ιφικλῆι	
ἰχθύα	
ἰχθυάω	to fish, angle
̓Ιχθύος	
ἰχθύς	a fish
ἴχνιον	a track, trace, footstep
ἴχνος	a track, footstep
̓Ιωλκόν	
ἰωχμός	
κάγκανον	
κάγκανος	fit for burning, dry
Καδμεῖος	Cadmean
καθά	according as, just as
καθαιρέω	to take down
καθαίρω	to make pure or clean, cleanse, clean, purge
καθάπτω	to fasten, fix or put upon
καθαρός	clear of dirt, clean, spotless, unsoiled
καθεύδω	to lie down to sleep, sleep
κάθημαι	to be seated
καθιδρύω	to make to sit down
καθίζω	to make to sit down, seat
καθίημι	to send down, let fall
καθικνέομαι	to come down to
κάθιξις	
καθίστημι	to set down, place
καθό	in so far as, according as
καθύπερθε	from above, down from above
καθυπέρτερος	above
καί	and
Κάικος	
καινός	new, fresh
καίνω	to kill, slay
καίπερ	although, albeit
καιρός	due measure, proportion, fitness
καίτοι	and indeed, and further
καίω	to light, kindle
κάκη	wickedness, vice
κακόκνημος	weak-legged, thin-legged
κακός	bad
κακοῦργος	doing ill, mischievous, knavish, villanous
κακοχρήσμων	difficult to live with
κακόω	to treat ill, maltreat, afflict, distress
κάκτος	
καλαθίσκος	
Καλαιθίδος	
καλαμαία	grasshopper
καλαμαῖος	
καλαμευτής	a reaper, mower
καλάμη	the stalk or straw of corn
κάλαμος	a reed
καλέω	to call, summon
κάλη	
καλίαν	
καλλιερέω	to have favourable signs in a sacrifice, to obtain good omens
κάλλιον	
Κάλλιον	
κάλλιστα	
κάλλος	beauty
καλός	beautiful, beauteous, fair
κάλπις	a vessel for drawing water, a pitcher or ewer
καλύβη	a hut, cabin, cell
Καλυδώνιος	
κάλυξ	a covering
καλύπτω	to cover with
κάλως	a reefing rope, reef
Καμίρου	
κάμνω	to work
κάμπτω	to bend, curve
κάμψη	
κἀν	and if, even if, although
κάνεον	a basket of reed or cane, a bread-basket
κανηφόρος	carrying a basket
κανθάρος	
κἀντιγένης	
κάπετος	a ditch, trench
κάπος	
κᾶπος	
καππυρίζω	to catch, take fire
καπυρός	dried by the air, dry
Κάρ	a Carian
κάρα	the head
καρδία	the heart
Κάρνεια	a festival held in honour of Apollo
καρπάλιμος	swift
κάρπιμος	fruit-bearing, fruitful
καρπός	
κάρτα	very, very, much, extremely
καρτερός	strong, staunch, stout, sturdy;
κάρτος	strength, vigour, courage
καρτύνω	
κάρυον	nut
καρχαρόδων	
κασίγνητος	a brother
Κασταλίδες	
Κάστωρ	Castor
κατά	down, downwards, with gen. or acc.
κατά-ἀγείρω	
κατά-ἄντομαι	
καταβαίνω	to step down, go or come down
καταβάλλω	to throw down, overthrow
καταβρίθω	to be heavily laden or weighed down by
καταδαίνυμαι	to devour
καταδαρθάνω	to fall asleep
καταδείκνυμι	to discover and make known
καταδέχομαι	to receive, admit
καταδύω	to go down, sink, set
κατά-ἕζομαι	
καταθάπτω	to bury
καταθέω	to run down
καταθύω	to sacrifice
καταίθω	to burn down, burn to ashes
κατά-καθέζομαι	
κατακείω	
κατακλείω	to shut in, inclose
κατακλίνω	to lay down
κατακόπτω	to cut down, cut in pieces, cut up
κατακρίνω	to give as sentence against
καταλαμβάνω	to seize upon, lay hold of
καταλέγω	to lay down
καταλείβω	to pour down;
καταλείπω	to leave behind
καταπίπτω	to fall or drop down
καταπρίω	to saw up
καταπτυχής	with ample folds
κατάπυκνος	very thick
καταρρέω	to flow down
κατασείω	to shake down, throw down
κατασμύχω	to burn with a slow fire, burn up
κατατάσσω	to draw up in order, arrange
κατατήκω	to melt away, to make to fall away
κατατίθημι	to place, put
κατατρίβω	to rub down or away;
κατατρύχω	to wear out, exhaust
κατατρώγω	to gnaw in pieces, eat up
καταυτόθι	
καταφαίνω	to declare, make known
καταφθείρω	to destroy or spoil utterly, bring to naught
καταχεύω	
καταχής	sounding
κατείβω	to let flow down, shed
κατελαύνω	to draw down
κατεναντίον	over against, opposite, before
κατέπεφνον	to kill, slay
κατερείπω	to throw or cast down
κατέρχομαι	to go down from
κατεσθίω	to eat up, devour
κατεύχομαι	to pray earnestly
κατηρεφής	covered over, vaulted, overhanging
κατοικέω	to dwell in as a κάτοικος, to settle in, colonise
κάτος	
κάτω	down, downwards
κάτωθε	
Καύκασος	Mt. Caucasus
καῦμα	burning heat
καὔτας	
καὐτονόα	
καυχάομαι	to speak loud, be loud-tongued
καυχός	
καχάζω	to laugh aloud
καχλάζω	to plash
κέδρινος	of cedar
κέδρον	
κέδρος	the cedar-tree
κεῖμαι	to be laid
κείμαν	
κειμήλιον	anything stored up as valuable, a treasure, heirloom
κειμήλιος	
κείρω	to cut
κεκαρωμένα	
κελαδέω	to sound as rushing water
κελάδω	sounding, roaring
κελαινός	black, swart, dark, murky
κελαρύζω	to murmur
κελέβη	a cup, jar, pan
κελέοντες	the beams in the upright loom
κέλευθος	a road, way, path, track
κελεύω	to urge or drive on, urge, exhort, bid, command, order
κέλλω	to drive on
κέλομαι	to urge on, exhort, command
κενεών	the hollow below the ribs, the flank
κενός	empty
κενόω	to empty out, drain
κέντασε	
κενταυροφόνοιο	
κεντέω	to prick, goad, spur on
κεραίζω	to ravage, despoil, plunder
κεραός	horned
κέρας	the horn of an animal
κεραυνός	a thunderbolt
Κέρβερος	
κερδαίνω	to gain, derive profit or advantage
κερδίων	more profitable
κέρδος	gain, profit, advantage
κερκίς	the rod or comb
κέρκος	the tail
κερούτιδες	
κερτομέω	to taunt or sneer at
κεύθω	to cover quite up, to cover, hide
κεφαλή	the head
κεχρήσετ'	
Κέως	Ceos
κἤγω	
κηδεμών	one who is in charge
κήδεος	given in charge for burial
κῆδος	care for
κήδω	to trouble, distress, vex
κήλη	a tumor
κἤμε	
κῆπος	a garden, orchard, plantation
κῆρ	the heart
Κήρ	
κήρα	
κηριοκλέπτης	stealer of honeycombs
κηρίον	a honeycomb
κηρόδετος	wax-bound
κηρόομαι	to form for oneself of wax
κηρός	bees-wax
Κιανῶν	
κιθαριστής	a player on the cithara
κίκιννος	a ringlet
κικλήσκω	to call, summon
Κίλιξ	a Cilician
κίναδος	a fox
Κιναίθα	
κινέω	to set in motion, to move
κίνημα	a motion, movement
Κίρκη	Circe
κίσθος	
κίσσα	the jay or magpie
Κισσαίθα	
κισσάω	to crave for strange food
κισσός	ivy
κισσόω	to wreathe with ivy
κισσύβιον	a rustic drinking-cup
κίστη	a box, chest
κιχλίζω	to chirp like a thrush
κίω	to go
κλαγγεῦντι	
κλάδος	a young slip or shoot broken off
κλάζω	to make a sharp piercing sound
κλαίω	to weep, lament, wail
κλᾴξ	
κλαῦσις	
κλάω	to break, break off
Κλεαρίστα	
Κλεαρίστας	
Κλείτας	
κλείω	
κλέος	a rumour, report, news
κλέπτης	a thief
κλέπτω	to steal, filch, purloin
Κλεύνικος	
κλῆρος	a lot;
κλητός	called, invited, welcome
κλῖμαξ	a ladder or staircase
κλίνη	that on which one lies, a couch or bed
κλιντήρ	a couch, sofa
κλίνω	to make to bend, slope
κλισμός	a couch
κλύζω	to dash over
κλύμενον	
κλύμενος	famous
Κλυτίη	
κλύω	to hear
κλωστήρ	a spindle
κνάκωνα	
κνάμα	
κνάμαισιν	
κνάμας	
κνάσαιο	
κνηκός	pale yellow, tawny
κνήμαργος	white-legged
κνίδη	a nettle
κνίζω	to scrape or grate: to tickle
κνύζα	
κνυζάομαι	to whine, whimper
κνυζόω	to disfigure
κνώδαλον	any dangerous animal
κνώσσω	to slumber, sleep
κόιλος	
κοῖλος	hollow, hollowed
κοιμάω	to lull or hush to sleep, put to sleep
κοῖτος	a place to lie on, bed
κοκκύζω	to cry cuckoo
κολεόν	a sheath, scabbard
κολεός	
κόλος	docked, curtal
κολοσσός	a colossus
κολούω	to cut short, dock, curtail
κόλπος	the bosom
κολπόω	to form into a swelling fold;
Κόλχος	a Colchian
κολώνη	a hill, mound
κόμαρον	
κόμαρος	the strawberry-tree, arbutus
Κομάτα	
Κομάτᾳ	
Κομάταν	
Κομάτας	
κομάω	to let the hair grow long, wear long hair
κομέω	to take care of, attend to, tend
κόμη	the hair, hair of the head
κομιδή	attendance, care
κονία	dust, a cloud of dust
κονιάω	to plaster or whiten over
κόνιος	
κόνις	ashes
κονίω	to make dusty, cover with clouds of dust
κόνυζα	fleabane, pulicaria
κόος	
κόπτω	to strike, smite, knock down
κορέννυμι	to sate, satiate, satisfy
κορέω	to sweep, sweep out
κόρη	a maiden, maid, damsel
κόρθυς	
Κορίνθιος	Corinthian
κόριον	
κόρος	
κόρση	one of the temples, the side of the forehead
κόρσης	
κορυδαλλίς	
κορυδαλλός	
κορυδός	the crested lark
κόρυδος	
Κορύδωνι	
κόρυθος	
κορύνη	a club, mace
κορυπτίλος	one that butts with the head
κορύπτω	to butt with the head
κόρυς	a helmet, helm, casque
κορύσσω	to furnish with a helmet
κορυφή	the head, top, highest point;
κορώνη	sea-crow
κορωνίς	crook-beaked, curved
κοσκινόμαντις	a diviner by a sieve
κοσμέω	to order, arrange
κόσμος	order
κόσσυφος	
κότινον	
κότινος	the wild olive-tree
Κοτυταρίς	
κουρά	a shearing or cropping
κοῦρος	
κουροσύνη	youth, youthful prime
κουρόσυνος	youthful
κουροτρόφος	rearing boys;
κουφίζω	to be light
κοῦφος	light, nimble
κούφῳφράζεο	
κόχλιας	
κοχλίας	a snail with a spiral shell
κόχλος	a shell-fish with a spiral shell
κοχυδέω	to stream forth copiously
κραδίας	
Κρᾶθιν	
Κράθις	
κραίνω	to accomplish, fulfil, bring to pass
Κραναίης	
κραναός	rocky, rugged
Κραννώνιος	
κράς	the head
κράσπεδον	the edge, border, skirt or hem
κρατερός	strong, stout, mighty
κρατέω	to be strong, mighty, powerful
κρατήρ	a mixing vessel
Κρατίδᾳ	
Κρατίδας	
κράτιστος	strongest, mightiest
κράτος	strength, might
κρατύνω	to strengthen
κρατύς	strong, mighty
κρεανομέω	to distribute flesh, to divide the flesh
κρέας	flesh, meat, a piece of meat
κρείουσα	
κρείσσων	stronger, mightier, more powerful
κρείων	a ruler, lord, master
κρέκω	to strike
κρεμάννυμι	to hang, hang up
Κρεώνδαις	
κρήγυος	good, agreeable
κρήνη	a well, spring, fountain
κρηπίς	a half-boot
κριθάω	to be barley-fed, to wax wanton
κρίνον	a lily
κρίνω	to pick out, choose
κριός	a ram
Κροῖσος	
κροκόεις	saffron-coloured
Κροκύλος	
Κρονίδης	son of Cronus
Κρονίων	son of Cronus
κρόταφος	the side of the forehead
κροτέω	to make to rattle
Κρότωνακαλα	
κρύβδην	secretly
κρύπτω	to hide, cover, cloak
κρύσταλλος	clear ice, ice
κρύψις	a hiding, concealment
κρωσσός	a water-pail, pitcher, jar
κτάομαι	to procure for oneself, to get, gain, acquire
κτέανον	possessions, property
κτέαρ	
κτεατίζω	to get, gain, win
κτείνω	to kill, slay
κτείς	a comb
κτέομαι	
κτέρεα	funeral gifts
κτῆσις	acquisition
κτίζω	to people
κύαμος	a bean
κυανάμπυξ	with dark edge
Κυάνεαι	dark rocks
κυάνεος	dark-blue, glossy-blue
κυάνοφρυ	
κυάνοφρυν	
Κύβελα	
Κυβέλη	Cybele
κύδιστος	most glorious, most honoured, noblest
κυδοιμός	the din of battle, uproar, hubbub
κῦδος	glory, renown
Κυδωνικόν	
Κυθέρεια	Cythereia
Κυκλάδες	
κυκλάμινος	
κυκλάς	round, circular;
κύκλος	a ring, circle, round
Κύκλωψ	a Cyclops
Κύκνος	
κύκνος	a swan
κυλινδέω	
κυλίνδω	to roll, roll along or down
κύλιξ	a cup, drinking-cup, wine-cup
κυλίω	to roll along
κυλοιδιάω	to have a swelling below the eye
κῦμα	anything swoln
Κυμαίθα	
κύμινον	cummin
κυναγός	a hound-leader
κυνάς	of a dog
κυνάω	to play the Cynic
κυνέη	a dog's skin
κυνέω	to kiss
Κυνίσκη	
κυνοθαρσής	impudent as a dog
κυνόσβατος	dog-thorn or dog-rose
κυπαρίσσινος	of cypress-wood
κυπάρισσος	a cypress
κύπειρον	galingale
κύπειρος	
Κύπρις	Cypris
Κυπρογενήας	
Κύπρος	Cyprus
κυρέω	to hit, light upon
κύρτος	
κυρτός	curved, arched
κύτισος	cytisus, a kind of clover
κύω	to conceive
κύων	a dog or bitch
κῶας	a fleece
κᾠκτίρμονος	
κωλοπέδας	
κῶμα	deep sleep, slumber
κωμάζω	to go about with a party of revellers, to revel, make merry
κώμη	country town
κῶμος	a village festival: a revel, carousal, merry-making
κώμυς	a bundle
κωμῳδία	a comedy
Κώναρος	
κῶνος	the fruit of the
κώπη	the handle of an oar
κώρα	
κῶρος	
Κῶς	Cos
κωτίλλω	to prattle, chatter
κωτίλος	twittering
Κομάτας	
Κορύδων	
λᾶας	
Λάβα	
λαβύρινθος	a labyrinth or maze
Λαγείδας	
λαγχάνω	to obtain by lot, by fate, by the will of the gods
λαγωβόλον	
λαγών	the hollow on each side below the ribs, the flank
Λαέρτης	
λάζομαι	to take, seize, grasp
λάθος	
λᾶθος	
λάθριος	treacherously
λαιμός	the throat, gullet
λαίνεος	
λάινος	of stone or marble
λαιός	on the left
λαιοτομέω	to reap corn
λαῖτμα	the depth or gulf
Λάκαινα	Lacaena, a Laconian woman
Λακεδαιμόνιος	
Λακεδαίμων	Lacedaemon
Λακίνιος	
Λάκων	a Laconian or Lacedaemonian
λαλαγέω	to prattle, to babble
λαλέω	to talk, chat, prattle, babble
λάλλαι	pebbles
λάλος	talkative, babbling, loquacious
λαμβάνω	to take
λαμπάς	
λάμπουρος	firetail
Λαμπριάδα	
λάμπω	to give light, shine, beam, be bright, brilliant, radiant
λαμυρός	gluttonous, greedy
λανθάνω	to escape notice, to be unknown, unseen, unnoticed
λάξ	with the foot
Λαοκόωσσα	
λᾷον	
λαός	the people
λαοφόνος	slaying the people
λαοφόρος	bearing people
Λαπίθαι	
Λαπίθης	
λάπτω	to lap with the tongue
Λαρισαῖος	Larissaean, of or from Larissa
λάρναξ	a coffer, box, chest
λασιαύχην	with rough, shaggy neck
λάσιον	
λάσιος	hairy, rough, shaggy, woolly
Λάτυμνον	
λαύρα	an alley, lane, passage
λαχαίνω	to dig
λάω	
λέαινα	a lioness
λέγος	
λέγω	
λείβω	to pour, pour forth
λειμών	any moist, grassy place, a meadow, mead, holm
λειμώνιον	
λειμώνιος	of a meadow
λειμωνόθεν	from a meadow
λεῖος	smooth, plain, not embroidered
λείπω	to leave, quit
λείχω	to lick up
λέκτρον	a couch, bed
λελίημαι	to strive eagerly
λέμβος	a boat
λεόντειος	
λεόντεος	of a lion
λεοντομάχαν	
Λεοντοφόνος	
λέπαργος	with white coat
λεπράς	
λεπρός	scaly, scabby, rough, leprous
λεπτόν	a very small coin, a mite
λεπτός	peeled, husked, threshed out
λεπύριον	
λευκαίνω	to make white, whiten
λευκάς	
λεύκη	white leprosy
Λεύκιππος	
λεύκιππος	riding or driving white horses
λευκίτης	
λευκόιον	white-violet
λευκόν	white
λευκός	light, bright, brilliant
λεῦκος	
λευκόσφυρος	white-ankled
λευκόχρους	of white complexion
λευκόχρως	white-skinned
λευκόω	to make white
λεύσσω	to look or gaze upon, see, behold
λέχος	a couch, bed
λέων	a lion
λήγω	to stay, abate
Λήδη	
λήθη	a forgetting, forgetfulness
λῆθος	
λήιον	a crop
ληίς	booty, spoil
ληκέω	to sound
Λῆναι	Bacchanals
ληνός	trough;
Λής	
Λητώ	Leto
λιάζομαι	to bend, incline
λίαν	very, exceedingly
λιαρός	warm
Λιβύη	Libya, the north part of Africa
Λιβύηθε	from Libya
Λιβυκός	Libyan
λιγυρός	clear, whistling
λιγύς	clear, whistling
λιγύφθογγος	clear-voiced
λιγύφωνος	clear-voiced, loud-voiced, screaming
λίθος	a stone
λιλαίομαι	to long or desire earnestly
λιμηρός	
λιμνάς	
λίμνη	a pool of standing water
λιμνήτης	living in marshes
λιμός	hunger, famine
λίνον	anything made of flax
λίνος	
Λίνος	Linos
λίπα	unctuously, richly
Λιπάρα	of Lipara
Λιπαραῖος	
λιπαρής	persisting or persevering
λιπαρός	oily, shiny with oil
λιπαρόχροος	
λιπαρόχρους	with shining skin
λιπάω	to be fat and sleek
λιποναύτης	leaving the sailors
λίς	
λισσάς	smooth, bare
λίστρον	a tool for levelling or smoothing, a spade
λίστρος	
λιτανεύω	to pray, entreat
Λιτυέρσης	Lityerses
λιχμάζω	to lick
λιχμάω	to lick with the tongue
λίψ	
λόγος	the word or that by which the inward thought is expressed
λοιπάς	
λοιπός	remaining, the rest
λοίσθιος	last
λοξός	slanting, crosswise, aslant
λουτρόν	a bath, bathing place
λούω	to wash
λοφάω	to have a crest
λόφος	the back of the neck
λόχος	an ambush
λυγίζω	to bend or twist as one does a withe
Λυγκεύς	
λύγραις	
λυγρός	sore, baneful, mournful
Λυδία	Lydia
Λυδίης	
Λύδιος	of Lydia, Lydian
Λύκαιον	
Λυκαῖος	Lycaean, Arcadian
Λυκαονίδαο	
λυκιδεύς	a wolf's whelp
Λυκίδης	
Λύκιοι	the Lycians
λύκιον	
Λύκιος	Lycian.
Λύκος	
λύκος	a wolf
λυκόω	to tear like a wolf
Λύκων	
Λυκωπεύς	
Λυκώπης	
Λυκωπίτας	
λυμαίνομαι	to treat with indignity, to outrage, to maltreat
λυπέω	to give pain to, to pain, distress, grieve, vex, annoy
λύπη	pain of body
λυπρός	wretched, poor, sorry
λύρα	
λυσίζωνος	loosing the zone
Λυσιμελείας	
λύσσα	rage, fury
λυσσάω	to be raging
λύχνιον	
λύχνον	
λύχνος	a portable light, a lamp
λύω	to loose
λωβάομαι	to treat despitefully, to outrage, maltreat
λωβασεῖσθε	
λώια	
λωίων	more desirable, more agreeable
λώπη	a covering, robe, mantle
λῶπος	
λῷστος	
λώτινον	
λώτινος	made of lotus-wood
λωτός	the lotus
Λάκων	
μά	in affirmation
μᾶ	
Μάγνης	a Magnesian
μᾶζα	a barley-cake
μάθη	
μαιμάω	to be very eager, pant or quiver with eagerness
Μαίναλον	Mount Maenalus
Μαίναλος	
μαίνομαι	to rage, be furious
μαίομαι	to seek
μαιωτιστί	
μάκαρ	blessed, happy
μακαριστός	deemed or to be deemed happy, enviable
μακαρῖτις	
μάκαρος	
μακέλας	
μακέλη	
μᾶκος	
μάκρα	
μακράν	a long way, far, far away
μακρός	long
μάκρος	length
μάλα	very, very much, exceedingly
μαλάκοις	
μαλακός	a fresh-ploughed
μάλευρον	
μάλη	the arm-pit
μάλθακον	
μαλθακός	soft
μαλίς	
Μαλίς	
μάλιστα	
μᾶλλον	
μᾶλον	
μαλοπάραυος	
μαλός	white
μάνδρα	an inclosed space
μανθάνω	to learn
μανία	madness, frenzy
μανιώδης	like madness, mad
μαντεύομαι	to divine, prophesy, presage
μάντις	one who divines, a seer, prophet
μάομαι	
μαραίνω	to put out or quench
μαρμαίρω	to flash, sparkle
μαρμάρινος	of marble
μάρμαρον	
μάρμαρος	stone or rock
μάσσω	to handle, touch
μάσσων	longer, greater
μάσταξ	that with which one chews, the mouth
μαστίζω	to whip, flog
μαστός	one of the breasts
ματάω	to be idle, to dally, loiter, linger
μάτερες	
ματεύω	to seek, search
μάτη	a folly, a fault
μάτην	in vain, idly, fruitlessly
μάχαιρα	a large knife or dirk
μάχη	battle, fight, combat
μάχηνδε	
μάχομαι	to fight
μαψίδιος	vain, false
μεγάθυμος	high-minded
μεγαίρω	to look on
μεγάλοιτος	very wretched
μεγάλως	
Μεγαρεύς	a citizen of Megara
Μεγάρη	
μέγαρον	a large room or chamber
μέγας	big, great
μεθίημι	to let go, let loose, release
μεθύω	to be drunken with wine
μειδίαι	
μειδιάω	
μείλιγμα	anything that serves to soothe
μειλίσσω	to make mild, to appease, propitiate
μείς	a month
μέλαθρον	the ceiling of a room
μέλαινα	
Μελάμπους	
μελάμφυλλος	dark-leaved
Μελάνθιος	
μελανόχρους	
μελανόχρως	
μέλας	black, swart
μελεδαίνω	to care for, be cumbered about
μελεδωνεύς	
μελεδώνη	care, sorrow
μέλεος	idle, useless
μέλη	
μέλημα	the object of care, a darling
μέλι	
μελίγηρυς	sweet-voiced, melodious
μελίζω	to modulate, sing, warble
μελικτής	a singer, player
Μελιξοῦς	
μελίπνους	honey-breathing, sweet-breathing
μέλισμα	a song
μέλισσα	a bee
μελίτεια	baulm
μελίτειον	mead
μελιτώδης	like honey
μελίχλωρος	honey-pale
μελιχρός	honey-sweet
μελλόγαμος	betrothed
μέλλω	to think of doing, intend to do, to be about to do
μέλος	a limb
μέλπω	to sing of, celebrate with song and dance
μελύδριον	a ditty
μέλω	to be an object of care or thought
μέμαα	to wish eagerly, strive, yearn, desire
μέμνᾳ	
μέμονα	to wish eagerly, to yearn, strive, be fain
μέμφομαι	to blame, censure, find fault with
μέν	on the one hand, on the other hand
Μενάλκης	
Μενέλαος	withstanding-men
μενοινάω	to desire eagerly, to be bent on
μένὁρη	
μένος	might, force, strength, prowess, courage
μένω	to stay at home, stay where one is, not stir
μερίζω	to divide, distribute
μέριμνα	care, thought
μεριμνάω	to care for, be anxious about, think earnestly upon, scan minutely
Μέρμνωνος	
μέσατος	
μέση	
μεσηγύ	in the middle, between
μεσημβρινός	belonging to noon, about noon, noontide
μεσημέριος	at mid-day
μέσης	
μεσονύκτιον	
μεσονύκτιος	of or at midnight
μέσος	middle, in the middle
μεσόω	to form the middle, be in or at the middle
Μεσσήνη	
Μεσσήνιος	
μέσφα	until
μετά	in the midst of, among with gen., dat., and acc.
μεταί	
μεταίζω	to seat oneself with or beside
μεταίσσω	to rush after, rush upon
μεταμώνιος	borne by the wind
μεταπρέπω	to distinguish oneself or be distinguished among
μετάρσιος	raised form the ground, high in air
μεταυδάω	to speak among
μέτειμι	to be among
μετεῖπον	to speak among
μετέπειτα	afterwards, thereafter
μετέρχομαι	to come or go among
μετόπισθε	from behind, backwards, back
μετρέω	to measure in any way
μέτριος	within measure
μέτρον	that by which anything is measured
μέτωπον	the space between the eyes, the brow, forehead
μέχρι	to a given point, even so far
μή	not
μηδαμός	none
μηδέ	but not or and not, nor
Μηδεία	
Μήδειος	
μηδείς	and not one
μήδομαι	to be minded, to intend, resolve
μηκάς	the bleating one
μηκέτι	no more, no longer, no further
μῆκος	length
μήκων	the poppy
μηλίς	
μῆλον	
μήν	now verily, full surely
μήνιον	
μηνίω	to be wroth with
μηνοφόρως	
μηνύω	to disclose what is secret, reveal, betray
μἠπιβάλῃς	
μἠπιλάθησθε	
μήποτε	never, on no account
μηρία	slices cut from the thighs
μήρινθος	a cord, line, string
μηρός	the thigh
μηρύομαι	to draw up, furl
μής	
μήτε	and not
μήτηρ	a mother
μήτις	lest any one, lest anything; that no one, that nothing
μῆτις	the faculty of advising, wisdom, counsel, cunning, craft
μῆχος	a means, expedient, remedy
μιαίνω	to stain, dye
μίγνυμι	to mix, mix up, mingle, properly of liquids
Μιδεάτιδος	
Μιδεᾶτις	
μικκός	
μικρός	small, little
Μίκων	
Μίλατος	
Μίλητος	Miletus
Μίλλατον	
μῖλος	
Μίλων	
μιμνάσκετο	
μιμνήσκω	to remind, put
μίμνω	to stay, stand fast
μιν	himself
Μινύειος	Minyan
μινύθω	to make smaller or less, lessen, curtail
μινύρισμα	a warbling
μινυρός	complaining in a low tone, whining, whimpering
μισέω	to hate
μισθοδότης	one who pays wages, a paymaster
μισθός	wages, pay, hire
μῖσος	hate, hatred
μίτυλος	hornless
μνᾶ	a weight, =
μνάομαι	to turn one's mind
μνῆμα	a memorial, remembrance, record
μνηστεύω	to woo, court, seek in marriage
μνηστήρ	a wooer, suitor
μνῆστις	remembrance, heed
μογέω	to toil, suffer
μογοστόκος	helping women in hard childbirth
Μοῖρα	
μοῖρα	a part, portion
μοιράω	to share, divide, distribute
Μοῖσα	
μόλις	not scarcely
Μόλος	
μολύνω	to stain, sully, defile
Μόλων	
μόνος	alone, left alone, forsaken solitary
μορμώ	a hideous she-monster
μόρον	
μόρος	man's appointed doom, fate, destiny
Μόρσων	
Μόρσωνι	
μορφάζω	to use gesticulations
μορφάω	to shape, fashion, mould
μορφή	form, shape
μοσχίας	
μοσχίον	a young calf
μόσχιος	
μόσχος	
Μοῦσα	the Muse
μουσίζω	to sing of, chant
μουσικός	of or for music, musical
μουσοποιέω	to write poetry: to sing of
μουσοποιός	making poetry, a poet, poetess
μοχθέω	to be weary with toil, to be sore distressed
μοχθίζω	to suffer
μόχθος	toil, hard work hardship, distress, trouble
μοχλός	a bar
μύελον	
μυελός	marrow
μυθέομαι	to say, speak
μυθίζω	
μυθόομαι	
μῦθος	anything, delivered by word of mouth, word, speech
μυκάομαι	to grate, creak
μυκηθμός	a lowing, bellowing
μύκημα	a lowing, bellowing, roaring
Μυκήνη	Mycene, Mycenae
μυκήσατοκοιλην	
μυκητής	a bellower
μύλη	the nether millstone
Μύνδιος	
μυριάς	a number of
μυρίκη	the tamarisk
μυρίος	numberless, countless, infinite
μύρμακες	
μύρμακι	
μυρμάκων	
μύρμαξ	
μύρον	sweet juice extracted form plants, sweet-oil, unguent, balsam
μῦρος	
μύρτον	a myrtle-berry
μύρτος	the myrtle
Μυρτώ	
μύρω	to flow, run, trickle
μῦς	the field-mouse
μύσταξ	the upper lip, the moustache
Μυτιλήνη	Mytilene
μυχθίζω	to snort, jeer
μυχός	the innermost place, inmost nook or corner
μύω	to close, be shut
μυών	a cluster of muscles, a muscle
μωμάομαι	to find, fault with, blame
Μενάλκας	
ναί	yea, verily
Ναίς	
ναίω	
νάκος	a fleece
νᾶμα	anything flowing, running water, a river, stream
νάοντος	
ναός	the dwelling of a god, a temple
νάπος	
νάρκα	
νάρκη	numbness, deadness
νάρκισσος	the narcissus
νάσσω	to press or squeeze close, stamp down
ναῦς	a ship
ναύτης	a mate or companion by sea
ναυτιλία	sailing, seamanship
νάω	to flow
νέα	
νεάω	to plough up anew
νεβρίς	a fawnskin
νεβρός	the young of the deer, a fawn
νει	
νεικέω	to quarrel or wrangle with
νεῖκος	a quarrel, wrangle, strife
Νείλεος	
Νεῖλος	the Nile
νειός	land ploughed up anew
νεκρός	a dead body, corpse
νεκρόω	to make dead
νέκταρ	nectar
νέκυς	a dead body, a corpse, corse
Νεμέα	Nemea
Νέμειος	Nemean
νεμεσητός	causing indignation or wrath
νεμεσσατά	
νέμος	a wooded pasture, glade
νέμω	to deal out, distribute, dispense
νεογιλλόν	
νεόγραπτος	
νεόγραφος	newly painted or written
νεόδρεπτος	fresh-plucked
νεόκλωστος	fresh spun
νεολαία	a band of youths, the youth
νέομαι	to go or come
νέος	young, youthful
νεοσσός	a young bird, nestling, chick
νεοτευχής	newly made
νεότης	youth
νεότμητος	newly cut
νεοχμός	new
νέποδες	young ones, children
νέρθε	
νέρτος	
νευρά	a string or cord of sinew, a bowstring
νευρειή	
νευρή	
νεῦρον	a sinew, tendon;
νευστάζω	to nod
νεύω	to nod or beckon
νεφέλη	a cloud
νέφος	a cloud, mass or pile of clouds
νέω	
νέωτα	next year, for next year
νεώτερος	younger
Νήαιθον	
νηδυίοφιν	
νήδυμος	sweet, delightful;
νηέω	to heap, heap or pile up
νήλιπος	
νῆμα	that which is spun, a thread, yarn
νηπιάχω	
νήπιος	not yet speaking
Νηρηίς	a daughter of Nereus, a Nereid or Nymph of the sea
νήριθμος	countless
νῆσος	an island
νίζω	to wash the hands or feet
νικάω	to conquer, prevail, vanquish
νίκη	victory in battle
Νικιάας	
Νικίας	
νῖκος	
νιν	him, her
Νιόβη	
Νισαῖος	
νίσσομαι	to go, go away
νίτρον	carbonate of soda
νιφόεις	snowy, snowclad, snowcapt
νίφω	to snow
νοέω	mere sight
νόημα	that which is perceived, a perception, thought
νοήμων	thoughtful, intelligent
νόμαιος	customary
νομαῖος	
νομεύς	a shepherd, herdsman
νομεύω	to put to graze, drive afield
νομίζω	to hold or own as a custom or usage, to use customarily, practise
νόμιος	of shepherds, pastoral
νομός	a feeding-place
νόμος	anything assigned, a usage, custom, law, ordinance
νόος	mind, perception
νοσέω	to be sick, ill, to ail
νόσημα	a sickness, disease, plague
νόσος	sickness, disease, malady
νοστέω	to come or go back, return
νόστος	a return home or homeward
νόσφι	aloof, apart, afar, away
νοτία	wet
νότιος	wet, moist, damp
νότος	the south or south-west wind
νοῦσος	
νύμφη	a young wife, bride
Νύμφης	
νυμφίος	
νῦν	now at this very time
Νύξ	
νύξ	the night-season or a night
νυός	a daughter-in-law
νύσσα	posts
νύσσω	to touch with a sharp point, to prick, spur, pierce
νύχειος	
νωδός	toothless
νωδυνία	ease from pain
νωλεμές	without pause, unceasingly, continually
νωμάω	to deal out, distribute
νῶτον	the back
νῶτος	
ξάνθοθριξ	
ξανθόθριξ	yellow-haired
ξανθοκόμης	
ξανθός	yellow
ξεινήιον	a host's gift
ξεινοδόκος	
Ξενέας	
ξενίζω	to receive or entertain strangers, to receive as a guest
ξένιος	belonging to a friend and guest, hospitable
ξέννον	
ξενοδόκος	one who receives strangers, a host
Ξενοκλέης	
ξένος	
ξενόω	to make one's friend and guest
ξηρός	dry
ξίφος	a sword
ξόανον	an image carved
ξουθός	yellowish, brown-yellow, tawny
ξύλον	wood
ξυλοχίζομαι	
ξυνήων	a joint-owner, partner in
ξυνός	common, public, general, concerning or belonging to all in common
ξυρέω	to shave
ξυρόν	a rasor
ξυρός	
ξυστίς	a xystis, a robe of fine material, a robe of state
̔Ο	
ὁ	the, that
οα	
ὄαρ	a wife
Οαριστύς	
ὀγδοήκοντα	eighty
ὄγκος	
ὄγμος	any straight line, a furrow
ὁδάω	to export and sell;
ὅδε	this
ὁδίτης	a wayfarer, traveller
ὁδοιπόρος	a wayfarer, traveller
ὁδός	
ὀδούς	
ὁδόω	to lead by the right way
ὀδυνάω	to cause
ὀδύνη	pain of body
ὀδύρομαι	to lament, bewail, mourn for
̓Οδυσεύς	
ὀδών	
ὄζος	a bough, branch, twig, shoot
ὄζω	to smell
ὅθεν	from whom
ὅθι	
ὀθνεῖος	strange, foreign
ὁθούνεκα	because
ὁθούνεκεν	
̓́Οθρυος	
οἴγω	to open
οἶδα	to know
οἰδέω	to swell, become swollen
ὀιζυρός	woful, pitiable, miserable
ὀιζύω	to wail, mourn, lament
οἶις	a sheep
οἴκαδε	to one's home, home, homewards
οἰκειόω	to make one's own
οἰκείω	
οἰκέτις	the mistress of the house
οἰκεύς	an inmate of one's house
οἰκέω	to inhabit, occupy
οἴκησις	the act of dwelling, habitation
οἶκος	a house, abode, dwelling
οἰκωφελία	profit to a house, housewifery
οἴμη	a song, lay
οἴμοι	ah me! woe's me!
οἰνάρεον	a vine-leaf
οἰνάρεος	
οἶνον	
οἰνόπεδον	
οἰνόπεδος	with soil fit to produce wine, wine-producing
οἶνος	wine
οἰνοφόρον	
οἰνοφόρος	holding wine
οἰνοχόος	a wine-pourer, cupbearer
οἰνωπός	fresh, ruddy
οἴομαι	to suppose, think, deem, imagine
οἶος	alone, lone, lonely
οἷος	such as, what sort or manner of nature, kind
ὄις	ram
οἰσός	
ὀιστός	an arrow
οἰστράω	to sting
οἴσυον	
οἴχομαι	to be gone, to have gone
ὁκά	
ὅκα	
ὅκκ'	
ὅκκα	
ὀκνέω	to shrink
ὀκνηρός	shrinking, hesitating, backward, unready, timid
ὄκνος	shrinking, hesitation, unreadiness, sluggishness
ὀκριόεις	having many points or roughnesses, rugged, jagged
ὀκτώ	
ὀκτωκαιδεκέτης	eighteen years old
ὅκχ'	
ὄλας	
ὀλβία	
̓́Ολβιε	
ὄλβιος	happy, blest
ὄλβος	happiness, bliss, weal, wealth
ὄλεθρος	ruin, destruction, death
ὀλέκω	to ruin, destroy, kill
ὀλίγος	few, little, scanty, small
ὀλισθάνω	to slip, slip and fall
ὄλλυμι	to destroy, make an end of
ὁλοίτροχος	a rolling stone, a round stone
ὀλολυγών	animal
ὀλολύζω	to cry to the gods with a loud voice, cry aloud
ὅλοξ	whole, entire, complete
ὀλοός	destroying, destructive, fatal, deadly, murderous
ὅλος	
ὁλοσχερής	whole, entire, complete
ὀλοφυγγόνα	
ὀλοφύρομαι	to lament, wail, moan, weep
ὀλοφώιος	destructive, deadly, pernicious
ὀλόχω	
ὄλπη	a leathern oil-flask
ὄλπις	
̓́Ολπις	
Ὄλυμπος	Olympus
̓Ολύμπου	
ὅμαιμος	of the same blood, related by blood
ὁμαλός	even, level
ὁμαρτέω	to meet
ὄμβρος	
ό̓μβρος	heavy rain
̔́Ομηρος	
ὅμιλος	any assembled crowd, a throng of people
ὄμμα	the eye
ὀμμιμνασκομένῳ	
ὀμνάσθην	
ὄμνυμι	to swear
ὁμοίιος	
ὁμοῖος	
ὅμοιος	like, resembling
ὁμοιόω	to make like
̔Ομόλας	
ὁμομαλίδες	
ὁμόρροθος	rowing together
ὁμός	one and the same, common, joint
ὁμότιμος	held in equal honour
ὁμοῦ	at the same place, together
ὁμόω	to unite
ὀμφαλός	the navel
ὄμφαξ	an unripe grape
ὅμως	all the same, nevertheless, nothwithstanding, still
ὁμῶς	equally, likewise, alike
ὄναρ	a dream, vision in sleep
ὀνάσῃς	
ὄνειαρ	anything that profits or helps
ὀνειροκρίτης	an interpreter of dreams
ὄνειρος	a dream
ὀνέμων	
ὄνησις	use, profit, advantage, good luck
ὀνίνημι	to profit, benefit, help, assist
ὄνομα	by name
ὄνομαι	to blame, find fault with, throw a slur upon, treat scornfully
ὀνομαστί	by name
ὀνομαστός	named, to be named
ὄνος	an ass
ὄντα	existing things, the present
ὄνυξ	talons;—
ὄξος	poor wine, vin-de-pays
ὀξύς	sharp, keen
ὀξύχειρ	quick with the hands, quick to strike
ὀπαδέω	to follow, accompany, attend
ὀπάζω	to make to follow, send with
ὁπανίκα	
ὅπη	by which way
ὀπηδός	
ὁπηνίκα	at what point of time, at what hour, on what day
ὄπις	the vengeance or visitation
ὄπισθεν	behind, at the back
ὀπίσσω	
ὀπίσω	backwards
ὁπλή	a hoof, the solid hoof
ὅπλον	a tool, implement
ὁπλότερος	the younger
ὁπόθεν	whence, from what place
ὁπόθι	where
ὁποῖος	of what sort or quality
ὁπόκ'	
ὁπόσος	as many as
ὁπότε	when
ὁπότερος	which of two, whether of the twain
ὁππόκα	
ὁπποσσάκιν	
ὁππόταν	
ὀπτάω	to roast, broil
ὀπτός	roasted, broiled
ὀπυίω	to marry, wed, take to wife
ὀπώρα	the part of the year between the rising of Sirius and of Arcturus
ὅπως	as, in such manner as
ὁρατός	to be seen, visible
ὁράω	To see
ὀργάζω	to soften, knead, temper
ὀργάω	to swell with moisture
ὀργή	natural impulse or propension: one's temper, temperament, disposition, nature
ὄργια	orgies
ὀρέγω	to reach, stretch, stretch out
ὀρεύς	a mule
ὀρεχθέω	to stretch oneself or struggle in the throes of death
ὅρημι	
ὀρθός	straight
ὀρθόω	to set straight
ὀρθρεύω	to rise early, to be awake early
ὄρθριος	at day-break, in the morning, early
ὄρθρος	day-break, dawn, cock-crow
̓́Ορθων	
ὀριγνάομαι	to stretch oneself
ὀρίνω	to stir, raise, agitate
ὅριον	a boundary, limit
ὅριος	of boundaries
ὅρκος	the object by which one swears, the witness of an oath
ὁρμαίνω	to turn over or revolve anxiously in the mind, to debate, ponder
ὁρμάω	to set in motion, urge
ὁρμέω	to be moored, lie at anchor
ὁρμή	a violent movement onwards, an assault, attack, onset
ὁρμιά	a fishing-line of horsehair
ὅρμος	a cord, chain
ὄρνις	a bird
ὄρνυμι	to stir, stir up
ὀροδαμνίς	a sprig, spray
ὀροθύνω	to stir up, rouse, urge on, excite
ὄρομαι	to watch, keep watch and ward
ὄρος	a mountain, hill
ὅρος	a boundary, landmark
ὄρουσις	
ὀρούω	to rise and rush violently on, to move quickly, rush on, hasten, dart forward
ὄρπετον	
ὄρπηξ	a sapling, young tree
ὀρτάλιχος	a chick, chicken
ὀρύσσω	to dig
ὀρφανίζω	to make orphan, make destitute
ὄρφνη	the darkness
ὀρχέομαι	to dance in a row
̓Ορχομενόν	
ὄρχος	a row of vines or fruit-trees
ὅς	this, that;
ὅσγε	who or which at least
ὀσμάομαι	to smell at
ὀσμή	a smell, scent, odour
ὅσος	quantus
ὄσσα	a rumour
ὄσσε	the two eyes
ὁσσίχος	as little, how little
ὅστε	who, which
ὀστέον	the
ὀστί'	
ὀστία	
ὅστις	any one who, anything which
ὄστρακον	an earthen vessel
ὅτα	
ὅταν	whenever
ὅτε	when
ὅτι	
ὅτινι	
ὄττις	
οὐ	not
οὗ	where
οὐδάλλος	
οὐδαμός	not even one, no one
οὖδας	the surface of the earth, the ground, earth
οὐδέ	but not
οὐδείς	and not one
οὐδέποκ'	
οὐδέποτε	and not ever or nor ever, not even ever, never
οὐδέπω	and not yet, not as yet
οὐδός	
οὖθαρ	the udder
οὐκετ'	
οὐκέτι	no more, no longer, no further
οὐλόμενον	
οὐλόμενος	destructive, baneful
οὖλος	
οὖν	really, at all events
οὕνεκα	on which account, wherefore
οὔποτε	not ever, never
οὔπω	not yet
οὐραῖος	of the tail
οὐρανίδαισι	
οὐράνιος	heavenly, of or in heaven, dwelling in heaven
Οὐρανίωνες	the heavenly ones, the gods above
οὐρανός	heaven
οὖρος	
οὖς	auris, the ear
οὔτε	and not
οὔτι	not, I suppose . . , surely you do not mean that . .
οὐτιδανός	of no account, worthless
οὔτις	no one or nobody
οὗτος	this
οὕτως	in this way or manner, so, thus
ὀφείλω	to owe, have to pay or account for
ὀφέλλω	to increase, enlarge, strengthen
ὄφελος	furtherance, advantage, help
ὀφθαλμός	the eye
ὄφις	a serpent, snake
ὄφρα	that, in order that, to the end that
ὀφρύγων	
ὀφρύς	the brow, eyebrow
ὀχεύς	anything for holding or fastening
ὀχεύω	to cover
ὄχθη	a rising ground, a bank, dyke
ὄχλος	a moving crowd, a throng, mob
ὄχνη	a wild pear
ὄψ	a voice
ὀψαμάτης	one who mows till late at even
ὀψίγονος	late-born, after-born
ὄψις	look, appearance, aspect
Π	
πάγχυ	quite, wholly, entirely, altogether
Παιάν	Paean or Paeon
παίγνιον	a plaything, toy
παίγνιος	sportive, droll
παιδεύω	to bring up or rear a child
παιδικόν	
παιδικός	of, for or like a child, boyish
παιδίον	a little or young child
παιδογόνος	begetting children
παίζω	to play like a child, to sport, play
Παιήων	
παῖς	a child
πακτόω	to fasten, make fast
πάλα	
πάλαι	long ago, in olden time, in days of yore, in time gone by
πάλαισμα	a bout or fall in wrestling
παλαίστρα	a palaestra, wrestling-school
παλάσσω	to besprinkle, sully, defile
πάλη	wrestling
παλίγκοτος	breaking out afresh
πάλιν	back, backwards
παλινάγρετος	to be taken back or recalled
παλίουρος	Rhamnus paliurus
παλίσσυτος	rushing hurriedly back
πάλλω	to poise or sway
παλύνω	to strew or sprinkle
πάμμαχος	
πάμπαν	quite, wholly, altogether
Πάμφυλος	
Πάν	Pan
πανάποτμος	all-hapless
πάνδημος	of or belonging to all the
Πάνεσσι	
παννύχιος	all night long
πανολβία	
πάντῃ	
πάντοθεν	from all quarters, from every side
παντοῖος	of all sorts or kinds, manifold
πάντοσε	every way, in all directions
πάντως	altogether;
πανύστατον	for the very last time
πανύστατος	last of all
πάομαι	to get, acquire
παός	
παπταίνω	to look earnestly, gaze
παρά	from the side of, c. gen., beside, alongside of, c. dat., to the side of, motion alongside of, c. acc.
παραβαίνω	to go by the side of
παραβάτις	a woman who follows the reapers
παρά-εὕω	
παραιβάτις	
παραισθάνομαι	to remark or hear of by the way
παρακλίνω	to bend or turn aside
παρακοίτης	one who sleeps beside, a bedfellow, husband, spouse
παρακύπτω	to stoop sideways
παραμύθιον	an address, exhortation
παράπαν	altogether, absolutely
παραπαφίσκω	to mislead, beguile
πάραρος	
παραστάς	anything that stands beside
παρατρέπω	to turn aside
παρατρέχω	to run by or past
παραύα	
παραυτίκα	immediately, forthwith, straightway
παραφρονέω	to be beside oneself, be deranged or mad
παραψύχω	to cool gently
παρείας	
παρείης	a reddish-brown snake
πάρειμι	to be by or present
παρελαύνω	to drive by or past
παρέξ	outside, before
πάρεργον	a bye-work, subordinate or secondary business, appendage, appendix
πάρεργος	
παρέρπω	to creep secretly up to
παρέρχομαι	to go by, beside or past, to pass by, pass
παρέχω	to hold beside, hold in readiness, to furnish, provide, supply
παρήιον	the cheek, jaw
παρθενική	
παρθενικός	of or for a maiden
παρθένος	a maid, maiden, virgin, girl
παρίημι	to let drop beside or at the side, let fall
Πάριος	
Πάρις	
παρισόομαι	to make oneself equal to, measure oneself with
παρίστημι	to make to stand or to place beside
Παρνάσιος	Parnassian
παροδεύω	to pass by
πάροιθε	before, in the presence of
πάρος	beforetime, formerly, erst
Πάρος	Paros
παρών	
πᾶς	all, the whole
πᾶσις	
πάσσαλος	a peg
πάσσον	
πάσσος	
πάσσω	to sprinkle
πάσσων	thicker, stouter
πασταί	
παστάς	a porch
παστή	
πασχόντες	
πάσχω	to receive an impression from without, to suffer
παταγέω	to clatter, clash, clap
πατάσσω	to beat, knock
πατέομαι	to eat
πατέω	to tread, walk
πατήρ	a father
πάτηρ	
πάτρις	
πατρίς	of one's fathers
Πατροκλέης	
πατρώιος	
πατρῷος	of or from one's father, coming or inherited from him
παῦρος	little, small
παύω	to make to cease
Πάφιος	
Πάφος	Paphos
πάχος	thickness
παχύς	thick, stout
πεδάω	to bind with fetters, to bind fast, make fast
πέδη	a fetter
πέδιον	
πεδίον	a plain or flat
πέδον	the ground, earth
πεδωρισταί	
πεζός	on foot
πείθω	to prevail upon, win over, persuade
πεινάω	to be hungry, suffer hunger, be famished
πεῖρα	a trial, attempt, essay, experiment
πειράζω	to make proof or trial of
πειράω	to attempt, endeavour, try
πείρω	to pierce quite through, fix
πεῖσα	obedience
Πείσανδρος	
πέκω	to comb or card
πέλαγος	the sea
πελάζω	to approach, come near, draw near or nigh
Πελασγός	a Pelasgian;
πελειάς	
πελεκάω	to hew or shape with an axe
πέλεκυς	an axe
πέλλα	
πέλλος	
Πελοπηιάδαι	
Πελοποννασιστί	in the Peloponnesian
Πέλοψ	Pelops
πέλω	to be in motion
πελώριος	gigantic
πέλωρον	a monster, prodigy
πέλωρος	monstrous, prodigious, huge, gigantic
πέμπω	to send, despatch
πενέστης	a labourer, workman
πενθερός	a father-in-law
Πενθεύς	
πένθημα	lamentation, mourning
πένθος	grief, sadness, sorrow
πενία	poverty, need
πένομαι	to work for one's daily bread
πέντε	five
πεπαίνω	to ripen, make ripe
πέπλος	any woven cloth
πεπλος	
πέπων	cooked by the sun, ripe, mellow
πέρ	all
πέρα	beyond, across or over, further
πέραν	on the other side, across, beyond
περάω	
πέρθω	to waste, ravage, sack, destroy
περί	around, round about with gen., dat., and acc.
περίαλλος	before all others;
περιβάλλω	to throw round
περιγληνάομαι	to turn round the eyeballs, glare around
περικαλλής	very beautiful
περίκειμαι	to lie round about
περικλάω	to break
περικλειτός	famed all round, farfamed
περιλιχμάομαι	to lick all round
Περιμήδης	
περιμήκης	very tall or long
πέριξ	round about, all round
περί-ξέω	
περιπέλομαι	to move round, be round about
περιπετάννυμι	to spread or stretch around
περίπλεκτος	intertwining, crossing
περί-πλήθω	
περισαίνω	to wag the tail round, fawn upon
περίσπλαγχνος	great-hearted
περισσός	beyond the regular number or size, prodigious
περισταδόν	standing round about
περιστέλλω	to dress, clothe, wrap up
περιστερίς	
περιτρέχω	to run round and round, run round
περίφρων	very thoughtful, very careful, notable
περιώσιος	immense, countless
περόναμα	
περονάω	to pierce, pin
περόνημα	a garment pinned or buckled on
περονητρίς	a robe fastened on the shoulder with a brooch
περρέχε	
Περσεύς	Perseus
Περσήιον	
Πέρσης	a Persian, inhabitant of Persis
πέρυσι	a year ago, last year
πέσσω	to soften, ripen or change
πέταλον	a leaf
πέταλος	broad, flat
πετάννυμι	to spread out
πέταυρον	a perch
πετεινός	able to fly, full fledged
πέτευρον	
πέτομαι	to fly
πέτρα	a rock, a ledge or shelf of rock
πέτρος	a stone
πεύθομαι	
πευκάλιμος	in wise, prudent, sagacious
πεύκη	the pine
πευσεῖσθε	
πεφιλαμένε	
πεφιλάμενον	
πῆ	in what way? how?
πη	in some way, somehow
πηγή	running waters, streams
πήγνυμι	to make fast
πηδάω	to leap, spring, bound
πηκτή	a net or cage set
πηκτίς	an ancient harp
πηκτός	stuck in, fixed
Πηλεύς	Peleus
πῆμα	suffering, misery, calamity, woe, bane
Πηνειός	
πηνίζομαι	to wind thread off a reel
πηός	a kinsman by marriage
πήποκα	
πήρα	a leathern pouch, a wallet, scrip
πηρός	disabled in a limb, maimed
πῆρος	
πῆχυς	the fore-arm
πιαίνω	to make fat, fatten
πῖδαξ	a spring, fountain
πιέζω	to press, squeeze, press tight
πίειρα	fat, rich
Πιερίδες	the Pierides
Πιερίς	
πίθος	a wine-jar
πίθων	a little ape
πικραίνω	to make sharp or bitter
πικράς	
πικρός	pointed, sharp, keen
πίμπλημι	to fill full of
Πίνδος	
πῖνον	
πίνος	dirt, filth
πινυτή	understanding, wisdom
πινυτός	wise, prudent, discreet, understanding
πίνω	to drink
πιπίσκω	to give to drink
πίπτω	to fall, fall down
Πῖσα	Pisa
πισεύς	
πίσσα	pitch
πιστεύω	to trust, trust to or in, put faith in, rely on, believe in
πίτυλος	the measured plash of oars
πίτυρον	the husks of corn, bran
πίτυς	the pine, stone pine
̓πιτύχην	
πιτυώδης	abounding in pines
πίων	fat, plump
πλαγίαυλος	the cross-flute
πλάζω	to make to wander or roam
πλάθανον	a mould
πλακερός	broad
πλανάω	to make to wander, lead wandering about
πλάνος	leading astray, cheating, deceiving
πλάσσω	to form, mould, shape
πλαταγέω	to clap, clap the hands
πλατάγημα	a clapping
πλαταγώνιον	the broad petal of the poppy or anemone
πλατάνιστος	
πλάτανος	the oriental plane
πλατεῖα	
πλατειάζω	to speak or pronounce broadly
πλατεῖον	a tablet
πλάτος	breadth, width
πλατύς	wide, broad
πλέγμα	plaited work, wicker-work
πλείων	more, larger
πλέκος	wicker-work
πλεκτή	a coil, wreath
πλεκτός	plaited, twisted
πλέκω	to plait, twine, twist, weave, braid
πλέος	full.
πλευρά	a rib
πλευρόν	a rib
πλέω	to sail, go by sea
πλέως	full of
πληγή	a blow, stroke
πλήθω	to be or become full of
πλήν	more than
πλήρης	filled or infected by
πληρόω	to make full
πλησίος	near, close to
πλήσσω	to strike, smite
πλίνθον	
πλίνθος	a brick
πλοκαμίς	a lock or braid of hair
πλόος	a sailing, voyage
Πλοῦτος	
πλοῦτος	
πλύνω	to wash, clean
πνεῦμα	a blowing
πνεύμων	the organ of
πνευστικός	
πνέω	to blow
πνοή	a blowing, blast, breeze
πόα	grass, herb
ποδεών	the ragged ends
ποδίς	
ποθεινός	longed for, desired, much desired
πόθεν	whence?
ποθεν	from some place or other
ποθέρπει	
ποθέω	to long for, yearn after
ποθή	fond desire for
πόθι	where?
ποθι	anywhere or somewhere
ποθορεῦσα	
ποθορῇ	
ποθόρημι	
ποθόρησθα	
πόθος	a longing, yearning, fond desire or regret
ποιέω	to make
ποιητής	one who makes, a maker
ποιητός	made
ποικίλος	many-coloured, spotted, mottled, pied, dappled
ποικιλότραυλος	twittering in various notes
ποιμαίνω	to be shepherd
ποιμενικός	of or for a shepherd
ποιμήν	
ποίμνη	a flock
ποίμνιον	a flock
ποίμνιος	
ποιολογέω	to gather corn into sheaves
ποιός	of a certain nature, kind or quality
ποῖος	of what nature? of what sort?
ποκάς	
ποκίζω	to shear wool
πόκος	wool
πολεμίζω	to wage war, make war, fight
πολεμιστής	a warrior, combatant
πόλεμος	battle, fight, war
πολέω	to go about, range over
πολίζω	to build a city, to build
πόλιον	
πολιός	gray, grizzled, grisly
πόλις	a city
πολίτης	a member of a city or state
πόλλα	
πολλάκις	many times, often, oft
πολύβοτρυς	abounding in grapes
Πολυβώτης	
πολύγναμπτος	much-bent, much-twisting
πολυδένδρεος	
πολύδενδρος	with many trees, abounding in trees
Πολύδευκες	
Πολυδεύκης	Pollux
πολυειδής	of many kinds
πολύεργος	much-working
πολύιδρις	of much knowledge, wisdom, shrewdness
πολύκαρπος	rich in fruit
πολυκήτης	full of monsters
πολύκληρος	of a large lot, with a large portion
πολυμήχανος	full of resources, inventive, ever-ready
πολύμοχθος	much-labouring, suffering many things
πολύμυθος	of many words
πολύναος	with many temples
πολυπίδακος	
πολυπῖδαξ	with many springs, many-fountained
πολύρραπτος	
πολύρραφος	well-stitched
πολύρρηνος	rich in sheep
πολύς	many
πολύσιτος	abounding in corn
πολύσταχυς	rich in ears of corn
πολύστονος	much-sighing, mournful
πολύφαμος	
πολύφημος	abounding in songs and legends
πολύφιλτρος	suffering from many love-charms, love-sick
πολυχανδής	wide-yawning
πολύχορδος	many-stringed
πολυώδυνος	very painful
πολυώνυμος	having many names
πομπεύς	one who attends or escorts, a conductor, guide
πομπεύω	to conduct, escort
πομπή	conduct, escort, guidance
πονέω	to work hard, do work, suffer toil
πονηρός	toilsome, painful, grievous
πόνος	work
ποντίζω	to plunge in the sea
ποντοπόρην	
πόντος	the sea
Πόντος	
ποπάνευμα	
πόποι	oh strange! oh shame!
ποππύζω	to whistle, cheep or chirp
ποππυλιάζω	
πορθμεύς	a ferryman
πόρος	a means of passing a river, a ford, ferry
πόρτις	a calf, young heifer
πορφύρεος	darkgleaming, dark;
πορφύρω	gleams darkly
πόρω	to furnish, offer, present, give
Ποσειδεών	
πόσις	
πόσος	bulk)
πότ	
ποταμός	a river, stream
ποτάομαι	to fly about
ποταῷον	
ποτέ	at some time or other, at some time
πότε	when? at what time?
πότερος	whether of the two?
ποτή	flight
πότης	a drinker, tippler, toper
ποτίδην	
ποτίζω	to give to drink
ποτίκρανον	a cushion
πότιμος	drinkable, fresh
ποτιπτύσσω	
πότις	
πότμος	that which befals one, one's lot, destiny
πότνα	
πότνια	mistress, queen
ποτόν	
ποτός	drunk, fit for drinking
πότος	drinking, a drinking-bout, carousal
πού	anywhere, somewhere
πούς	a foot
πρᾶν	
Πραξινόα	
Πραξιτέλης	
πράσσω	to pass over
πράτης	
πρᾶτος	
πρέμνον	the bottom of the trunk of a tree, the stump
πρέμνος	
πρέπω	to be clearly seen, to be conspicuous
πρέσβυς	an old man
πρεσβῦτις	an aged woman
Πριαμίδης	son of Priam
Πριαμικός	of or like Priam
Πριαμίς	
Πρίαμος	Priam
Πρίαπος	Priapus
πρίν	comparative
πρῖνος	the evergreen oak, ilex
πρό	before
προβλώσκω	to go or come forth, to go out of the house
προβόλαιος	held out before
προβολεύς	
προβολή	a putting forward
προγένειος	with prominent chin, long-chinned
προγενής	born before, primaeval
προγίγνομαι	to come forwards
πρόγονος	a forefather, ancestor
προδείελος	before evening
προδείκνυμι	to shew by way of example
πρόειμι	
προεξέδρα	a chair of state
προέχω	to hold before
πρόθυρον	the front-door, the door leading from the
προιάλλω	to send forth, dismiss
προίημι	to send before, send on or forward
προλέγω	
προπάροιθε	before, in front of
πρόπας	all
προπίνω	to drink before
προπίπτω	to fall or throw oneself forward
Προποντίς	the fore-sea
πρός	motion from
προσάγω	to bring to or upon
προσᾴδω	to sing to
προσαμείβομαι	to answer
προσαμέλγομαι	to yield milk besides
πρόσ-αὐλέω	
προσβλέπω	to look at or upon
προσδέρκομαι	to look at, behold
προσδέω	
προσεῖδον	to look at or upon
πρόσειμι	
προσεῖπον	to speak to
προσέοικα	to be like, resemble
προσερίζω	to strive with or against
προσέρχομαι	to come or go to
προσέσπερος	towards evening
προσέχω	to hold to, offer
προσήκω	to have arrived at
πρόσθεν	before
προσθέω	to run towards or to
πρόσθη	
προσκάρδιος	at the heart
προσκιγκλίζομαι	to wag one's tail
πρόσκρανον	
πρόσ-κρίνω	
προσλέγομαι	to lie beside
προσμάσσω	to knead
προσμυθέομαι	to address, accost
προσνήχομαι	to swim towards
πρόσοδος	a going or coming to, an approach
προσόζω	to smell of, be redolent of
πρόσορθρος	towards morning
προσπνέω	to breathe upon, inspire
προσρέω	to flow towards a point, to stream in, assemble
προστάς	
προστίθημι	to put to
πρόσφημι	to speak to, address
προσφιλής	dear, beloved
προσφύω	to make to grow to
προσχεθεῖν	to hold before
πρόσω	forwards, onwards, further
πρόσωπον	the face, visage, countenance
προτερέω	to be before, be in advance
πρότερος	prae.
προτέρωσε	toward the front, forward
πρόφασις	that which is alleged as the cause, an allegation, plea
προφερής	carried before, placed before, excelling
προφέρω	to bring before
προφεύγω	to flee forwards, flee away
προφθάνω	to outrun, anticipate
πρόφρων	with forward mind
πρύμνα	the hindmost part of a ship, the stern, poop
πρυτανεῖον	the presidents' hall, town-hall
πρυτάνειος	
πρώην	lately, just now
πρωιζός	the day before
πρώξ	a dewdrop
πρῴραθεν	from the ship's head, from the front
Πρωτεύς	
πρώτιστος	the very first, first of the first
πρῶτος	
πρωτοτόκος	bearing her first-born
πταίω	to make to stumble or fall
πτελέα	the elm
Πτελεατικόν	
Πτερέλαος	
πτέρις	
πτέρνα	the heel
πτέρνη	
πτερόν	feathers
πτέρυξ	the wing
πτοέω	to terrify, scare
Πτολεμαῖος	
πτολίεθρον	
πτύον	a winnowing-shovel or fan
πτύω	to spit out or up
πτώξ	the cowering animal
πυγμάχος	one who fights with the fist, a boxer
πυγμή	a fist
Πυθαγορικτάς	
Πύθιος	Pythian
πυθμήν	the hollow bottom or stand of a cup
πύθω	to make rot, to rot
πυκάζω	to make close, cover or wrap up, enwrap
πυκινός	
πυκνός	close, compact
πυκνόω	to make close or solid, to pack close
πύκτης	a boxer, pugilist
πυλάρτης	gate-fastener, he that keeps the gates of hell
πύλη	one wing of a pair of double gates
Πύλος	Pylos
πύματος	hindmost, last
πυνθάνομαι	to learn by hearsay or by inquiry
πύξ	with clenched fist
Πύξας	
πύξινος	made of box-wood
πῦρ	fire
πυρά	watch-fires
πύργος	a tower
πυρεῖον	pieces of wood
πυρεύς	a fire-proof vessel
πυρή	any place where fire is kindled
πυρναῖος	fit for eating
πυρός	wheat
πυροφόρος	wheat-bearing
πυρόω	to burn with fire, burn up
Πύρρα	
πυρρίχος	
πυρρός	flame-coloured, yellowish-red
Πύρρος	
πυρρότριχος	
πυρσός	a firebrand, torch
πω	up to this time, yet
πώγων	the beard
πῶλος	a foal, young horse
πῶμα	
πως	in any way, at all, by any means
πῶς	how? in what way or manner?
πωτάομαι	to fly about
πῶυ	a flock
Παιδικά	
ῥ'	
ῥαγίζω	to gather grapes
ῥαδινός	slender, taper
ῥᾴδιος	easy, ready, easy to make or do
ῥαίδιον	
ῥαίνω	to sprinkle, besprinkle
ῥάιος	
ῥαίω	to break, shiver, shatter, wreck
ῥάμνος	
ῥάχις	the lower part of the back, the chine
̔Ρέα	
ῥέζω	to do, act, deal
ῥέθος	a limb
ῥεῖα	easily, lightly
ῥεῖθρον	that which flows, a river, stream
ῥείτης	
ῥέον	
ῥέω	to flow, run, stream, gush
ῥῄδιος	
ῥῆμα	that which is said or spoken, a word, saying
̔Ρήναιαν	
ῥιγέω	to shiver or shudder with cold
ῥίζα	a root
ῥινός	the skin
ῥίον	any jutting part
ῥίπτω	to throw, cast, hurl
ῥίς	the nose
ῥοδόεις	of roses
ῥοδόμηλον	a rose-apple
ῥόδον	the rose
̔Ροδόπαν	
ῥοδόπηχυς	rosy-armed
ῥοδόχρως	
ῥοικός	crooked
ῥόμβος	a spinning-top or wheel
ῥόον	
ῥόος	a stream, flow, current
ῥόπαλον	a club, cudgel
ρος	
ῥύγχος	a snout, muzzle
ῥυθμός	measured motion, time, rhythm
ῥύομαι	to draw to oneself
ῥύπον	
ῥύπος	dirt, filth, dirtiness, uncleanness
ῥύσοι	
ῥωγάς	ragged
σαίρω	to draw back the lips and shew the teeth, to grin
σακεσπάλος	
σάκκος	a coarse hair-cloth, sackcloth
σακός	
σάκος	a shield
Σάμιος	
Σάμος	Samos
σάν	
σάνδαλον	a wooden sole
σάος	
σαρδόνιον	the rope sustaining the upper-edge of a hunting-net
σαρδόνιος	
Σαρδώ	Sardinia
σαρκάω	
σάρκινος	of flesh, in the flesh
σαρκίς	
σάρξ	flesh
σάττω	to pack or load
σατυρίσκε	
Σατυρίσκος	
Σάτυρος	a Satyr
σαύρα	a lizard
σαῦρος	
σαυτοῦ	
σάφα	
σβέννυμι	to quench, put out
σέβας	reverential awe, a feeling of awe
σέβομαι	to feel awe or fear
σέγε	
σεῖος	
σείω	to shake, move to and fro
Σελάναπᾶσα	
σέλας	a bright flame, blaze, light
σεληναίη	
σελήνη	the moon
σέλινον	parsley
Σεμέλη	
Σεμίραμις	
σεύω	to put in quick motion: to drive, hunt, chase away
σηκίτης	kept in the fold, sucking
σηκός	a pen, fold
σηκόω	to weigh, balance
σῆμα	a sign, mark, token
σημαίνω	to shew by a sign, indicate, make known, point out
σήμερον	to-day
σῆραγξ	a hollow rock, cave
σής	a moth
σθένος	strength, might
Σιβύρτα	
σιγάζω	to bid
σιγάω	to be silent or still, to keep silence
σιγή	silence
σιδαρίω	
σιδηρεία	a working in iron
σιδήρειος	
σιδήρεος	made of iron or steel, iron
σίδηρον	
σίδηρος	iron
σιδηρόω	to overlay with iron
σίζω	to hiss
Σικελίδης	Sicilian
Σικελός	Sicilian, of or from Sicily
Σιμαίθα	
σίμβλος	a beehive
Σιμιχίδᾳ	
Σιμιχίδα	
Σιμόεις	the
Σῖμος	flat-nose
σιμός	snub-nosed, flat-nosed
σίνομαι	to do
σισύρα	a cloak of goats-hair
Σισυφίς	
σιτέομαι	to take food, eat
σιτίζω	to feed, nourish, fatten
σῖτος	corn, grain
σίττα	off; sht! chit!
σίττη	
σίττος	
σκαιός	side
σκαίρω	to skip, frisk
σκανᾶς	
σκαπάνη	a digging tool, mattock
σκαφίς	a bowl, milk-pail
σκέλλω	to dry, dry up, make dry, parch
σκέλος	the leg
σκεπάζω	to cover, shelter
σκεπάω	to cover, shelter
σκέπτομαι	to look about, look carefully
σκιά	a shadow
σκιαρός	
σκιάς	any thing serving as a shade, a canopy, pavilion
σκιερός	shady, giving shade
σκίλλα	a squill, sea-onion
σκιρτασεῖτε	
σκληρός	hard
σκνιφαῖον	
Σκόπαδαι	
σκοπιά	a lookout-place, a mountain-peak
σκοπιάζω	to look about one, spy from a high place or watchtower
σκοπός	one that watches, one that looks after
σκότος	darkness, gloom
σκύζομαι	to be angry or wroth with
Σκυθικός	Scythian
σκύλαξ	a young dog, whelp, puppy
σκύλος	a skin, hide
σκύμνος	a cub, whelp
σκύταλον	
σκύταλος	
σκύφος	a cup, can
σκώψ	owl
σμᾶμα	
σμῆνος	a beehive
σμίκρας	
σοβαρός	scaring birds away: —
σός	thy, thine, of thee
σόφα	
σοφία	skill
σόφισμα	any skilful act, the skilful dressing of food
σοφιστής	a master of one's craft or art, an adept
σοφός	skilled in any handicraft or art, cunning in his craft
Σπάρτη	Sparta
σπάω	to draw
σπεῖρα	coiled
σπείρω	to sow
σπένδω	to pour or make a drink-offering
σπέρχω	to set in rapid motion
σπεύδω	to set a-going, to urge on, hasten, quicken
σπήλυγγα	
σπιλάς	a rock over which the sea dashes, a ledge of rock
σπλάγχνον	the inward parts
σποδός	wood-ashes, embers
σπόριμος	sown, to be sown, fit for sowing
σπόρος	a sowing
σπουδάζω	to make haste
σπουδή	haste, speed
σπυράς	a ball of dung
στάζω	to drop, let fall or shed drop by drop
σταθμάω	to measure by rule
στάθμη	a carpenter's line
σταθμόν	
σταθμός	a standing place
σταθμόω	to form an estimate, to judge or conclude by or from
στάλιξ	a stake to which nets are fastened
σταφίς	
σταφυλή	a bunch of grapes
σταφυλίς	a bunch of grapes
στάχυς	an ear of corn
στέγος	a roof
στείβω	to tread on, tread under foot
στείνω	to straiten
στεῖρα	
στείχω	to walk, march, go or come
στενάχω	to sigh, groan, wail
στενός	narrow, strait
στένω	to moan, sigh, groan
στέργω	to love
στερεός	stiff, stark, firm, solid
στερεόω	to make firm or solid
στέρνον	the breast, chest
στεφανηφόρος	wearing a crown or wreath, crowned
στέφανος	that which surrounds
στεφανόω	to be put round
στέφω	to put round
στῆθος	the breast
στήλη	a block of stone
στιβαρός	compact, strong, stout, sturdy
στιβάς	a bed of straw, rushes
στίζω	to mark with a pointed instrument, to tattoo
στίλβω	to glisten
στίλβων	
στιχάομαι	to march in rows or ranks
στόμα	the mouth
στομαλίμνη	a salt-water lake, estuary
στομάλιμνον	
στόρεννυμι	
στράπτω	to lighten
στρατιώτης	a citizen bound to military service;
στρεπτός	flexible, pliant
στρέφω	to turn about or aside, turn
στρόμβος	a body rounded or spun round
στυγνός	hated, abhorred, hateful
στυγνόω	to make gloomy
στῦμα	
στύμα	
στωμύλος	mouthy, wordy, talkative, chattering, glib
σύ	
Συβαρίτης	a Sybarite
Συβαρίτιδος	
Συβαρῖτις	
συγγράφω	to write or note down
σύκινος	of the fig-tree
σῦκον	the fruit of the
συλάω	to strip off
σύλη	the right of seizing the ship or cargo
συμβαίνω	to stand with the feet together
συμβάλλω	to throw together, dash together
συμμαχέω	to be an ally, to be in alliance
συμπαίζω	to play or sport with
σύμπας	all together, all at once, all in a body
συμπήγνυμι	to put together, construct, frame
συμπλέκω	to twine or plait together
συμπλήγδην	with clapping of hands
συμφέρω	to bring together, gather, collect
συμφλέγω	to burn to cinders
σύμφορος	happening with, accompanying
συμφύρω	to knead together: beat black and blue
σὐν	
σύν	along with, in company with, together with
συναγείρω	to gather together, assemble
συνάγω	to bring together, gather together, collect, convene
συνᾴδω	to sing with or together
συναλοάω	to thresh out together, to grind to powder, crush, shiver
συνάμα	together
συνάντομαι	to fall in with, meet
συνάπτω	to tie or bind together, to join together, unite
συνδρομάς	
σύνειμι	
συνεπάγω	to lead together against
συνέπομαι	to follow along with, follow closely
συνεράω	
συνερείδω	to set firmly together
συνεχής	holding together
συνιζάνω	to sink in, collapse
σύν-λάπτω	
σύν-λέγω	
σύννομος	feeding together, gregarious
συνομαίμων	one of the same blood, a brother or sister
συνομῆλιξ	a comrade
σύνοφρυς	with meeting eyebrows
Σύρα	a Syrian woman
Συρακοσία	the territory of Syracuse
Συρακόσιος	Syracusan
Συρακόσσαις	
Συρακούσιος	
Συρία	Syria
συριγκτά	
συριγκτάν	
συριγκτάς	
σῦριγξ	a pipe
συρίζω	to play the σῦριγξ, to pipe
Σύριος	of or from Syria
Σῦρος	Syros
σύρω	to draw, drag
σφάζω	to slay, slaughter
σφαιρόω	to make spherical
σφάλλω	to make to fall, throw down, overthrow
σφεῖς	they
σφένεϊ	
σφέτερος	their own, their
σφήξ	a wasp
σφίγγω	to bind tight, bind fast
σφός	their, their own, belonging to them
σφριγανός	
σφύζω	to throb, beat
σφυρήλατος	wrought with the hammer, beaten out
σφυρόν	the ankle
σφωίτερος	of you two
σχαδών	a honey-cell
σχεδία	a raft, float
σχέδιος	hand to hand, in or for close combat
σχεδόν	close, near, hard by, nigh
σχέθω%	
σχέτλιος	unwearying
σχῆμα	form, figure, appearance
σχίζα	a piece of wood cleft off, a lath, splinter
σχίζω	to split, cleave
σχῖνος	the mastich-tree
σχοινίς	
σχοῖνος	a rush
σχολή	spare time, leisure, rest, ease
σώζω	to save, keep
σῶμα	the body
σωρός	a heap
σῶς	safe and sound, alive and well, in good case
σωτήρ	a saviour, deliverer, preserver
σώφρων	of sound mind
ταλαεργός	enduring labour, drudging
τάλαντον	a balance
ταλαρίσκος	quasillus
τάλαρος	a basket
τάλας	suffering, wretched
ταλασίφρων	patient of mind, stout-hearted
ταμεσίχροος	
τάμισος	rennet
τᾶμος	
τᾶν	sir, my good friend
τανίκα	
τανύφλοιος	with long-stretched bark
τανύφυλλος	with long-pointed leaves
τανύω	to stretch, strain, stretch out
τάπης	a carpet, rug
ταράσσω	to stir, stir up, trouble
ταρβέω	to be frightened, alarmed, terrified
τάρβος	fright, alarm, terror
ταρσός	a stand or frame of wicker-work, a crate
τάσσω	to arrange, put in order
ταῦρος	a bull
ταὐτάζω	
ταύτῃ	in this way.
ταὐτός	
τάφρος	a ditch, trench
τάχα	quickly, presently, forthwith
ταχέως	
ταχινός	
τάχος	swiftness, speed, fleetness, velocity
ταχυπειθής	soon persuaded, credulous
ταχύπωλος	with fleet, swift horses
ταχύς	quick, swift, fleet
τε	and
τεθλασμένος	
τεθνάκαμες	
τεθνειῶτος	
τέθριππος	with four horses abreast, four-horsed
τεῖδ'	
τεῖδε	
τείνω	
Τειρεσίης	
τείρω	to rub hard
τεῖχος	a wall
τεκν	
τέκνον	that which is borne or born, a child
τεκνόω	to furnish or stock with children
τέκος	the young
τέκτων	any worker in wood
τελαμών	a broad strap for bearing
Τελαμών	
τελέθω	to come into being, to be quite or fully
τέλειος	having reached its end, finished, complete
τελέω	to complete, fulfil, accomplish
τέλλω	to make to arise, accomplish
τέλος	the fulfilment or completion
τέμνω	to cut, hew
τέμπεα	
τέος	
τεός	
τέρας	a sign, wonder, marvel
τέρμινθος	the terebinth or turpentine tree
τερπνός	delightsome, delightful, pleasant, agreeable, glad
τέρπος	
τέρπω	to satisfy, delight, gladden, cheer
τέρσομαι	to be or become dry, to dry up
τέρψις	enjoyment, delight
τέσσαρες	four
τέταρτος	fourth
τέτμον	to overtake, reach, come up to, find
τετορταῖος	
τετράενες	
τετράκις	four times
τετράπολος	turned up or ploughed four times
τέττιξ	a
τευς	
τεῦχος	a tool, implement
τεύχω	to make ready, make, build, work
τέφρα	ashes
τέχνη	art, skill, craft in work, cunning of hand
Τέως	
τῇ	here, there
τῇδε	here, thus
τήκω	to melt, melt down
τῆλε	at a distance, far off, far away
τηλεθάω	luxuriant-growing, blooming, flourishing
Τήλεμος	
τηλέφιλον	faraway-love, love-in-absence
τηλίκος	of such an age, so old or so young
τηλόθεν	from afar, from a foreign land
τηλόθι	
τηλοῦ	afar, far off or away, in a far country
τηλύγετος	an only child, a darling child
τημόσδε	
τηνεῖ	there
τηνόθι	in that case, then
τῆνος	he, she, it
τηνῶ	there
τηνῶθεν	
τηρέω	to watch over, protect, guard
τηύσιος	idle, vain, undertaken to no purpose
τίθημι	to set, put, place
τίκτω	to bring into the world
τίλλω	to pluck or pull out
Τιμαγήτοιο	
τίματα	
τιμάω	to pay honour to, hold in honour, to honour, revere, reverence
τιμή	that which is paid in token of worth or value
τίμιος	valued
τινάσσω	to shake or brandish
τίνω	to pay a price
τίπτε	
Τίρυνς	
τις	any one, any thing, some one, some thing;
τίς	who? which?
Τιτυός	Tityus
Τίτυρος	
τιτύσκομαι	to make, make ready, prepare
τῖφος	standing water, a pond, pool, marsh
τίω	to pay honour to
τλάω	to take upon oneself, to bear, suffer, undergo
τλήμων	suffering, enduring, patient, stout-hearted
τμητός	cut, shaped by cutting
τόγ'	
τόγε	
τόθι	there, in that place
τοι	let me tell you, surely, verily
τοιγάρ	so then, wherefore, therefore, accordingly
τοίγε	
τοῖος	quality, such, such-like
τοιόσδε	such a
τοιοῦτος	such as this
τοίς	
τοῖχος	the wall of a house or court
τοκάς	of or for breeding
τοκέεσσιν	
τοκεύς	one who begets, a father
τόκος	a bringing forth, childbirth, parturition
τολμάω	to undertake, take heart
τομάς	
τομή	the end left after cutting, the stump
τομός	cutting
τόξον	a bow
τόσος	so great, so vast
τοσόσδε	so strong, so able
τοσσῆν'	
τοσσῆνον	
τότα	
τότε	at that time, then
τουτεῖ	
τουτόθε	
τουτόθεν	hence, thence
τουτῶθεν	
τραγεῖαι	
τραγίσκος	a young he-goat
τράγος	a he-goat
τράγω	
τράπεζα	four-legged a table
τραῦμα	a wound, hurt
τραφερός	well-fed
τράχηλος	the neck, throat
Τραχίνιος	
Τραχίς	Trachis
τραχύς	rugged, rough
τρεῖς	
τρέπω	to turn or direct
τρέφω	to thicken or congeal
τρέχω	to run
τρέω	to flee from fear, flee away
τρητός	perforated, with a hole in it
τριακοντάζυγος	with thirty benches
τριακόσιοι	three hundred
τριάς	the number three, a triad
τρίβος	a worn or beaten track, the high road, highway
τρίβω	to rub: to rub or thresh
τρίγαμος	
τριέτης	of or for three years
Τρινακρία	Sicily
Τρινάκριος	
τρίοδος	a meeting of three roads
τριόδους	with three teeth, three-pronged
Τρίοπον	
τρίπολος	thrice ploughed
τρίπους	three-footed, of or with three feet
τρίς	thrice, three times
τρισκαιδεκάπηχυς	thirteen cubits high
τρισκελής	three-legged
τρισμυσαρά	
τρισσός	threefold
τρίταιον	
τρίτος	the third
τριφίλητος	thrice-beloved
Τροία	Troy
τρομερός	trembling
τρομέω	to tremble, quake, quiver
τρόπος	a turn, direction, course, way
τροφός	a feeder, rearer, nurse
τροχάζω	to run like a wheel, to run along, run quickly
τροχός	anything that runs round
τρυγάω	to gather in
τρύγη	ripe fruit, a grain-crop, corn
τρύγος	
τρυγών	the turtle-dove
τρύζω	
τρύξ	new wine not yet fermented, wine with the lees in it, must
τρυφάλεια	a helmet
τρυφερός	delicate, dainty
τρύχνος	nightshade
τρώγω	to gnaw, nibble, munch
τρώξιμος	
τυγχάνω	to hit
Τυδεύς	Tydeus
τυῖδε	here
τυκτός	created
τυλόω	to make knobby
τύμβος	a sepulchral mound, cairn, barrow
τύμμα	a blow
Τυνδάρεος	Tyndareos or Tyndarus
τυννός	so small, so little
τύπτω	to beat, strike, smite
τυρόεις	like cheese
τυρός	cheese
τυτθός	little, small
τυφλός	blind
τύφω	to raise a smoke
τῷ	therefore, in this wise, thereupon
τώγ'	
τώγε	
τωθάζω	to mock, scoff or jeer at, flout
τώς	so, in this wise
τῶὐβουλοιο	
ὑακίνθινος	hyacinthine
ὑάκινθος	the hyacinth
ὑβρίζω	to wax wanton, run riot
ὕβρις	wantonness, wanton violence or insolence
ὑγιής	sound, healthy, hearty, sound in
ὑγρός	wet, moist, running, fluid
ὐδάτινα	
ὑδατόεις	watery, like water
ὕδωρ	water
̔Υετίδος	
υἱός	A son
υἱωνή	
υἱωνός	a grandson
̔́Υλα	
ὑλαγμός	a barking, baying
ὑλαῖος	of the forest, savage
ὑλακτέω	to bark, bay, howl
̔́Υλαν	
ὑλάοντες	
̔́Υλας	
ὑλάω	to howl, bark, bay
Ὕλη	
ὕλη	forest-trees
ὑλήεις	woody, wooded
ὑλητόμος	
ὗλις	
ὐμαλίκων	
ὑμάρτη	
̔Υμέναιε	
ὑμέναιος	hymenaeus, the wedding or bridal song
ὑμεναιόω	to sing the wedding-song
̔Υμήν	
̔Υμῖν	
ὔμμος	
̔Υμνέομεν	
ὑμνέω	to sing, laud, sing of
ὕμνος	a hymn, festive song or ode, in praise
ὕμοιος	
ὑπακούω	to listen, hearken, give ear
ὑπαντάω	to come or go to meet
ὑπάρχω	to begin, make a beginning
ὕπατος	supremus, the highest, uppermost
ὕπειμι	
ὑπέκ	out from under, from beneath, away from
ὑπένερθε	underneath, beneath
ὑπεξαναβαίνω	to step suddenly back
ὑπεξαναδύομαι	to come up from under, emerge
ὑπέρ	over, above, w. gen, over, beyond, w. acc.
ὑπεραχθής	overburdened
ὑπερβαίνω	to step over, mount, scale
ὕπερθεν	from above
ὑπεροπλία	overweening confidence in arms, proud defiance, presumptuousness
ὑπέροπλος	proudly trusting in force of arms, defiant, presumptuous
ὑπερόπτης	a contemner, disdainer of
ὑπερόριος	over the boundaries or confines, living abroad
ὑπέροχος	prominent, eminent, distinguished above
ὑπερπηδάω	to leap over
ὑπέρ-πωτάομαι	
ὑπέρτερος	over or above, upper
ὑπερφίαλος	overbearing, overweening, arrogant
ὑπηνέμιος	lifted or wafted by the wind
ὑπήνεμος	under the wind, under shelter from it
ὑπήνη	the hair on the under part of the face, the beard
ὑπνάω	to sleep
ὕπνον	
ὕπνος	sleep, slumber
ὑπνόω	to put to sleep
ὑπό	from under, by, c. gen. under, c. dat., towards c. acc.
ὑπό-δάμνημι	
ὑποδείκνυμι	to shew secretly
ὑποδέχομαι	to receive beneath
ὑπόδροσος	somewhat moistened or dewy
ὑπό-δρύπτω	
ὑποκάρδιος	in the heart
ὑποκόλπιος	under the folds of the robe
ὑποκρίνομαι	to reply, make answer, answer
ὑπολαμβάνω	to take up by getting under
ὑπομάσσω	to smear or rub underneath
ὑπομένω	to stay behind, survive
ὑπομιμνάσκων	
ὑπονύσσω	to prick or sting underneath
ὑποπτεύω	to be suspicious
ὑπότροπος	returning
ὑποφαίνω	to bring to light from under
ὑποφήτης	a suggester, interpreter, a priest who declares an oracle
ὑποφῆτις	
ὕπτιος	laid back, laid on one's back
ὑπωλένιος	under the elbow
ὑπωρόφιος	under the roof, in the house
ὗς	the wild swine
ὑσμίνη	a fight, battle, combat
ὕσπληγξ	a rope drawn across the racecourse, let down when the runners were to start, the starting-line
ὕστατος	
ὕστερον	
ὕστερος	latter, last
ὑφαίνω	to weave
ὑφή	a web
ὑφηγέομαι	to go just before, to guide, lead
ὑφίημι	to let down
ὑφίστημι	to place or set under
ὑφορβός	
ὑψηλός	high, lofty, high-raised
ὕψιστος	highest, loftiest
ὑψίτερος	loftier
ὑψόθε	
ὑψόθεν	from on high, from aloft, from above
ὑψόθι	aloft, on high
ὕω	to send rain, to rain
φάβα	
φαγεῖν	to eat, devour
φαγός	a glutton
φαέθω	to shine
φαίδιμος	shining
φαινόλις	light-bringing
φαίνω	to bring to light, make to appear
φακός	lentil
φάλαγξ	a line of battle, battle-array
Φάλαρος	
φάλαρος	having a patch of white
φάλητι	
Φανοτῆι	
φάντασμα	an appearance, phantasm, phantom
φάος	light, daylight
φαρέτρα	a quiver
φαρμακεύτρια	
φαρμακόεις	
φάρμακον	a drug, medicine
φάρμακος	
φάρυγξ	the throat, gullet
φάσγανον	a sword
Φᾶσιναἰετος	
Φᾶσις	the river Phasis
φάσκω	to say, affirm, assert
φάσσα	a wild pigeon, ringdove
φάτης	
φάτις	a voice from heaven, the voice of an oracle, an oracle
φάτνη	a manger, crib, feeding-trough
φαῦλος	easy, slight
φέγγος	light, splendour, lustre
Φεἰδευ	
φείδομαι	to spare
φειδώ	a sparing
φέρβω	to feed, nourish
φέριστος	
φέρτατος	bravest, best
φέρω	to bear
φεῦ	ah! alas! woe!
φεύγω	to flee, take flight, run away
φεύζω	to cry
φήμη	a voice from heaven, a prophetic voice
φημί	to declare, make known
φθάνω	to come or do first or before
φθέγγομαι	to utter a sound or voice
φθεγξεῖται	
φθίω	to decay, wane, dwindle
φθονερός	envious, jealous, grudging
φθόρος	a pestilent fellow
φιερώτατος	
φιλαίτερος	
Φιλαμμονίδας	
φιλάοιδος	fond of singing
φιλάργυρος	fond of money, covetous
φίλασε	
φιλάσεις	
φίλασεν	
φίλασον	
φιλάσω	
φιλέριθος	fond of wool-spinning
φιλεχθής	
φιλέω	to love, regard with affection
φίλημα	a kiss
φίλησις	a feeling of affection
φιλητής	
φιλήτης	
φιλητός	to be loved, worthy of love
φιλικός	of or for a friend, befitting a friend, friendly
Φιλῖνος	
Φιλίστη	
φιλοθρηνής	
Φιλοίτιος	
φιλοῖφα	
φιλοκέρδεια	love of gain, greed
φιλοκέρτομος	fond of jeering
φιλόμουσος	loving the Muses
φιλόξενος	loving strangers, hospitable
φιλόπαις	loving its young
φιλοποίμνιος	loving the flock
φιλοπόλεμος	fond of war, warlike
φῖλος	
φίλος	loved, beloved, dear
φιλόστοργος	loving tenderly, affectionate
φιλότης	friendship, love, affection
φίλτατος	
φίλτρον	a love-charm
φίλυπνος	
φίλων	
Φιλώνδα	
φλάσσαιμι	
φλασσῶ	
φλιά	the doorposts, jambs
φλίβω	
φλόγεος	burning, flaming
φλογερός	flaming, fiery-red
φλογίς	
φλοιός	the bark
φλόξ	a flame
φοβαθῇς	
φοβερός	fearful
φοβέω	to put to flight
φοιβάω	to cleanse, purify
Φοῖβος	
φοινίκεος	purple-red, purple or crimson
Φοινίκη	
φοινικόλοφος	purple or crimson-crested
Φοῖνιξ	a Phoenician
φοῖνιξ	a purple-red, purple or crimson
φοίνιος	of or like blood, blood-red, red
φοινίσσω	to redden, make red
φοιτάω	to go to and fro, up and down, to stalk
Φόλος	
φονεύς	a murderer, slayer, homicide
φονεύω	to murder, kill, slay
φόνος	murder, homicide, slaughter
φορά	a carrying
φορεῖταιἀρχετε	
φορέω	to bear or carry constantly, to be used to carry
φόρμιγξ	the phorminx
φορμός	a basket for carrying
Φορωνείδης	
φραγμός	a fencing in, blocking up
φραδάζω	to make known
φραδή	understanding, knowledge
φράζω	to point out, shew, indicate
Φρασίδαμος	
Φρασιδάυω	
φράσσω	to fence in, hedge round
φρενόω	to make wise, instruct, inform, teach
φρήν	the midriff or muscle which parts
φριμάσσομαι	to snort and leap about, to neigh and prance
φρίσσω	to be rough or uneven on the surface, to bristle
φρονέω	to think, to have understanding, to be sage, wise, prudent
φροντίζω	to think, consider, reflect, take thought, have a care, give heed
φροντίς	thought, care, heed, attention
φρόντισις	
φρουρέω	to keep watch or guard
φρυγία	
φρύγιον	
Φρύγιος	Phrygian, of, from Phrygia
φρύγω	to roast or fry
Φρύξ	a Phrygian
φυγάς	one who flees
φυγή	flight
φυή	growth, stature
φυκία	
φυκιόεις	full of sea-weed, weedy
φυκίον	rouge
φῦκος	rouge
φυλάζω	to divide into tribes
φυλακός	
φυλάσσω	to keep watch and ward, keep guard
Φυλεύς	
φύλλινος	of or from leaves, made of leaves
φύλλον	a leaf;
φυλλόστρωτος	strewed or covered with leaves
φύλοπις	the battle-cry, din of battle, battle
φύος	
φύρω	to mix
φυσάω	to puff or blow up, distend
φυσιγνώμων	
Φύσκος	
φυτόν	that which has grown, a plant, tree
φύτον	
φυτός	shaped by nature, without art
φυτοσκάφος	digging round plants
φύω	to bring forth, produce, put forth
φώκη	a seal
φωλάς	lurking in a hole
φωλεύω	to lurk in a hole or den
φωνᾶσαι	
φωνέω	to produce a sound or tone
φωνή	a sound, tone
φώς	a man
χἁ	
χαἱ	
χαίρω	to rejoice, be glad, be delighted
χαίτη	long, flowing hair
χάλαζα	hail
χαλαῖς	
χάλασις	a slackening, loosening
χαλάω	to slacken, loosen
χαλεπαίνω	to be severe, sore, grievous
χαλεπός	hard to bear, painful, sore, grievous
χαλέπτω	to oppress, depress, crush
χαλέπω	
χαλέπως	
χἁλίκα	
χαλκεία	smith's work
χάλκειος	of copper or bronze, brasen
χαλκεοθώραξ	with brasen breastplate
χαλκεοκάρδιος	with heart of brass
χάλκεος	of copper or bronze, brasen
χαλκίον	a copper vessel, a copper, caldron, kettle, pot
χαλκός	copper
χαλκοῦς	a copper coin
χἁλκυόνες	
Χάλκων	
χαμαί	on the earth, on the ground
χαμεύνη	a bed on the ground, pallet-bed
χαμεύνης	
χαμευνίς	
χἁμῖν	
χανδάνω	to take in, hold, comprise, contain
χαράσσω	to make sharp or pointed, sharpen, whet
χαρίεις	graceful, beautiful, lovely
χαρίζομαι	to say or do something agreeable
χάρις	Grace
Χάρις	
χάριτος	
χαριτόω	to shew grace to
χαροπός	glad-eyed, bright-eyed
χάσκω	may
χασμάω	to yawn, gape wide
χασμέομαι	
χἅτερα	
χᾳῶν	
χεῖλος	a lip
χειλόω	to surround with a lip or rim
χεῖμα	winter-weather, cold, frost
χειμαίνω	to drive by a storm
χείμαρρος	
χειμάρρους	winter-flowing, swollen by rain and melted snow
χειμέριος	wintry, stormy
χειμών	winter
χείρ	the hand
χειρίς	a covering for the hand, a glove
χειροπληθής	filling the hand, as large as can be held in the hand
χειρόω	to bring into hand, to manage, master, subdue
Χείρων	Cheiron
χελιδόνιον	swallow-wort, celandine
χελιδόνιος	of the swallow, like the swallow
χελιδών	the swallow
χερειότερος	
χερείων	meaner, inferior
χέρσονδε	to or on dry land
χέρσος	dry land, land
χέω	to pour
χηλός	a large chest or coffer
χθαμαλός	near the ground, on the ground, flat
χθιζός	of yesterday
χθόνιος	in, under or beneath the earth
χθόνος	
χθών	the earth, ground
χιλιάς	the number one thousand, a thousand
χίλιοι	a thousand
χίλιος	
χίμαιρα	a she-goat
χίμαρος	a he-goat
χῖον	
Χῖος	Chian, of or from Chios
χιτών	the garment worn next the skin, a frock
χιτώνιον	a woman's frock or shift
χιών	snow
χλαῖνα	pallium.
χλαμυδηφόρος	one who wears a χλαμύς, a horseman, cavalier
χλωρεύς	
χλῶρον	
χλωρός	greenish-yellow
Χοἱ	
χοἱ	
χοιράς	of a hog
χοῖρος	a young pig, porker
χολάς	the bowels, intestines, guts
χολάω	to be full of black bile, to be melancholy mad
χολή	gall, bile
χόλος	gall, bile
χολόω	to make angry, provoke, anger
χορεία	a dance
χορεῖος	
χορεύω	to dance a round or choral dance
χορηγός	a chorus leader
χόριον	the membrane that encloses the fetus, the afterbirth
χόριος	
χορός	a round dance
χόρτος	an inclosed place, a feeding-place
χοὗτος	
χοὕτω	
χόω	to throw or heap up
χράω	
χρέος	that which one needs must pay, an obligation, debt
χρεώ	want, need;
χρή	it is fated, necessary
χρῄζω	to need, want, lack, have need of
χρῆμα	a thing that one uses
χρήμη	
χρήσιμος	useful, serviceable, good for use, good, apt or fit
χρησμός	the answer of an oracle, oracular response, oracle
χρηστός	useful, good of its kind, serviceable
χρίμπτω	to bring near
χρίω	to touch on the surface: to rub or anoint with scented unguents
χροιά	the surface of a body, the skin; the body
χροίζω	to touch on the surface;
χροϊξεῖθ'	
Χρόμις	
χρόνιος	after a long time, late
χρόνος	time
χρύσεος	golden, of gold, decked or inlaid with gold
Χρυσογόνης	
χρυσός	gold
χρυσόω	to make golden, gild
χρώς	the surface of the body, the skin
χὑμές	
χὑμνοθέτης	
χὥδωνις	
χὡκ	
χωλός	lame
χῶμα	earth thrown up, a bank, mound
χὡνήρ	
χώρα	the space in which a thing is
χωρέω	to make room for another, give way, draw back, retire, withdraw
χωρίς	separately, asunder, apart, by oneself or by themselves
χῶρος	a piece of ground, ground, place
χὡς	
χὥτα	
ψε	
ψεῦδις	
ψευδοκύων	a sham Cynic
ψεῦδος	a falsehood, untruth, lie
ψεύδω	to cheat by lies, beguile
ψῆφος	a small stone, a pebble, rubbed and rounded
ψιθύρισμα	a whispering
ψυχή	breath
ψυχρόομαι	to grow cold, be cool
ψυχρός	cold, chill
ψύχω	to breathe, blow
̓́Ω	
̂̓Ω	
ὦ	O! oh!
ὥ'	
ὡγώ	
̂̔Ωδ'	
̂̔Ωδε	
ὧδε	in this wise, so, thus
ᾠδή	a song, lay, ode
ὠδίνω	to have the pains or throes of childbirth, to be in travail or labour
ὠδίς	the pangs or throes of labour, travail-pains
ᾠδοποιός	making songs or odes
ὥδωνις	
ᾦζυρε	
ὠθέω	to thrust, push, shove, force onwards or away
̓́Ωιαι	
ὡκ	
ὦκα	quickly, swiftly, fast
̓Ωκεανοῖο	
̓Ωκεανόν	
Ὠκεανός	Oceanus
ὠκύς	quick, swift, fleet
ὥλαφος	
ὦλευθερε	
ὥλλοι	
̓́Ωμοι	
ὤμοι	
ὠμοπλάτη	the shoulder-blade
ὦμος	ulna
ὠμός	raw, undressed
ὠμοφάγος	eating raw flesh, carnivorous
ὡμυκλαϊάσδων	
ὡμφιτρύωνος	
ὥνεκα	
ὦνος	for
ὡξ	
ὧπερ	where
ὦπιμελητα	
ὡπόλλων	
ᾡπόλοι	
ᾡπόλος	
ὤρα	care, concern, heed, regard for
ὥρα	period
̂̔Ωραι	
ὡραῖος	produced at the right season
̔Ωρᾶν	
ὥρατος	
ὡργεῖος	
ὥριος	produced in season
ὥριφος	
̓Ωρίωνα	
ὥρνες	
ὦρος	a mountain
ὠρυγμός	
ὠρύομαι	to howl
ὡρχαῖος	
̔Ως	
̔́Ως	
ὡς	thus, as, so that, since
ὡσαύτως	in like manner, just so
ὡσεί	just as if, as though
ὥσπερ	just as if, even as
ὥστε	as, as being
ὥστοργος	
ὥτερος	
ὧτινος	
ωὑτός	
ὡφρόντιστος	
ὠχρός	pale, wan, sallow
ὤψ	the eye, face, countenance