Field1	Field2
Α'	
ἄβρωτος	
'ἀγαθῇ	
ἀγαθός	good
ἀγανακτέω	to feel irritation
ἀγνοέω	not to perceive or know
ἀγνώς	unknown
ἄγνωστος	unknown
ἄγνωτος	
ἀγορά	an assembly of the people
ἀγοράζω	to be in the ἀγορά
ἀγοραῖος	in, of, or belonging to the ἀγορά
ἀγοράομαι	to meet in assembly, sit in debate
ἄγος	any matter of religious awe
ἀγρέω	to capture, seize
ἀγροικία	rusticity, boorishness, coarseness
ἄγροικος	of or in the country
ἀγρός	fields, lands
ἀγρυπνία	sleeplessness, waking, watching
ἄγω	to lead or carry, to convey, bring
ἀγωγή	a carrying away, carriage
ἀγών	a number of people brought together, a gathering, assembly
ἀδαξᾶσθαι	
ἀδελφή	a sister
ἀδικέω	to do wrong
ἀδικία	wrong-doing, injustice
ἀδολεσχέω	to talk idly, prate
ἀδολέσχης	a garrulous fellow, idle talker
ἀδολεσχία	garrulity, idle talk
ἀεί	always, for ever
ἀείδω	to sing
ἄεισμα	
ἀεκούσιος	against one's will, involuntary
ἀέκων	against one's will, unwilling
ἀηδής	unpleasant to the taste, distasteful
ἀηδία	unpleasantness, nauseousness
ἀήρ	the lower air, the air
ἀθεραπευσία	neglect of θεῶν
'Ἀθηνᾶ	
Ἀθηναῖος	Athenian, of or from Athens
ἀθρόος	in crowds or masses, crowded together
αἰδοῖον	the genitals, pudenda
αἰδοῖος	regarded with reverence, august, venerable
Αἰθίοψ	burnt-face
αἷμα	blood
αἱρέω	to take with the hand, grasp
αἴρω	to take up, raise, lift up
αἰσχροκέρδεια	base covetousness
Αἰσχροκερδειάς	
αἰσχροκερδής	sordidly greedy of gain
αἰσχρός	causing shame, abusive
αἰσχύνω	to make ugly, disfigure, mar
αἰτέω	to ask, beg
αἴτιος	to blame, blameworthy, culpable
ἀκαιρία	unfitness of times: unseasonableness
ἄκαιρος	ill-timed, unseasonable, inopportune
ἀκέομαι	to heal, cure
ἀκή	a point
ἀκολουθέω	to follow
ἀκόλουθος	following, attending on
ἀκούσιος	
ἀκούω	to hear
ἄκρα	a headland, foreland, cape
ἀκρασία	bad mixture, ill temperature
ἀκρίβεια	exactness, minute accuracy, precision
ἀκριβής	exact, accurate, precise, made or done to a nicety
ἀκριβόω	to make exact or accurate
ἀκριβῶς	
ἀκρόδρυα	fruit-trees
ἄκρος	at the furthest point
ἀλαζονεία	false pretension, imposture, quackery
ἀλαζών	a vagabond
ἅλας	salt
ἀλέγω	to trouble oneself, have a care
ἀλείφω	to anoint with oil, oil
ἀλέξανδρος	defending men
Ἀλέξανδρος	
ἀλέω	to grind, bruise, pound
ἁλή	
ἀληθής	unconcealed, true
ἁλής	assembled, thronged, in a mass, all at once
ἁλίζω	
'ἀλλ'	
ἀλλά	otherwise, but
ἄλλος	alius, another, one besides
ἀλλότριος	of or belonging to another
ἀλλοτριόω	to estrange from
'ἄλλῳ	
ἄλλως	in another way or manner
ἅλς	a lump of salt
ἀλυσιτελής	unprofitable
ἀλφάνω	to bring in, yield, earn
ἄλφιτον	peeled or pearl-barley
ἀλφός	whiteness: white leprosy
ἅμα	at once, at the same time
ἀμαθία	ignorance
ἀμέλει	never mind
ἀμελέω	to have no care for, be neglectful of
ἁμός	
ἀμφισβητέω	to stand apart
ἀμφότερος	each or both of two
ἄν	
'ἄν	
ἀνά	up, upon
ἀναβάλλω	to throw or toss up
ἀναγκάζω	to force, compel
ἀναγκαῖος	with or by force
ἀνάγω	to lead up
ἀναδείκνυμι	to lift up and shew
ἀναδέχομαι	to take up, catch, receive
ἀναιρέω	to take up, raise
ἀναισθησία	want of feeling or perception; insensibility
ἀναίσθητος	insensate, unfeeling
ἀναισχυντία	shamelessness
ἀναίσχυντος	shameless, impudent
ἀνακοινόω	to communicate
ἀνακράζω	to cry out, lift up the voice
ἀνακύπτω	to lift up the head
ἀναλίσκω	to use up, to spend, lavish or squander
ἀνάλωμα	expenditure, cost
ἀναμένω	to wait for, await
ἀναμιμνήσκω	to remind
ἀνανεύω	to throw the head back
ἀναπίπτω	to fall back
ἀνάπλεος	quite full of
ἀναπνέω	to breathe again, take breath
ἀναστρέφω	to turn upside down, upset
ἀνασύρομαι	to pull up one's clothes
ἀνατίθημι	to lay upon
ἀναφέρω	to bring or carry up
ἀναφορά	
ἀνδράποδον	one taken in war and sold as a slave, a captive
ἀνδριάς	the image of a man, a statue
ἀνδρόλαλος	
ἀνελευθερία	illiberality
ἀνελεύθερος	not fit for a free man
ἄνευ	without
ἀνήρ	a man
Ἀνθεστηριών	Anthesterion
ἀνθεστηριών	
ἀνθρώπινος	of, from or belonging to man, human
ἄνθρωπος	man
ἀνίστημι	to make to stand up, raise up
ἄνοος	without understanding, foolish, silly
ἀνταλλάσσω	to exchange
ἀντανίστημι	to set up against
ἀντεραστής	a rival in love
ἀντίδικος	an opponent in a suit, defendant
ἀντικνήμιον	the part of the leg opposite the κνήμη, the shin
Ἀντίπατρος	
ἀντιπροσεῖπον	
ἀνυπόδητος	unshod, barefoot
ἄνω	
ἀξία	the worth or value
ἄξιος	weighing as much, of like value, worth as much as
ἀξιόω	to think or deem worthy of
'ἄπαγ'	
ἀπαγγέλλω	to bring tidings, report, announce
ἀπαγορεύω	to forbid
ἀπάγχω	to strangle, throttle
ἀπάγω	to lead away, carry off
ἀπαιτέω	to demand back, demand
ἀπαλλάσσω	to set free, release, deliver
ἁπαλός	soft to the touch, tender
ἀπαντάω	to move from
ἀπαντικρύ	right opposite
ἀπάρχω	
Ἀπατούρια	the Apatouria
Ἀπατούριος	
ἀπαυδάω	to forbid
ἄπειμι	
ἀπεῖπον	to speak out, tell out, declare
ἀπείρητος	without making trial of
ἀπέρχομαι	to go away, depart from
'ἀπέσταλκα	
ἀπέχω	to keep off or away from
ἀπήνεια	
ἄπιος	
ἀπιστέω	to be ἄπιστος
ἀπιστία	disbelief, distrust, mistrust
ἄπιστος	not to be trusted
ἁπλόος	single
ἀπνευστί	to hold one's breath
ἀπό	from, away from. c. gen.
ἀποβάλλω	to throw off
ἀποβλέπω	to look away from
ἀπογράφω	to write off, copy: to enter in a list, register
ἀπογυμνάζω	to bring into hard exercise, to ply hard
ἀπογυμνόω	to strip quite bare
ἀπογύμνωσις	
ἀποδημέω	to be away from home, be abroad or on one's travels
ἀποδίδωμι	to give up or back, restore, return
ἀποδοκιμάζω	to reject on scrutiny, to reject for want of qualification
ἀποδοκιμάω	to reject
ἀπό-δράω	
ἀποκαθίστημι	to re-establish, restore, reinstate
ἀποκαλέω	to call back, recall
ἀποκάμπτω	to turn off or aside
ἀποκείρω	to clip or cut off
ἀποκρίνω	to separate, set apart
ἀποκρύπτω	to hide from, keep hidden from
ἀπολαμβάνω	to take or receive from
ἀπολαύω	to have enjoyment of
ἀπόλλυμι	to destroy utterly, kill, slay
ἀπολύω	to loose from
ἀπομύσσω	to wipe
ἀπονίζω	wash off
ἀπονοέομαι	to have lost all sense
ἀπόνοια	loss of all sense
Ἀπονοιάς	
ἀπονυχίζω	to pare the nails
ἀποπτύω	to spit out
ἄπορος	without passage
ἀποροῦμαι'	
ἀπορρίπτω	to throw away, put away
ἄποσος	
ἀποστέλλω	to send off or away from
ἀποστερέω	to rob, despoil, bereave or defraud
ἀποτίθημι	to put away, stow away
ἀποτρέπω	to turn
ἀπουσία	a being away, absence
ἀποφαίνω	to shew fort, display, produce
ἀποφέρω	to carry off or away
ἀποφορά	payment of what is due, tax, tribute
ἀποψάω	to wipe off
ἀπροβούλευτος	not planned beforehand, unpremeditated
ἅπτω	to fasten, bind fast
ἀπύρευτος	
ἀπωθέω	to thrust away, push back
ἄρα	
ἀργύριον	a piece of silver, a silver coin
ἀργυροθήκη	a money-chest
ἀρέσκεια	
Ἀρεσκειάς	
ἄρεσκος	pleasing
ἀρέσκω	to make good, make up
ἀριθμέω	to number, count or reckon up
ἀριστάω	to take breakfast or luncheon
Ἀριστοφών	
ἁρμονικός	skilled in music
ἄρον	
ἄρος	
ἄροτρον	a plough
ἁρπάζω	to snatch away, carry off
ἀρρώστημα	an illness, a sickness
ἀρρωστία	weakness, sickness
Ἄρτεμις	Artemis
ἄρτι	just, exactly
ἄρτος	a cake or loaf of wheat-bread
ἀρύταινα	a small pail
ἀρχαῖος	from the beginning
ἀρχή	a beginning, origin, first cause
ἀρχήν	
Ἀρχίης	
ἄρχιος	
ἀρχιτεκτονέω	to be the architect
ἄρχω	to be first
ἄρχων	a ruler, commander, chief, captain
Ἀσία	Asia
Ἀσίης	
ἄσιος	
Ἄσιος	Asian
Ἀσκληπιεῖον	the temple of Asclepius
Ἀσκληπίειος	of, belonging to Asclepius
'ἀσκός	
ᾆσμα	a song, a lyric ode
ἀσπίδα'	
ἀσπίδιον	
Ἄστειος	
ἀστεῖος	of the town
ἀστράγαλος	one of the neck-vertebrae
ἄστρον	the stars
ἄστυ	a city, town
ἄσχημος	
ἀσχήμων	misshapen, unseemly, shameful
ἀσχολέω	to engage, occupy
ἀτελής	without end
ἀτραπός	a path with no turnings
αὐθάδεια	self-will, wilfulness, stubbornness, contumacy, presumption
αὐθάδης	self-willed, wilful, dogged, stubborn, contumacious, presumptuous
αὐλαία	
αὐλαῖος	
αὐλεία	
αὔλειος	of or belonging to the αὐλή or court
αὐλέω	to play on the flute
αὐλητής	a flute-player
αὐλητρίς	a flute-girl
αὐλίδιον	
αὐξάνω	to make large, increase, augment
αὔριον	to-morrow
'αὗται	
'αὐταί	
αὐτοκράτωρ	one's own master
αὐτός	self
αὐτοῦ	at the very place, just here, just there
αὐτῶν'	
αὐχμέω	to be squalid or unwashed
αὐχμή	
αὐχμός	drought
ἀφαιρέω	to take from, take away from
ἀφίημι	to send forth, discharge
ἀφίστημι	to put away, remove
'ἀχάριστον	
ἄχρι	to the uttermost, utterly
ἄχυρον	husks, chaff, bran
ἄχυρος	
ἀχυρός	a chaff-heap
ἄω	
Β'	
βαδίζω	to go slowly, to walk
βακτηρία	a staff, cane
βαλανεῖον	bathing-room
βαλανεύς	a bath-man
βαλλάντιον	a bag, pouch, purse
βάπτω	to dip in water
βασίλεια	a queen, princess
βασιλεία	a kingdom, dominion
βασίλειος	of the king, kingly, royal
βασιλεύς	a king, chief
βδελυρία	brutal conduct, want of shame and decency, brutality
βδελυρός	loathsome, disgusting, brutal
βέλτιστος	best
βελτίων	better
βίος	life
βιόω	to live, pass one's life
βλάβη	hurt, harm, damage
βλάπτω	to disable, hinder, stop
βλασφημέω	to drop evil or profane words, speak lightly or amiss of sacred things
βοάω	to cry aloud, to shout
Βοηδρομιών	the third Attic month
βουλεύω	to take counsel, deliberate, concert measures
'βούλομαι	
βούλομαι	to will, wish, be willing
βούλονται'	
βοῦς	cow
βραδυτής	slowness
Βυζάντιος	
Γαῖα	
γαλάξια	
γαλέη	a weasel, marten-cat or polecat
γαμέω	to marry
γάμος	a wedding, wedding-feast
γάρ	for
γαστήρ	the paunch, belly
γε	at least, at any rate
γέγονεν'	
γείτων	one of the same land, a neighbour
γελάω	to laugh
γέλως	laughter
γενεαλογέω	to trace by way of pedigree
γενέσθαι'	
γεννάω	to beget, engender
γένος	race, stock, family
γεωργέω	to be a husbandman, farmer
γῆ	earth
γίγνεται'	
γίγνομαι	to come into being
γιγνώσκω	to learn to know, to perceive, mark, learn
γλαύξ	the owl
γλίχομαι	to cling to, strive after, long for
γλῶσσα	the tongue
γνάθος	the jaw
γναφεύς	
γνώριμος	well-known, familiar
γόνυ	the knee
γοῦν	at least then, at any rate, any way
γράμμα	that which is drawn
γραμματείδιον	small tablets
γράφω	to scratch, scrape, graze
γυμνάζω	to train naked, train in gymnastic exercise
γυμνάς	fem. of γυμνός, naked
γυμνάσιον	bodily exercises
γύμνασις	
γυμνός	naked, unclad
γυναικεῖος	of or belonging to women, like women, befitting them, feminine
γυνή	a woman
δαιμονάω	to be under the power of a δαίμων, to suffer by a divine visitation
δαιμόνιον	the Deity
δαιμόνιος	of or belonging to a δαίμων
δαίς	
δάκνω	to bite
δακρύω	to weep, shed tears
δακτύλιον	
δακτύλιος	a ring, seal-ring
δάκτυλος	a finger
Δάμιππος	
δανείζω	to put out money at usury, to lend
δανειστικός	of or for money-lending
δαπανάω	to spend
δαπάνη	outgoing, cost, expense, expenditure
δασύς	thick with hair, hairy, shaggy, rough
δάφνη	the laurel
δέ	but
δεῖ	it is binding on
δείκνυμι	to bring to light, display, exhibit
δειλία	cowardice
δειλιάω	to be afraid
δειλός	cowardly, craven
δεῖνα	such an one, a certain one
δεινός	fearful, terrible, dread, dire
δειπνέω	to make a meal
δεῖπνον	the principal meal
δεῖπνος	
δεισιδαιμονία	fear of the gods, religious feeling
δεισιδαίμων	fearing the gods
δέκα	ten
δεκαδιστής	
δεκαζομένων'	
Δελφοί	the Delphians
δεσμωτήριον	a prison
δέχομαι	to take, accept, receive
δέω	
δή	exactness
δημαγωγέω	to lead the people
δημαγωγός	a popular leader
δημοκρατία	democracy, popular government
δῆμος	a country-district, country, land
δημοσίᾳ	
δημόσιος	belonging to the people or state
δημοσιόω	to confiscate
δημότης	one of the people, a commoner, plebeian
δήποτε	at some time, once upon a time
δήπου	perhaps, it may be
'διά	
διά	through c. gen. through, by means of c. acc.
διαβάλλω	to throw over or across, to carry over or across
διαγιγνώσκω	to distinguish, discern
διάζευγμα	
διαίρω	to raise up, lift up
δίαιτα	a way of living, mode of life
διαιτάω	to feed in a certain way, to diet
διακονέω	to minister, serve, do service
διακοντίζομαι	to contend with others at throwing the javelin
διαλέγω	to pick out one from another, to pick out
διά-λέγω	
διαλογίζομαι	to balance accounts
διαλύω	to loose one from another, to part asunder, undo
διαμένω	to remain by, stand by
διανεμόομαι	to flutter in the wind
διανέμω	to distribute, apportion
διάνοια	a thought, intention, purpose
διά-ὁρίζω	
διάπειρα	an experiment, trial
διαπείρω	to drive through
διαρραίνομαι	to flow all ways
διατείνω	to stretch to the uttermost
διατοξεύω	to shoot through.
διατρίβω	to rub between, rub hard, rub away, consume, waste
διαφαγεῖν	to eat through
διαφέρω	to carry over or across
διάφορος	different, unlike
διαψιθυρίζω	to whisper among themselves
διδασκαλεῖον	a teaching-place, school
διδάσκαλος	a teacher, master
διδάσκω	to teach
διδόντοσ'	
δίδωμι	to give
διείργω	to keep asunder, separate
διέξειμι	to go out through, pass through
διεξέρχομαι	to go through, pass through
διεξῄει'	
διεξίημι	to let pass through
διηγέομαι	to set out in detail, describe in full
διήγησις	narrative, statement
δικάζω	to judge, to give judgment on
δίκαιος	observant of custom and social rule, well-ordered, civilised
δικαιόω	to set right
δικαστήριον	a court of justice
δίκη	custom, usage
διμοιρία	a double share
Διονύσια	the feast of Dionysus or Bacchus
Διονύσιον	
Διονύσιος	
Διονύσος	
Διόνυσος	Dionysus
διότι	for the reason that, since
δίς	twice, doubly
διφάω	to search after
διφθέρα	a prepared hide, tanned skin, piece of leather
διωθέω	to push asunder, tear away
διώκω	to pursue
δοκεύς	
δοκέω	videor mihi, to think, suppose, imagine, expect
δοκή	a vision, fancy
δοκόν	
δοκός	a bearing-beam
δοκώ	
δόξα	a notion
δόξις	
δορκάδειος	of an antelope
δόρυ'	
δοῦλος	a born bondman or slave
δραχμή	a handful
δρέπανον	a scythe
δύναμαι	to be able, capable, strong enough
δυνατός	strong, mighty, able
δύο	two
δυσέντευκτος	hard to speak with
'δυστυχής	
δυσχέρεια	annoyance or disgust
Δυσχέρειας	
δυσχερής	hard to take in hand or manage
δώδεκα	twelve
δωμάτιον	a chamber, bed-chamber
ἕ	sui.
Ε'	
ἐάν	if haply
ἑαυτοῦ	itself, absolutely
ἐάω	to let, suffer, allow, permit
ἑβδομάς	the number seven or a number of seven
ἐγγράφω	to mark in or on, to paint on
ἐγγύα	
ἐγγυάω	to give or hand over as a pledge
ἐγγύη	a pledge put into the hand: surety, security
ἐγγυητής	one who gives security, a surety
ἐγγυητός	wedded
ἐγείρω	to awaken, wake up, rouse
ἐγκαλέω	to call in
ἐγκρούω	to knock or hammer in
ἐγκώμιος	in or of the same village, native
'ἐγώ	
ἐγώ	ego
ἕδρα	a sitting-place
ἔδω	to eat
ἐθέλω	to will, wish, purpose
εἰ	whether.
εἰδέναι'	
εἰδεχθής	
εἰδῆσαι	
εἴδομαι	are visible, appear
εἶδον	to see, perceive, behold
εἰκών	a likeness, image, portrait
εἰμί	to be, to exist
εἶμι	to go
εἶναι'	
'Εἴπ'	
'εἶπας	
εἶπον	to speak, say
εἴρω	
εἴρων	a dissembler, one who says less than he thinks
εἰρωνεία	dissimulation
εἰς	into, to c. acc.
εἷς	
εἰσάγω	to lead in or into, to introduce
εἴσειμι	to go into
εἰσέρχομαι	to go in or into, enter
εἰσθέω	to run into, run up
εἰσίημι	to send into
εἰσ-κρούω	
εἴσοδος	a way in, entrance
εἰσπράσσω	to get in or exact
εἰσφέρω	to carry into or to
εἴσω	to within, into
εἶτα	then, next
ἐκ	from out of
ἕκαστος	every, every one, each, each one
ἑκάτερος	each of two, either, each singly
Ἑκάτη	Hecate, the far-darter
ἑκάτη	
ἐκβάλλω	to throw or cast out of
ἐκβοηθέω	to march out to aid
ἐκδέχομαι	to take or receive from
ἐκδίδωμι	to give up, surrender
ἐκδύω	to take off, strip off
ἐκεῖ	there, in that place
ἐκεῖνος	the person there, that person or thing
ἐκ-θύω	
ἐκκλησία	an assembly of the citizens regularly summoned, the legislative assembly
ἐκκορέω	to sweep out, to sweep clean
ἐκλέγω	to pick or single out
ἐκμανθάνω	to learn thoroughly
ἐκπέμπω	to send out or forth from
ἐκπίνω	to drink out or off, quaff
ἐκπλήγνυμι	
'ἐκπλήττομαι'	
ἐκπλύνω	to wash out
ἔκπωμα	a drinking-cup, beaker
ἐκτίθημι	to set out, place outside
ἐκτίνω	to pay off, pay in full
ἐκτρίβω	to rub out
ἐκφέρω	to carry out of
ἐλαία	the olive-tree
ἔλαιον	olive-oil
ἔλαιος	the wild olive
ἐλαιόω	
ἐλασσόω	to make less or smaller, to lessen, diminish, lower
ἐλάσσων	smaller, less
ἐλαύνω	to drive, drive on, set in motion
ἐλάχιστος	the smallest, least
ἐλέγχω	to disgrace, put to shame
ἐλευθερία	freedom, liberty
ἐλεύθερος	free
ἑλκέω	to drag about, tear asunder
ἕλκος	a wound
ἑλκόω	to wound sorely, lacerate
Ἑλλάς	Hellas
ἑλλέβορος	hellebore
Ἕλλην	Hellen
ἐλλύχνιον	a lamp-wick
ἐμβαίνω	to step in
ἐμβάλλω	to throw in, put in
ἐμός	mine
ἔμπειρος	experienced or practised in
ἐμπίπλημι	to fill quite full
ἐμπίπτω	to fall in or upon or into
ἐμπόλημα	matter of traffic, the freight of a ship, merchandise
ἔμπροσθεν	before, in front
ἔμφοβος	terrible
ἐν	in, among. c. dat.
'ἐν	
'ἕνα	
ἐναντίον	
ἐναντίος	opposite
ἐνδίδωμι	to give in
ἔνδον	in, within, in the house, at home
ἕνεκα	on account of, for the sake of, because of, for
ἐνενήκοντα	ninety
ἐν-ἡμερεύω	
ἐνθυμέομαι	to lay to heart, consider well, reflect on, ponder
'ἐνθυμῇ	
ἐνιαυτός	any long period of time, a cycle, period
ἔνιοι	some
ἐννέα	nine
ἕνος	belonging to the former of two periods, last year's
ἐνταῦθα	here, there
ἔντευξις	a lighting upon, meeting with, converse, intercourse
ἐντυγχάνω	to light upon, fall in with, meet with
ἐνύπνιον	a thing seen in sleep
ἐνύπνιος	in dreams appearing
ἐνυφαίνω	to weave in as a pattern
ἐξαγωγεύς	
ἐξαγωγή	a leading out
ἑξακόσιοι	six hundred
ἔξαρνος	denying;
ἔξειμι	to go out, come out
ἐξέρχομαι	to go or come out of
ἔξεστι	it is allowed, it is in one's power, is possible
ἐξηγητής	one who leads on, an adviser
ἑξηκονταέτης	sixty years old
ἕξις	a having, possession
ἐξίστημι	to put out of its place, to change or alter utterly
ἔξοδος	
ἐξόμνυμι	to swear in excuse
ἔξω	out
ἔοικα	to be like
ἑορτή	a feast or festival, holiday
'ἐπ'	
ἐπαγγέλλω	to tell, proclaim, announce
ἐπαγωγή	a bringing in, supplying
ἐπαινέω	to approve, applaud, commend
ἐπαινός	dread
ἐπάν	
ἐπαναγκάζω	to compel by force, constrain
ἐπάνειμι	to go back, return
ἐπανέρχομαι	to go back, return
ἐπεί	after that, after (postquam), since, when (quum)
ἐπεῖδον	to look upon, behold
ἐπείσειμι	to come in or besides
ἐπεντείνω	to stretch tight upon
ἐπεύχομαι	to pray or make a vow
ἐπέχω	to have or hold upon
ἐπί	on, upon with gen., dat., and acc.
'ἐπί	
ἐπιβαίνω	to go upon
ἐπιβάλλω	to throw or cast upon
ἐπίβουλος	plotting against
ἐπιγελάω	to laugh approvingly
ἐπιγράφω	to mark the surface, just pierce, graze
ἐπιδείκνυμι	to exhibit as a specimen
ἐπίδειξις	a shewing forth, making known
ἐπιδέξιος	towards the right
ἐπιδημέω	to be at home, live at home
ἐπίδοσις	a giving over and above, a voluntary contribution
ἐπιθυμία	desire, yearning, longing
ἐπιθυμιάω	to offer incense
ἐπικαταλλαγή	money paid for exchange, discount
ἐπικρηπῖδας	
ἐπιλαμβάνω	to lay hold of, seize, attack
ἐπιλήθω	to cause to forget
ἐπίληπτος	caught or detected in
ἐπιμελέομαι	to take care of, have charge of, have the management of
ἐπιμελής	careful or anxious about, put in charge of
ἐπιρράπτω	to sew or stitch on
ἐπισημαίνω	to set a mark upon
ἐπισκέπτομαι	
ἐπισκοπέω	to look upon or at, inspect, observe, examine, regard
ἐπισκώπτω	to laugh at, quiz, make game of
ἐπίσταλμα	a commission
ἐπίσταμαι	to know
ἐπιστέλλω	to send to, send as a message or letter
ἐπίτευξις	
ἐπιτήδειος	made for an end or purpose, fit or adapted for it, suitable, convenient
ἐπιτήδευμα	a pursuit, business, practice
ἐπιτηδεύω	to pursue or practise
ἐπιτίθημι	to lay, put or place upon
ἐπιτιμάω	to lay a value upon
ἐπιτιμή	
ἐπιτίμησις	censure, criticism
ἐπιτρέπω	to turn towards
ἐπιφανής	coming to light, appearing
ἐπιχρωνῆν	
ἐπονείδιστος	to be reproached, shameful, ignominious
ἔπος	a word
ἔρα	
ἐρανίζω	lay under contribution
ἔρανος	a meal to which each contributed his share
ἐράω	
ἐργάζομαι	to work, labour
ἐργασία	work, daily labour, business
ἐργαστήριον	any place in which work is done: a workshop, manufactory
ἔργνυμι	to confine
ἐργολάβος	one who contracts for the execution of work, a contractor
ἔργον	work
ἐργώδης	irksome, troublesome
ἐρεθισμός	
ἐρείδω	
ἐρεύγομαι	to spit or spew out, to disgorge
ἐρῆμος	desolate, lone, lonely, lonesome, solitary
ἐρημόω	to strip bare, to desolate, lay waste
Ἑρμαφρόδιτος	an hermaphrodite, a person partaking of the attributes of both sexes
Ἑρμῆς	Hermes
ἔρος	
ἔρχεται'	
ἔρχομαι	to come or go
ἐρῶ	I will say or speak
ἐρώμενος	one's love
ἐρωτάω	to ask
ἐσθίεισ'	
ἐσθίω	to eat
ἔσθος	
ἔσται'	
ἐστι'	
ἑστία	the hearth of a house, fireside
ἑστιάω	to receive at one's hearth or in one's house: to entertain, feast, regale
ἑστιόομαι	to be founded or established
ἔστω'	
ἑταίρα	a companion
ἕτερος	one of the
ἔτης	clansmen
ἔτι	yet, as yet, still
ἔτος	a year
εὖ	well
'εὖ	
εὐαγγελίζομαι	to bring good news, announce them
εὐγενής	well-born, of noble race, of high descent
εὐδοκιμέω	to be of good repute, to be held in esteem, honoured, famous, popular
εὐεργετέω	to do well, do good
εὐημερέω	to spend the day cheerfully, live happily from day to day
εὐθύς	
εὔλυτος	
εὔνοια	good-will, favour, kindness
εὔνους	well-minded, well-disposed, kindly, friendly
εὑρίσκω	to find
εὔρυθμος	rhythmical
Εὐρώτης	
εὐρωτιάω	to be or become mouldy
εὐσχήμων	elegant in figure, mien and bearing, graceful
εὐτρεπίζω	to make ready, get ready
εὐφραίνω	to cheer, delight, gladden
εὐφυής	well-grown, shapely, goodly
εὔχομαι	to pray, offer prayers, pay one's vows, make a vow
εὐωχέω	to treat or feed well, entertain sumptuously
'εὐωχοῦ	
ἐφέλκω	to draw on, drag or trail after
ἔφηβος	one arrived at puberty
'ἐφθόνησεν	
ἐφίστημι	to set or place upon
ἐφοδεύω	to visit, go the rounds, patrol
ἐφόδιον	travelling-allowance
ἐφόδιος	
'ἔχεις	
ἐχθές	yesterday
ἐχθρός	hated, hateful
ἐχῖνος	the urchin, hedgehog
ἔχις	an adder, viper
ἔχω	to have or to hold
ἕψω	to boil, seethe
ἐώνημαι'	
ἕως	until, till
Ζ'	
ζάω	to live
Ζεύς	Zeus
ζέω	to boil, seethe
ζηλόω	to rival, vie with, emulate
ζητέω	to seek, seek for
ζωγρέω	to take alive, take captive
ζωμός	broth
ζωρός	pure, sheer
Η'	
'ἤ	
ἤ	
η	
ἡγέομαι	to go before, lead the way
ἡδέως	
ἤδη	by this time, before this, already
ἡδονά	
ἡδονή	delight, enjoyment, pleasure
ἦδος	delight, enjoyment, pleasure
'ἡδύ	
ἡδύς	sweet
ἠθέω	to sift, strain
ἦθος	an accustomed place
ἥκω	to have come, be present, be here
ἡλικία	time of life, age
ἡλίκος	as big as
ἧλος	a nail
ἡμέρᾳ'	
ἡμέρα	day
ἥμερος	tame, tamed, reclaimed
ἡμερόω	to tame, make tame
ἤμεσα'	
ἡμιόλιος	containing one and a half, half as much again
ἥμισυς	half
ἡμιωβόλιον	a half-obol
ἡμός	
ἡνίκα	at which time, when
Ἡράκλειος	of Hercules
ἡρῷον	the temple or chapel of a hero
ἡρῷος	the heroic measure, hexameter
ἡσσάομαι	to be less than another, inferior to
ἥσσων	less, weaker, less brave
ἤτοι	now surely, truly, verily
'ηὐδοκίμεις	
ἠώς	the morning red, daybreak, dawn
θᾶκος	a seat, chair
θάλασσα	the sea
θαρσέω	to be of good courage, take courage
θάσσων	quicker, swifter
θαῦμα	whatever one regards with wonder, a wonder, marvel
θαυμάζω	to wonder, marvel, be astonied
'θαυμάζω	
'θαυμάζω'	
θεά	a goddess
θέα	a seeing, looking at, view
θεάομαι	to look on, gaze at, view, behold
θέατρον	a place for seeing
θεατρώνης	
θείνω	to strike, wound
θεον	
θεός	God
θεράπαινα	a waiting maid, handmaid
θεραπεύω	to be an attendant, do service
θεωρέω	to look at, view, behold
θεωρός	a spectator
θηριόω	to make into a wild beast.
θηριώδης	full of wild beasts, infested by them
θησαυρός	
Θησεύς	Theseus
θλίβω	to press, squeeze, pinch
Θουριακάς	
Θρᾷσσα	a Thracian woman
θρίξ	the hair of the head
θυγάτηρ	a daughter
θυήλημα	
θύλακος	a bag, pouch, wallet
θύμον	thyme
θύμος	
θυμόω	to make angry
θύον	
θυόω	to fill with sweet smells
θύρα	a door
θύω	
Ι'	
ΙΑ'	
ἰάομαι	to heal, cure
ἰατρός	one who heals, a mediciner, physician or surgeon
ΙΒ'	
ΙΓ'	
ΙΔ'	
ἴδη	a timber-tree
ἴδιος	one's own, pertaining to oneself
ἱδρύω	to make to sit down, to seat
ΙΕ'	
ἱερά	
ἱεραί	
ἱεράομαι	to be a priest or priestess
ἱερεία	
ἱέρεια	a priestess
ἱερεῖον	a victim, an animal for sacrifice or slaughter
ἱερεύς	a priest, sacrificer
ἱερή	
Ἱερή	
ἱερόν	
ἱερός	super-human, mighty, divine, wonderful
ἱερόω	to hallow, consecrate, dedicate
ΙΖ'	
ΙΗ'	
ἵημι	to set a going, put in motion
ΙΘ'	
ἱκανός	becoming, befitting, sufficing
'ἱκανός	
ἱκανόω	to make sufficient, qualify
'ἱλαρός	
ἱμάτιον	an outer garment, a cloak or mantle
ἱματισμός	clothing, apparel
ἵνα	in that place, there
ἱππάζομαι	to drive horses, drive a chariot
ἱππεύς	a horseman
ἵππος	a horse, mare
Ισ'	
ἴσθι'	
ἴσος	equal to, the same as
ἰσόω	to make equal
ἵστημι	to make to stand
ἰσχυρός	strong, mighty
ἰσχύς	strength
ἴσως	equally, in like manner
ἰχθυοπώλιον	
καθά	according as, just as
καθαίρω	to make pure or clean, cleanse, clean, purge
καθᾶραι	
καθεύδω	to lie down to sleep, sleep
κάθημαι	to be seated
καθιζάνω	to sit down
καθίζω	to make to sit down, seat
καθίστημι	to set down, place
καθό	in so far as, according as
και	
καί	and
καινόν'	
καινός	new, fresh
καινόω	to make new, innovate
καίπερ	although, albeit
καιρός	due measure, proportion, fitness
κάκη	wickedness, vice
κακία	badness
κακολογία	evil-speaking, reviling
κακολόγος	evil-speaking
κακός	bad
κακόω	to treat ill, maltreat, afflict, distress
καλέω	to call, summon
κάλη	
καλλιστεύω	to be the most beautiful
καλλύνω	to beautify
καλός	beautiful, beauteous, fair
κάλυμμα	a head-covering
κἀν	and if, even if, although
κάρυον	nut
καρφολογῆσαι	
Κάσανδρος	
κασσύω	to stitch or sew together like a shoemaker
κατά	down, downwards, with gen. or acc.
καταβαίνω	to step down, go or come down
καταβάλλω	to throw down, overthrow
καταγιγνώσκω	to remark, discover
κατάγνυμι	to break in pieces, shatter, shiver, crack
κατάγω	to lead down
καταδεής	wanting or failing in, lacking
κατά-ἕζομαι	
κατά-καθέζομαι	
κατακείω	
καταλείπω	to leave behind
καταλύω	to put down, destroy
κατά-ὀχέω	
καταπονέω	to subdue after a hard struggle
καταράομαι	to call down curses upon, imprecate upon
κατάστρωμα	that which is spread over
κατατίθημι	to place, put
καταφέρω	to bring down
καταφιλέω	to kiss tenderly, to caress
καταφρόνησις	contempt, disdain
καταχεύω	
κατενεχθήσῃ'	
κατέχω	to hold fast
κατηγορέω	to speak against, to accuse
κατηγορία	an accusation, charge
κατηχέω	to sound
κάτος	
κάτω	down, downwards
ΚΒ'	
ΚΓ'	
ΚΔ'	
ΚΕ'	
κεῖμαι	to be laid
κείρω	to cut
κελεύω	to urge or drive on, urge, exhort, bid, command, order
κέλλω	to drive on
κενόω	to empty out, drain
κεράννυμι	to mix, mingle
κέρας	the horn of an animal
κεράω	
κέρδος	gain, profit, advantage
κεφάλαιος	of the head
κεφαλή	the head
ΚΖ'	
κήλη	a tumor
κηλιδόω	to stain, sully, soil
κηλίς	a stain, spot, defilement
κῆπος	a garden, orchard, plantation
κηρύσσω	to be a herald, officiate as herald
ΚΘ'	
κιβωτός	a wooden box, chest, coffer
κινδυνεύω	to be daring, to make a venture, take the risk, do a daring thing
κίχρασθαι	
κίων	a pillar
'κλάδος	
κλείς	that which serves for closing
κλῄζω	
κλιμάκιον	
κλίνη	that on which one lies, a couch or bed
κλίνω	to make to bend, slope
κλοπεύς	a thief, stealer
κλοπή	theft
κλύδων	a wave, billow
κνάπτω	to card or dress
κναφεύς	a fuller
κοιμάω	to lull or hush to sleep, put to sleep
κοινός	common, shared in common
κοινόω	to make common, communicate, impart
κοίρανος	a ruler, commander
κολακεία	flattery, fawning
κολακεύω	to flatter
κόλαξ	a flatterer, fawner
κολοιός	a jackdaw, daw
κόλπος	the bosom
κομίζω	to take care of, provide for
κόνις	ashes
κόπος	a striking, beating
κόπτω	to strike, smite, knock down
κόραξ	carrion-crow
κόρδαξ	the cordax
κουρά	a shearing or cropping
κουρεῖον	a barber's shop
κόφινος	a basket
κρατέω	to be strong, mighty, powerful
κράτιστος	strongest, mightiest
κράτος	strength, might
κραυγάζω	to bay
κραυγή	a crying, screaming, shrieking, shouting
κρέας	flesh, meat, a piece of meat
κρείττων'	
κρεωπώλην	
κριθή	barley-corns, barley
κρίνεσθαι'	
Κρινοκοράκα	
κρίνον	a lily
κρίνω	to pick out, choose
κριός	a ram
κρίσις	a separating, power of distinguishing
κροκύς	the flock or nap on woollen cloth
κροτέω	to make to rattle
κρύπτω	to hide, cover, cloak
Κσ'	
κτάομαι	to procure for oneself, to get, gain, acquire
κτέομαι	
κυβερνήτης	a steersman, helmsman, pilot
κυβεύω	to play at dice
Κύζικος	of or from Cyzicus
κυκεών	mixed drink, a potion, tankard
κύκλος	a ring, circle, round
κύλιξ	a cup, drinking-cup, wine-cup
κυλιούχιον	
κύμινον	cummin
κυνάριον	a little dog, whelp
κυνάω	to play the Cynic
κύπτω	to bend forward, stoop down
κύων	a dog or bitch
κωλύω	to let, hinder, check, prevent
κωμάζω	to go about with a party of revellers, to revel, make merry
κωμικός	
Λ'	
λάθρῃ	secretly, covertly, by stealth, treacherously
Λακεδαιμόνιος	
Λακεδαίμων	Lacedaemon
λακκαῖον	
Λακωνικός	Laconian
'λαλεῖν	
λαλέω	to talk, chat, prattle, babble
λαλιά	talking, talk, chat
λαλιή	
λαλιός	
λάλος	talkative, babbling, loquacious
λαμβάνω	to take
λαμπάς	
λαμπρός	bright, brilliant, radiant
λανθάνω	to escape notice, to be unknown, unseen, unnoticed
λάχανον	garden-herbs, potherbs, vegetables, greens
λέγος	
λέγω	
λειτουργέω	to serve public offices at one's own cost
λειτουργία	a liturgy
λέπρα	leprosy
λεπτόν	a very small coin, a mite
λεπτός	peeled, husked, threshed out
λευκός	light, bright, brilliant
λεχώ	a woman in childbed
ληκύθιον	a small oil-flask
λήκυθος	an oil-flask, oil-bottle
λῆρος	silly talk, nonsense, trumpery
ληψόμενοσ'	
λίαν	very, exceedingly
λιβανωτός	frankincense, the gum of the tree λίβανος
λιθάω	
λιθοκόλλητος	set with precious stones
λιθόομαι	
λίθος	a stone
λιπαρέω	to persist, persevere, hold out
λιπαρής	persisting or persevering
λιπαρός	oily, shiny with oil
λογίζομαι	to count, reckon, calculate, compute
λογισμός	a counting, reckoning, calculation, computation
λογοποιέω	to invent stories, to write, compose
λογοποιία	tale-telling, news-mongering
λογοποιός	a prose-writer
λόγος	the word or that by which the inward thought is expressed
λοιδορέω	to abuse, revile
λοιδορία	railing, abuse
λοιπός	remaining, the rest
λοπάς	a flat dish
λούω	to wash
Λύκος	
λυκόω	to tear like a wolf
Λύκων	
λυπέω	to give pain to, to pain, distress, grieve, vex, annoy
λύπη	pain of body
λυπρός	wretched, poor, sorry
Λύσανδρος	
λυσιτελέω	to pay what is due
λύχνον	
λύχνος	a portable light, a lamp
λύω	to loose
μαγειρεῖον	a cook-shop
μαγειρεύω	to be a cook, to cook meat
μάγειρος	a cook
μάθημα	that which is learnt, a lesson
μαίνομαι	to rage, be furious
Μακεδονία	
Μακεδών	a Macedonian
μάκρα	
μακρός	long
μάκρος	length
μαλακίζομαι	to be softened or made effeminate, shew weakness or cowardice
μαλακός	a fresh-ploughed
μάλιστα	
μᾶλλον	
μάμμη	mamma, mammy
μανθάνω	to learn
μανικός	of or for madness, mad
μάντις	one who divines, a seer, prophet
μαρτυρέω	to be a witness, to bear witness, give evidence, bear testimony
μάρτυρος	
μάρτυς	a witness
μασάομαι	to chew
μαστιγίασ'	
μαστιγόω	to whip, flog
μασχάλη	the armpit
μάχη	battle, fight, combat
μάχομαι	to fight
μέγας	big, great
μεθό	after that.
μεθύσκω	to make drunk, intoxicate, inebriate
μεθύω	to be drunken with wine
μειδιάω	
μειράκιον	a boy, lad, stripling
μείς	a month
μέλαινα	
μελάντερος	
μέλας	black, swart
μελετάω	to care for, attend to
μελέτη	care, attention
μέλι	
Μελιταῖοσ'	
Μελιταῖος	
μέλλω	to think of doing, intend to do, to be about to do
μεμψιμοιρία	
μεμψίμοιρος	complaining of one's fate, repining, querulous
μέν	on the one hand, on the other hand
μέντοι	
μένω	to stay at home, stay where one is, not stir
μερίς	a part, portion, share, parcel
μέρος	a part, share
μέση	
μέσης	
μεσοπορέω	to be half-way
μέσος	middle, in the middle
μεσόω	to form the middle, be in or at the middle
μεστός	full, filled, filled full
μετά	in the midst of, among with gen., dat., and acc.
μεταβάλλω	to throw into a different position, to turn quickly
μεταδίδωμι	to give part of, give a share of
μεταί	
μεταξύ	betwixt, between
μεταστρέφω	to turn about, turn round, turn
μεταφέρω	to carry over, transfer
μέτειμι	to be among
μετρέω	to measure in any way
μέτρον	that by which anything is measured
μή	not
μηδέ	but not or and not, nor
μηδείς	and not one
μηδέπω	nor as yet, not as yet
μῆλον	
μήν	now verily, full surely
μής	
μήτε	and not
μήτηρ	a mother
μήτις	lest any one, lest anything; that no one, that nothing
μητρίς	
μιαίνω	to stain, dye
μικρολογία	the character of a μικρολόγος, frivolity: pettiness, meanness
μικρολόγος	reckoning trifles;
μικρός	small, little
μικροφιλοτιμία	petty ambition
μικροφιλότιμος	seeking petty distinctions
μιμνήσκω	to remind, put
μισέω	to hate
μισητός	hateful
μισθός	wages, pay, hire
μισθόω	to let out for hire, farm out, let
μισθωτής	one who pays rent, a tenant
μισθωτός	hired
μνᾶ	a weight, =
μνῆμα	a memorial, remembrance, record
μοιόν	
μόλις	not scarcely
μόνος	alone, left alone, forsaken solitary
Μουσεῖον	a temple of the Muses, seat or haunt of the Muses
μοχλός	a bar
μυέω	to initiate into the mysteries
μυῖα	a fly
μύρον	sweet juice extracted form plants, sweet-oil, unguent, balsam
μυροπώλιον	a perfumer's shop
μυρσίνη	a branch or wreath of myrtle
μύρτη	
μύρτον	a myrtle-berry
μῦς	the field-mouse
μυστήριον	a mystery or secret doctrine;
μύωψ	contracting the eyes
ναυμαχία	a sea-fight
νεκρός	a dead body, corpse
νέμω	to deal out, distribute, dispense
νεοσσίον	
νέωτα	next year, for next year
νήφω	to drink no wine
νήφων	sober
νικάω	to conquer, prevail, vanquish
νομίζω	to hold or own as a custom or usage, to use customarily, practise
νουμηνία	the new moon, the first of the month
νῦν	now at this very time
νύξ	the night-season or a night
νυστάζω	to nod in sleep, to nap, slumber
ξενίζω	to receive or entertain strangers, to receive as a guest
ξένιος	belonging to a friend and guest, hospitable
ξενοδοχία	entertainment of a stranger
ξένος	
ξενόω	to make one's friend and guest
ξύλινος	of wood, wooden
ξύλον	wood
ξυλόω	to make of wood.
'ὁ	
'ὅ	
ὁ	the, that
ὀγκόω	to heap up
ὁδάω	to export and sell;
ὅδε	this
ὁδός	
ὀδούς	
ὁδόω	to lead by the right way
ὀδών	
ὄζω	to smell
οἶδα	to know
οἴκαδε	to one's home, home, homewards
οἰκεῖος	in or of the house, domestic
οἰκειόω	to make one's own
οἰκείω	
οἰκέτης	a house-slave, menial
οἰκέω	to inhabit, occupy
οἰκητός	inhabited
'οἰκία	
οἰκία	a building, house, dwelling
οἰκίον	
οἴκοι	at home, in the house
οἰκονομία	the management of a household or family, husbandry, thrift
οἰκόσιτος	taking one's meals at home, living at one's own expense, unpaid
οἰνάριον	weak or bad wine
οἶνον	
οἰνοπώλης	
οἶνος	wine
οἰνόχοος	
οἰνοχόος	a wine-pourer, cupbearer
οἴομαι	to suppose, think, deem, imagine
οἷος	such as, what sort or manner of nature, kind
οἶος	alone, lone, lonely
ὀλή	
ὀλιγαρχία	an oligarchy, government in the hands of a few families or persons
ὀλιγαρχικός	oligarchical, of, for or like oligarchy
ὅλοξ	whole, entire, complete
ὅλος	
ὅμηρος	a pledge for the maintenance of unity, a surety, a hostage
Ὅμηρος	Homer;
ὁμιλέω	to be in company with, consort with
ὁμιλία	a being together, communion, intercourse, converse, company
ὄμνυμι	to swear
ὅμοιος	like, resembling
ὁμοῖος	
ὁμοιόω	to make like
ὁμολογέω	to speak together
ὁμότροπος	of the same habits or life
ὀμώμοκα'	
ὀνειροκρίτης	an interpreter of dreams
ὄνομα	by name
ὀνομαστί	by name
ὄνος	an ass
ὄνυξ	talons;—
ὄξος	poor wine, vin-de-pays
ὄπισθεν	behind, at the back
ὁπλομάχος	fighting in heavy arms
'ὅπως	
ὅπως	as, in such manner as
'ὁρᾶς	
ὁράω	To see
ὄρεξις	desire, appetite
ὀρθός	straight
ὀρθόω	to set straight
'ὀρθῶσ'	
ὀρίγανον	marjoram
ὀρίγανος	
ὁρίζω	to divide or separate from, as a boundary
ὁρμαθός	a string, chain
ὀρνιθόσκοπος	
ὀρνιθοσκόπος	observing and predicting by the flight and cries of birds
ὅρος	a boundary, landmark
Ὀρφεοτελεστής	one who initiates into the mysteries of Orpheus
ὀρχέομαι	to dance in a row
ὅς	this, that;
ὁσημέραι	as many days as are
'ὅσοι	
ὅσος	quantus
ὅστε	who, which
ὀστέον	the
ὅστις	any one who, anything which
ὅταν	whenever
ὅτε	when
ὅτι	
'ὅτι	
ὁτιοῦν	whatsoever
οὐ	not
'οὐ	
οὗ	where
οὐδαμός	not even one, no one
οὐδαμοῦ	nowhere
οὐδέ	but not
οὐδείς	and not one
'οὐδεμία	
οὐδέποτε'	
οὐδός	
'οὐκ	
οὐλαί	barley-corns, barley-groats
οὖν	really, at all events
οὐράνη	
οὖς	auris, the ear
οὐσία	that which is one's own, one's substance, property
οὔτε	and not
οὔτι	not, I suppose . . , surely you do not mean that . .
οὔτις	no one or nobody
'οὗτος	
οὗτος	this
οὕτως	in this way or manner, so, thus
'οὐχ	
ὀφείλω	to owe, have to pay or account for
ὄφις	a serpent, snake
ὀφλισκάνω	to owe, to be liable to pay
ὄχλος	a moving crowd, a throng, mob
ὀψέ	after a long time, late
ὀψιμαθής	late in learning, late to learn
ὀψιμαθία	late-gotten learning
ὄψον	cooked meat
ὀψωνέω	to buy fish and dainties
ὀψώνης	one who buys fish or victuals, a purveyor
πάθημα	anything that befals one, a suffering, calamity, misfortune
παιδαγωγός	a boy-ward;
παιδάριον	a young, little boy
παιδάριον'	
παιδεύω	to bring up or rear a child
παιδία	
παιδιή	childish play, sport, game, pastime
παίδιον	
παιδίον	a little or young child
παίδιος	
παιδοτρίβης	one who teaches boys wrestling and other exercises, a gymnastic master
παίζω	to play like a child, to sport, play
παῖς	a child
'πάλαι	
παλαιόω	to make old
παλαίστρα	a palaestra, wrestling-school
παλαιστριαῖον	
παλαίω	to wrestle
παλιλλογία	recapitulation
πάλιν	back, backwards
παλινπήξει	
πανδοκεῖον	a house for the reception of strangers, an inn, hotel
πανδοκεύω	to receive and entertain as a host
πανδοκέω	to take upon oneself, assume
πανήγυρις	a general or national assembly
πανουργία	knavery, roguery, villany
παντοδαπός	of every kind, of all sorts, manifold
παντοποιός	ready for all, reckless
πάνυ	altogether, entirely
πάππας	
πάππης	papa
πάππος	a grandfather
παρά	from the side of, c. gen., beside, alongside of, c. dat., to the side of, motion alongside of, c. acc.
παραγγελεύς	
παραγγέλλω	to transmit as a message
παραγίγνομαι	near, attend upon
παράδειγμα	a pattern or model
παραδειπνέομαι	to go without one's dinner
'παράδοξον	
παραθεάομαι	to compare
παραινέω	to exhort, recommend, advise
παρά-καθέζομαι	
παρά-κάθημαι	
παρακαλέω	to call to
παράκειμαι	to lie beside or before
παρακολουθέω	to follow beside, follow closely
παρακούω	to hear beside
παραλαμβάνω	to receive from
παραλείπω	to leave on one side, leave remaining
παραμένω	to stay beside or near, stand by
παραρρήγνυμι	to break at the side
παρασείω	to shake at the side
παράσιτος	one who eats at another's table, one who lives at another's expense, a parasite, toad-eater
παρασκευάζω	to get ready, prepare
παρασκευαστικός	skilled in providing
παραστρέφω	to turn aside
παρατάσσω	to place side by side, draw up in battle-order
παρατηρέω	to watch closely, observe narrowly, to watch one's opportunity
παρατίθημι	to place beside
παρείας	
παρείης	a reddish-brown snake
πάρειμι	to be by or present
παρέλιπον'	
παρεμβάλλω	to put in beside, insert, interpolate, interpose
παρέρχομαι	to go by, beside or past, to pass by, pass
πάρεχε'	
παρέχω	to hold beside, hold in readiness, to furnish, provide, supply
πάρημαι	to be seated beside or by
παρίημι	to let drop beside or at the side, let fall
παρίστημι	to make to stand or to place beside
παροιμία	a by-word, common saying, proverb, maxim, saw
παρρησία	freespokenness, openness, frankness
παρών	
πᾶς	all, the whole
πᾶσις	
πάσσω	to sprinkle
πάσχω	to receive an impression from without, to suffer
πάτηρ	
πατήρ	a father
πατρίς	of one's fathers
πατρῷος	of or from one's father, coming or inherited from him
παύω	to make to cease
παχύς	thick, stout
πεζομαχία	a battle by land
πεζός	on foot
πείθω	to prevail upon, win over, persuade
πειρά	
πεῖρα	a trial, attempt, essay, experiment
πειράζω	to make proof or trial of
πειράω	to attempt, endeavour, try
πείρω	to pierce quite through, fix
πέλεκυσ'	
πέμπειν'	
πέμπτος	the fifth, oneself with four others
πέμπω	to send, despatch
πέντε	five
'περαιτέρω	
πέρθω	to waste, ravage, sack, destroy
περί	around, round about with gen., dat., and acc.
περιδέω	to bind, tie round or on
περί-εἶδον	
περίειμι	to be around
περιεργία	over-exactness
περίεργος	careful overmuch
περιίστημι	to place round
περικαθᾶραι	
περιλαμβάνω	to seize around, embrace
περιμένω	to wait for, await
περιπατέω	to walk up and down, to walk about
περιπάτησις	
περίπατος	a walking about, walking
περιρραίνω	to besprinkle all round
περισπογγίζω	to sponge all round
περιστάζομαι	to be bedewed all round
περίστασις	a standing round, a crowd standing round
περιστέλλω	to dress, clothe, wrap up
περιστερά	the common pigeon or dove
περιτρέχω	to run round and round, run round
Πέρσευς	
Πέρσης	a Persian, inhabitant of Persis
πη	in some way, somehow
πηδάω	to leap, spring, bound
πηρός	disabled in a limb, maimed
πιθανός	calculated to persuade;
πιθανόω	to make probable
πίθηκος	an ape, monkey
πίθος	a wine-jar
πίθων	a little ape
πίμπλημι	to fill full of
πίνω	to drink
πιπράσκω	to sell
πίπτω	to fall, fall down
πίσσα	pitch
πιστεύεισ'	
πιστεύω'	
πιστεύω	to trust, trust to or in, put faith in, rely on, believe in
πλανάω	to make to wander, lead wandering about
πλεθρίζω	to run the
πλειστάκις	mostly, most often, very often
πλεῖστος	most, largest
πλείων	more, larger
πλέος	full.
πλευρά	a rib
πλευρόν	a rib
πλέω	to sail, go by sea
πλέως	full of
πληγάς	
πληγή	a blow, stroke
πλῆθος	a great number, a throng, crowd, multitude
πλήθω	to be or become full of
πλήν	more than
πλήρωμα	a full measure
πλησιάζω	to bring near
πλησίος	near, close to
πλοκάς	
πλοκή	a twining: anything woven, a web
πλύνω	to wash, clean
πλώιμος	fit for sailing
πνεῦμα	a blowing
πόα	grass, herb
ποδαπός	from what country?
ποιέω	to make
ποίησις	a making, fabrication, creation, production
ποιητικός	capable of making, creative, productive
ποῖος	of what nature? of what sort?
ποιός	of a certain nature, kind or quality
πόλει'	
πολεμέω	to be at war or go to war, make war
πολεμικός	of or for war
πολέμιος	of or belonging to war
πολέω	to go about, range over
πολιά	grayness of hair
πολίζω	to build a city, to build
πόλιν'	
πολιός	gray, grizzled, grisly
πόλις	a city
πολίτης	a member of a city or state
πολλάκις	many times, often, oft
Πολυκλέης	
πολυκοιρανία	
πολυκοιρανίη	the rule of many
Πολυπέρχων	
πολύς	many
πομπεύς	one who attends or escorts, a conductor, guide
πομπεύω	to conduct, escort
πομπή	conduct, escort, guidance
πονηρία	a bad state or condition, badness
πονηρός	toilsome, painful, grievous
πόπανον	a round cake
ποππύζω	to whistle, cheep or chirp
πορεύω	to make to go, carry, convey
πορίζω	to carry: to bring about, to furnish, provide, supply, procure, cause
πορνοβοσκέω	to keep a brothel
πορνοβοσκός	a brothel-keeper
Ποσειδῶν	Poseidon
ποσιδεών	
πόσος	bulk)
ποσός	of a certain quantity or magnitude
ποσόω	to reckon up, count
πότε	when? at what time?
ποτέ	at some time or other, at some time
'πότε	
πότερος	whether of the two?
ποτήριον	a drinking-cup, wine-cup
ποτός	drunk, fit for drinking
πότος	drinking, a drinking-bout, carousal
πού	anywhere, somewhere
που'	
ποῦ	where?
πούς	a foot
πρᾶγμα	that which has been done, a deed, act
πρᾶγμα'	
'πράγματα	
πραγματεύομαι	to busy or exert oneself, take trouble
πρᾶξις	a doing, transaction, business
πρᾶος	Mild, soft, gentle, meek
πράσσω	to pass over
πρίαμαι	to have
πρίν	comparative
πρό	before
προαιρέω	to bring forth, produce from one's stores
προαποστέλλω	to send away, dispatch beforehand
προβάλλω	to throw before, throw or toss to
προεῖδον	to see beforehand, catch sight of
πρόθυμος	ready, willing, eager, zealous
προίξ	a gift, present
προκόλπιον	a robe falling over the breast
προμανθάνω	to learn beforehand
προμετωπίδιος	before or on the forehead
προοιμιάζομαι	to make a prelude, preamble or preface
προπέμπω	to send before, send on or forward
πρός	motion from
'πρός	
προσαγορεύω	to address, greet, accost
προσάγω	to bring to or upon
προσαιρέομαι	to choose for oneself
προσανατρίβομαι	to rub oneself upon or against
προσαπαιτέω	to require from as a duty besides
προσβάλλω	to strike or dash against
προσδιηγέομαι	to narrate besides
πρόσειμι	
προσεπιγράφω	to write on besides
πρόσ-ἐρυγγάνω	
προσέρχομαι	to come or go to
προσέχω	to hold to, offer
'προσήγγελκα'	
προσήκω	to have arrived at
προσθέω	to run towards or to
προσίημι	to send to or towards, let come to
προσίστημι	to place near, bring near
προσκαλέω	to call to, call on, summon
πρόσκειμαι	to be placed or laid by or upon, to lie by or upon
προσκεφάλαιον	a cushion for the head, pillow
προσκοπέω	to see or consider beforehand, weigh well, look to, provide for
προσκυνέω	to make obeisance
προσλαλέω	to talk to or with
προσπατταλῶσαι	
προσπίπτω	to fall upon, strike against
προσποιέω	to make over to
προσποίησις	a taking something to oneself, acquisition
πρόσπταισμα	a stumble against something, a stumble
προσπταίω	to strike against
προσπτύω	to spit upon
προσστάζω	to drop on, shed over
προστάσσω	to place or post at
προστατέω	to stand before, be ruler over, domineer over
προστίθημι	to put to
προστρέχω	to run to or towards, come to
προσφέρω	to bring to or upon, apply to
προσφοιτάω	to go or come to frequently, to resort to
προσφορά	a bringing to, applying, application
πρόσωθεν	from afar
προσωπεῖον	a mask
πρόσωπον	the face, visage, countenance
πρότερος	prae.
προτρέχω	to run forward
προχωρέω	to go or come forward, advance
προώμεθα'	
πρύτανις	a prince, ruler, lord, chief
'πρῶτον	
πρῶτος	
πτύω	to spit out or up
πυανοψιών	
πύθω	to make rot, to rot
πυκνός	close, compact
πύλη	one wing of a pair of double gates
πύνδαξ	the bottom
πυνθάνομαι	to learn by hearsay or by inquiry
πυρέσσω	to be ill of a fever
πυρός	wheat
πυρόω	to burn with fire, burn up
πω	up to this time, yet
πώγων	the beard
πωλέομαι	to go up and down, go to and fro
πωλέω	to exchange or barter
πώλη	
πώλης	a seller, dealer
πῶσ'	
πῶς	how? in what way or manner?
πως	in any way, at all, by any means
ῥᾴδιος	easy, ready, easy to make or do
ῥαίδιον	
ῥαφανιδόω	to thrust a radish up the fundament
ῥαφανίς	the radish
ῥῆσις	a saying, speaking, speech
ῥήτωρ	a public speaker, pleader
ῥιγέω	to shiver or shudder with cold
ῥιγόω	to be cold, shiver from cold
ῥίπτω	to throw, cast, hurl
ῥόδον	the rose
Ῥόδος	Rhodes
ῥύγχος	a snout, muzzle
ῥυπαίνω	to defile, disfigure, disparage
Σαβάδιος	
Σαβάζιος	Bacchus
σαλπιγκτής	a trumpeter
σαλπικτής	
'σαπρόν	
σαπρός	rotten, putrid
σημαίνω	to shew by a sign, indicate, make known, point out
σημεῖον	a sign, a mark, token
σήμερον	to-day
Σικελικός	Sicilian
σίκυος	a cucumber or gourd
σιτίζω	to feed, nourish, fatten
σιτοδεία	want of corn or food
σιτοποιός	of grinding and baking
σιωπάω	to be silent
σιωπή	silence
σιώπησις	
σκέλος	the leg
σκέπτομαι	to look about, look carefully
σκευάζω	to prepare, make ready
σκεῦος	a vessel or implement of any kind
σκηνάω	to dwell, live
σκηνέω	to be or dwell in a tent, to be encamped
σκηνή	a covered place, a tent
σκίλλα	a squill, sea-onion
σκολιός	curved, winding, twisted, tangled
σκόροδον	garlic
σκυθρωπάζω	to look angry or sullen, be of a sad countenance
σκύλαξ	a young dog, whelp, puppy
σκυτοδέψης	a leather-dresser, currier
σκώπτω	to hoot, mock, jeer, scoff at
σμικρός	
σοβέω	to scare away
σός	thy, thine, of thee
σοφιστής	a master of one's craft or art, an adept
σπαθάω	to strike home the woof with the
σπάθη	a flat blade used by weavers
σπένδω	to pour or make a drink-offering
σπεύδω	to set a-going, to urge on, hasten, quicken
σπουδάζω	to make haste
σπουδή	haste, speed
στάδιον	a stade, =
στάδιος	standing firm
σταθμάω	to measure by rule
σταθμόν	
σταθμός	a standing place
στέμμα	a wreath, garland
στεφάνη	anything that encircles
στεφανόω	to be put round
στέφω	to put round
στηλίδιον	
στοά	a roofed colonnade, piazza, cloister
στόμα	the mouth
στρατεύω	to serve in war, serve as a soldier, do military service, take the field, march
στρατηγέω	to be general
στρατηγός	the leader or commander of an army, a general
στρατιώτης	a citizen bound to military service;
στρέφω	to turn about or aside, turn
στρογγύλος	round, spherical
στρῶμα	anything spread or laid out for lying or sitting upon, a mattress, bed
'σύ	
σύ	
συγγενικός	congenital, hereditary
συγγνώμη	acknowledgment, confession
συγγράφω	to write or note down
συγκρούω	to strike together
σῦκον	the fruit of the
συκοτραγέω	to eat figs
συκοφαντέω	to accuse falsely, slander, calumniate
συκοφάντης	a false accuser, slanderer
συλλαβή	that which holds together
συλλέγω	to collect, gather
συλλυπέω	to hurt or mortify together
συμβαίνω	to stand with the feet together
συμβάλλω	to throw together, dash together
σύμβολον	a sign or token by which one infers
σύμβολος	an augury, omen
συμμαχέω	to be an ally, to be in alliance
συμπαίζω	to play or sport with
συμπρεσβευτής	a fellow-ambassador
συμφέρω	to bring together, gather, collect
συμφωνέω	to agree in sound, be in harmony
συνάγω	to bring together, gather together, collect, convene
συνακολουθέω	to follow closely, to accompany
συναποδημέω	to be abroad together
συναρκέομαι	to acquiesce along with
συναρπάζω	to seize and carry clean away
συναυξάνω	to increase or enlarge along with or together
συναχθεσθησομένους	
συνδειπνέω	to dine or sup with
συνδικάζω	to be assessor to a judge
συνδιοικέω	to administer together with
συνεδρεύω	to sit together, sit in council
σύνειμι	
συνεπιλαμβάνομαι	to take part in together, have a share in, partake in
συνεπιμελέομαι	to join in taking care of or attending to
συνέρχομαι	to go together or in company
συνέχονται'	
συνήδομαι	to rejoice together
συνήθης	dwelling or living together, accustomed or used to each other
συνηχέω	to sound together or in unison
σύνθεσις	a putting together, composition, combination
συνθεωρέω	to act as
συνίημι	to bring or set together
συνίστημι	to set together, combine, associate, unite, band together
σύν-κάθημαι	
συνοδοίπορος	a fellow-traveller
συνοδοιπόρος	
συντάσσω	to put in order together
συντερετίζω	to whistle an accompaniment
συνωνέομαι	to collect by offering money
συρίζω	to play the σῦριγξ, to pipe
συσσιτέω	to mess with
σφαιριστήριον	a ball-court
σφόδρα	very, very much, exceedingly, violently
σφύζω	to throb, beat
σχεδόν	close, near, hard by, nigh
σχετλιάζω	to complain of hardship, to complain angrily, inveigh bitterly
σχολάζω	to have leisure or spare time, to be at leisure
σχολή	spare time, leisure, rest, ease
σώζω	to save, keep
σῶμα	the body
Σωσίδημος	
Σωσίης	
Σωσίστρατος	
ταινία	a band, riband, fillet
ταλαίπωρος	suffering, miserable
τάλαντον	a balance
ταμιεῖον	a treasury
τάξις	an arranging
ταράσσω	to stir, stir up, trouble
ταριχοπώλιον	
τάριχος	
ταὐτός	
ταχέως	
ταχίστην'	
τάχος	swiftness, speed, fleetness, velocity
'ταχύ	
ταχύς	quick, swift, fleet
τε	and
τελευτάω	to complete, finish, accomplish
τελέω	to complete, fulfil, accomplish
τέλλω	to make to arise, accomplish
τελωνέω	to be a tax-gatherer
τεράστιος	monstrous
τερετίζω	to whistle
τέρπω	to satisfy, delight, gladden, cheer
τέσσαρες	four
τετραίνω	to bore through, pierce, perforate
τετράς	the fourth day
τεχνίτης	an artificer, artisan, craftsman, skilled workman
τῇ	here, there
τηνικάδε	at this time of day, so early
Τίβειε	
τίθημι	to set, put, place
τίκτω	to bring into the world
τιμάω	to pay honour to, hold in honour, to honour, revere, reverence
τιμή	that which is paid in token of worth or value
τιμωμένουσ'	
τις	any one, any thing, some one, some thing;
'τίς	
τίς	who? which?
τίτθη	a nurse
τίτυρον	
'τό	
τοιόσδε	such a
τοιοῦτος	such as this
τόκος	a bringing forth, childbirth, parturition
τοσοῦτος	so large, so tall
τότε	at that time, then
'τουτί	
τραγηματίζω	to eat sweetmeats
τράγος	a he-goat
τράγω	
τραγῳδέω	to act a tragedy
τραγῳδός	a goat-singer
τράπεζα	four-legged a table
τραῦμα	a wound, hurt
τραυματίας	
τραυματίης	a wounded man
τραχηλίζω	of wrestlers
τρεῖς	
τρέπω	to turn or direct
τρέφω	to thicken or congeal
τρέχω	to run
τρέω	to flee from fear, flee away
τρία	
τριάκοντα	thirty
τρίβων	practised or skilled in
τριηραρχέω	to be a τριήραρχος, to command a trireme
τριηραρχία	the command of a trireme
τρίοδος	a meeting of three roads
τρισσός	threefold
τρίχα	threefold, in three parts
τρίχαλκον	a coin worth three
τρίχωμα	a growth of hair, hair
τρόπος	a turn, direction, course, way
τροπόω	to furnish the oar with its thong
τροχάζω	to run like a wheel, to run along, run quickly
τρώγω	to gnaw, nibble, munch
τυγχάνω	to hit
τύπον	
τύπος	a blow
τύχη	the good which man obtains
τῷ	therefore, in this wise, thereupon
ὑβρίζω	to wax wanton, run riot
ὑγιής	sound, healthy, hearty, sound in
ὑγρός	wet, moist, running, fluid
ὕδωρ	water
'υἱός	
υἱός	A son
Ὑμήττιος	
ὑπακούουσι'	
ὑπακούω	to listen, hearken, give ear
ὕπειξις	
ὑπέμνησασ'	
ὑπέρ	over, above, w. gen, over, beyond, w. acc.
ὑπερβολή	a throwing beyond
ὑπερημερία	a being over the day
ὑπερηφανία	arrogance, disdain
ὑπερήφανος	overweening, arrogant, haughty
ὑπερτρέχω	to run over or beyond, outrun, escape
ὕπνον	
ὕπνος	sleep, slumber
ὑπνόω	to put to sleep
ὑπό	from under, by, c. gen. under, c. dat., towards c. acc.
ὑποβάλλω	to throw, put or lay under
ὑπό-δέω	
ὑπόδημα	a sole bound under the foot with straps, a sandal
ὑποζύγιον	a beast for the yoke, a beast of burden
ὑποκορίζομαι	to talk child's language
ὑπολαμβάνω'	
ὑπολαμβάνω	to take up by getting under
ὑπόληψις	a taking up
ὑπομένω	to stay behind, survive
ὑπομιμνήσκω	to remind
ὑπόμνημα	a remembrance, memorial
ὑπομονή	a remaining behind
ὑπό-ὁδάω	
ὑπό-ὁδόω	
ὑποπρίασθαι	to buy under the price
ὑπό-στόρεννυμι	
ὑποτίθημι	to place under
ὑποχώρημα	a downward evacuation
ὗς	the wild swine
ὑστεραῖος	on the day after, the next day
ὕστερον	
ὕστερος	latter, last
ὑφή	a web
ὕω	to send rain, to rain
φαγεῖν	to eat, devour
φαίνω	to bring to light, make to appear
φακῆ	a dish of lentils
φακός	lentil
φανερός	open to sight, visible, manifest, evident
φάσκω	to say, affirm, assert
φαῦλος	easy, slight
φειδωλία	
Φειδωνείῳ	
φέρω	to bear
φεύγω	to flee, take flight, run away
φημί	to declare, make known
φθέγγομαι	to utter a sound or voice
φιλαρχία	love of rule, lust of power
φιλέταιρος	fond of one's comrades or partisans, true to them
φιλέω	to love, regard with affection
φιλοπονηρία	a love of bad men and actions
φιλοπόνηρος	a friend to bad men
φιλοπονία	love of labour, laboriousness, industry
φίλος	loved, beloved, dear
φῖλος	
φιλοσοφέω	to love knowledge, pursue it, philosophise
φιλόσοφος	a lover of wisdom
φιλοτιμία	the character of the
φίλων	
φοβερός	fearful
φοβέω	to put to flight
φοῖνιξ	a purple-red, purple or crimson
φορεύς	a bearer, carrier
φορέω	to bear or carry constantly, to be used to carry
φορτίον	a load, burden
φράτηρ	a member of a φράτρα&colon; in pl. those of the same φράτρα
φράτωρ	
φρίσσω	to be rough or uneven on the surface, to bristle
φυλάσσω	to keep watch and ward, keep guard
φυλέτης	one of the same tribe, a tribesman
φύς	a son;
φύσις	the nature, natural qualities, powers, constitution, condition
φυτεύω	to plant
φύω	to bring forth, produce, put forth
φωνέω	to produce a sound or tone
φωνή	a sound, tone
χαλεπός	hard to bear, painful, sore, grievous
χαλκεῖον	a smith's shop, forge, smithy
χάλκεος	of copper or bronze, brasen
χαλκός	copper
χαλκοῦς	a copper coin
χαλκόω	to make in bronze
χαμαί	on the earth, on the ground
'χαρίζοιο	
χαρίζομαι	to say or do something agreeable
χάρις	Grace
χειμών	winter
χείρ	the hand
χειρίζοντος	
χειροτονέω	to stretch out the hand
χείρων	worse, meaner, inferior
χελιδών	the swallow
χέω	to pour
χθές	yesterday
χιτωνίσκος	a short frock
χολή	gall, bile
χολίκιον	
χορός	a round dance
χόω	to throw or heap up
χράομαι	consulting or using an oracle
χραύω	to scrape, graze, wound slightly
χράω	
χρέος	that which one needs must pay, an obligation, debt
χρή	it is fated, necessary
χρῆμα	a thing that one uses
χρηματίζω	to negotiate, transact business, have dealings
χρηννύειν	
χρηννύναι	
χρήσιμος	useful, serviceable, good for use, good, apt or fit
χρηστός	useful, good of its kind, serviceable
'χρηστοῦ	
χρῖσμα	anything smeared on
χρόνος	time
χρυσίον	a piece of gold
χρώς	the surface of the body, the skin
χύτρα	an earthen pot, a pot for boiling, pipkin
χωρέω	to make room for another, give way, draw back, retire, withdraw
χωρίον	a particular place, a place, spot, district
χωρίς	separately, asunder, apart, by oneself or by themselves
ψευδής	lying, false
ψευδολογία	a false speech, falsehood
ψεῦδος	a falsehood, untruth, lie
ψεύδω	to cheat by lies, beguile
ψῆφος	a small stone, a pebble, rubbed and rounded
ψυχή	breath
ψυχρός	cold, chill
'ὦ	
ὦ	O! oh!
ᾠδεῖον	the Odeum
ὠδίνω	to have the pains or throes of childbirth, to be in travail or labour
ὠθέω	to thrust, push, shove, force onwards or away
Ὠιδεῖον	
ὠνέομαι	to buy, purchase
ὠνητής	a buyer, purchaser
ὠνητιᾶν	
ὠνητός	bought
ὡς	thus, as, so that, since
'ὡς	
ὦσις	
ὥσπερ	just as if, even as
ὥστε	as, as being