a	from, away from, out of
ab	
abdico	
abditus	hidden, concealed, secret
abduco	to lead away, take away, carry off, remove, lead aside
abeo	to go from, go away, go off, go forth, go, depart
abhorreo	to shrink back from, have an aversion for, shudder at, abhor
abicio	to throw from one, cast away, throw away, throw down
ablatio	
abscido	to cut off, hew off
absento	
abstractus	
abstraho	
absum	to be away from, be absent
abundo	to overflow, stream over
abutor	
accedo	sync
accelero	
accepta	
accepto	to take, receive
acceptum	the receipt
accessus	a coming near, approach
accido	
accipio	to take without effort, receive, get, accept
acer	
acerbitas	bitterness, harshness, sourness
acerbus	harsh, bitter, unripe
acieris	
acies	a sharp edge, point, cutting part
acriter	sharply, fiercely
acta	the sea-shore, sea-beach
acte	
actio	a putting in motion
actuaria	a swift boat
actuarium	
actuarius	easily driven, swift
actum	a deed, transaction, proposition, decree, law
actus	a driving, impulse, setting in motion
acuo	to sharpen, whet, point, make sharp
acutus	sharpened, pointed, sharp, cutting
ad	to, toward
adaequo	to make equal, equalize, level with
adaugeo	to increase by adding, augment
addico	
addo	to put to, place upon, lay on, join, attach
adduco	to lead to, bring to, bring along
a-demitto	
ad-emitto	
ad-emo	
adeo	
ad-eximo	
ad-gero	
adhaereo	to cleave, adhere, stick to
adhaeresco	to cleave, stick, adhere
adhibeo	to hold toward, turn to, apply, add to
adhortatus	
adhortor	to encourage, exhort, stimulate, rouse, urge
adhuc	
adicio	to throw to, cast to, fling at, put, put to, set near
adigo	to drive, urge, bring by force, take
aditus	a going to, drawing near, approach, access
administratio	aid, help, co-operation
administro	to manage, control, guide, superintend, execute, regulate, rule, direct
admiror	to regard with wonder, admire
admisceo	
admissum	a voluntary fault, trespass, crime
admitto	to send to, let go, let loose, let come, admit, give access
admixtus	
admodum	to the proper limit, to full measure
admoneo	to bring to mind, remind, suggest, put in mind of
admonitum	a reminding, warning
admonitus	a reminding, suggestion, request
admoveo	
adnato	to swim up
adorio	
adorior	to approach as an enemy, fall upon, assail, assault, attack
adorno	to provide, furnish, fit out, equip, make ready
ad-pello	
ad-peto	
ad-pulso	
ad-rapio	
ad-scribo	
ad-servo	
adsum	to be at, be present, be at hand
ad-tenuo	
ad-tribuo	
adulatio	a fawning
adulescens	growing, near maturity, young, youthful
adulescentia	youth
adveho	
advenio	to come to, reach, arrive at
advento	to advance, press forward, march on, approach
adventus	a coming, approach, arrival
adverro	
adversa	
adversaria	
adversarius	opposite, hostile, contrary
adverso	
adversum	misfortune, calamity, disaster
adversus	an enemy, opponent
adverto	to turn to, turn towards, direct
advoco	to call, summon, invite
advolo	to fly to, fly towards
adytum	the inmost recess, holiest place
adjaceo	
adjicio	
adjuncta	
adjungo	
adjuto	
adjutor	
adjuvo	
aedificium	a building, edifice, structure
aedifico	to build, erect a building
aedilitas	the office of an aedile, aedileship
a-edo	
aeger	unwell, ill, sick, diseased, suffering, feeble
aegreo	
aegror	
aegrum	
aeque	equally, in like manner, just as, in an equal degree, to the same extent
aequitas	uniformity, evenness
aequo	to make equal, equalize
aequum	a plain, level
aequus	even, plain, level, flat
aer	the air, atmosphere, sky
aera	
aerarium	part of the temple of Saturn at Rome, in which the public treasure was kept, the treasury
aerarius	
aeratus	of bronze
aestas	summer
aestimatio	the determination of value, value, valuation, appraisement
aestimo	to determine the value of, estimate, value, rate, appraise
aestus	an agitation, glow, heat, rage of fire
aetas	the life of man, age, lifetime, years
affectus	
affero	
afficio	
affingo	
affinitas	
affligo	
ager	productive land, a field, farm, estate, arable land, pasture
agger	a mass, heap, collection, pile
aggero	to make a mound of, heap up, pile
aggredior	to approach
aggressus	
agmen	that which is driven
agnosco	
ago	to put in motion, move, lead, drive, tend, conduct
agrius	
alacer	lively, brisk, quick, eager, excited, glad, happy
alacritas	liveliness, ardor, eagerness, alacrity, cheerfulness, encouragement
alarius	of the wing
alba	
albeo	to be white
album	white color, whiteness
albus	white
alebria	
alia	
alias	at another time, some other time, at other times
alienatio	a transfer, surrender
alieno	to make strange, make another's, transfer, make over, part with
alienum	the property of a stranger, another's possessions
alienus	
alio	to another place, to another, elsewhere
aliqua	by any way, in any direction, any whither
aliquamdiu	
aliqui	some, any
aliquis	any end
aliquo	to some place, somewhere, anywhither
aliquot	some, several, a few, not many, a number
alius	another, other, different
allido	
allium	
alluo	
alo	to feed, nourish, support, sustain, maintain
alter	one, another, the one, the other
alterco	to wrangle
altercor	to alternate in discussion, dispute, wrangle
alteruter	one or the other, either this or that, one of two
altitudo	height, altitude
alto	
altum	
altus	nourished, grown great, high, lofty, tall
ambitus	a going round, moving about, revolution
ambo	both
amica	a female friend
amicitia	friendship
amico	
amicus	
amitto	to send away, dismiss, part with
amo	to love
amplector	to twine around, encircle, encompass, embrace
amplexus	an encircling, surrounding, circuit
amplus	of large extent, great, ample, spacious, roomy
an	or
anceps	that has two heads, two-headed
ancora	an anchor
ancorarius	of an anchor
angulo	
angulus	an angle, corner
angustia	narrowness, straitness
angustiae	
angustio	
angusto	to make narrow, straiten
angustum	a narrow place
angustus	narrow, strait, contracted
anima	air, a current of air, breeze, breath, wind
animadversio	investigation, inquiry
animadverto	to direct the mind, give attention to, attend to, consider, regard, observe
animo	
animus	the rational soul
anno	
annona	the year's produce
annua	
annuo	
annus	a year
annuum	
annuus	of a year, lasting a year
ante	before, in front, forwards
antea	before, earlier, formerly, aforetime, previously
antecedo	to go before, get the start, precede
antecursor	a forerunner
anteeo	to go before, precede
antefero	to bear in front, carry before
antesignanus	a leader in battle
antiquitus	in former times, of old, anciently, long ago
antiquo	to reject, not to pass
antiquus	ancient, former, of old times
aperio	to uncover, lay bare
aperto	
apertum	
apertus	without covering, uncovered
apparatus	
appario	
appellatio	an addressing, accosting
appello	
appeto	to strive for, reach after, grasp at
applico	to join, connect, attach, add
appropinquo	to come near, approach, draw nigh
apto	to adapt, fit, apply, adjust
aptus	fastened, joined, fitted, bound, attached
apud	
aqua	water
aquarium	
aquarius	of water, watery
aquator	a water-carrier
aquila	an eagle
aquilifer	an eaglebearer, standard-bearer, first centurion of the first cohort in a legion
aquilus	
aquor	to fetch water
arbiter	a spectator, beholder, hearer, eye-witness, witness
arbitrarius	
arbitratus	mediatiou, arbitration
arbitrium	a judgment, decision of an arbitrator
arbitror	to testify on information and belief, depose to one's best knowledge
arbor	
arca	a place for safe-keeping, chest, box
arcanum	
arcanus	secret, trusty, silent
arcesso	to cause to come, call, send for, invite, summon, fetch
arcuballista	
ardeo	to be on fire, burn, blaze, be burned
arduum	a steep place, steep
arduus	steep
argentum	silver
argumentum	an argument, evidence, ground, support, proof
arma	implements, outfit, instruments, tools
armamenta	implements, utensils
armarium	a closet, chest, safe
armatura	armor, equipment
armatus	
armo	to furnish with weapons, arm, equip
armus	the shoulder
arrogantia	
arrogo	
artificium	a profession, trade, employment, art
arx	a castle, citadel, fortress, stronghold
ascendissent	
ascendo	to mount, climb, ascend, scale, go up
ascensus	a climbing, ascent
asia	
asper	without hope, adverse, calamitous, troublesome, cruel, perilous
aspero	to make rough
asperum	
aspicio	to look at, look upon, behold, look
asser	a stake, post
assero	
assis	
assuefacio	
assum	
assus	roasted
asto	to stand at, take place near
astruo	to build in addition, add to
a-sum	
at	but, but on the other hand, but meanwhile
atque	and, as well as, together with
attigo	
attingo	to touch, come in contact with
attribuo	to assign, allot, make over
attulo	
auctionor	to hold a public sale, sell by auction
aucto	to increase much, prosper
auctor	a promoter, producer, father, progenitor
auctoritas	origination, production
auctoro	to bind, oblige
auctumnus	
audacia	daring, courage, valor, bravery, boldness, intrepidity
audacter	boldly, courageously
audax	daring, bold, courageously, spirited
audeo	to venture, dare, be bold, dare to do, risk
audio	to hear
auditus	the hearing, sense of hearing
aufero	to take away, bear off, carry off, withdraw, remove
augeo	to increase, augment, enlarge, spread, extend
aulus	
aura	the air
auris	the ear
auro	
aurum	gold
auster	the south wind
ausum	a bold deed, reckless act
aut	or
autem	but, on the other hand, on the contrary, however
autor	
autumnum	
auxilia	
auxiliares	
auxiliaris	aiding, helping, assistant, auxiliary
auxilio	
auxilior	to give help, aid, assist, succor
auxilium	help, aid, assistance, support, succor
avaritia	inordinate desire, greed, avarice, covetousness
aversum	
averto	to turn away, avert, turn off, remove
axis	an axle, axle-tree
Acarnania	
Achaia	
Achaicus	Achaean, Grecian
Achaius	Grecian
Achillas	
Acilius	
Acutius	
Adbucilli	
Aeginium	
Aegyptius	Egyptian
Aegyptus	
Aetoli	
Aetolia	
Aetolius	
Aetolus	
Afraniani	
Afranianus	
Afranius	
Africa	
Africanus	
Africus	
Ahenobarbus	
Alba	
Albici	
Albicorum	
Albicos	
Alesia	
Alexandrea	
Alexandrini	
Alexandrinus	
Allobrogem	
Allobroges	
Amantia	
Amantini	
Amanus	
Ambracia	a town of Epirus
Ambracius	
Amphilochi	
Amphilochus	
Amphipolis	
Ampius	
Anas	
Ancona	
Androsthenes	
Anquillaria	
Antiochea	
Antiochenses	
Antiochensis	
Antiochus	
Antonianae	
Antonianus	
Antonius	a gentile name
Apollonia	
Apolloniatibus	
Apolloniatium	
Appulia	
Apsus	
Aquitani	
Aquitanus	
Arecomicorum	
Arelate	
Ariminum	
Ariobarzanes	
Arretium	
Asculum	
Asia	
Asiaticus	
Asius	
Asparagium	
Athamania	
Athenae	Athens
Attianus	
Attius	
Aulus	
Ausetani	
Ausetanus	
Auximates	
Auximum	
Avaricum	
balbus	stammering, stuttering
barbara	
barbarum	
barbarus	of strange speech, speaking jargon, unintelligible
bellicosus	warlike, martial, valorous, given to fighting
bellis	
bellor	to war, fight
bellum	war
bellus	pretty, handsome, neat, pleasant, fine, agreeable
bene	
benef	
beneficiarii	soldiers exempt from common labor, a body-guard
beneficiarius	
beneficium	a favor, benefit, service, kindness
beneficus	generous, liberal, serviceable, beneficent, bountiful
benevolentia	good-will, benevolence, kindness, favor, friendship
benus	
bibulus	given to drink, drinking freely
biduus	
biennium	a period of two years, two years
bini	two by two, two to each, two each, two at a time
bipedale	
bipedalis	of two feet, measuring two feet
biremis	with two oars, two-oared
bis	twice, at two times, on two occasions
bonae	
bonum	
bonus	good
breve	
brevi	in a little while, in a short time, soon
brevis	short
brevitas	shortness
brutus	heavy, inert, immovable
bucinator	a trumpeter
Bagrada	
Balbus	
Belica	
Bessi	
Bessus	
Bibulus	
Bithynia	
Bithynion	
Bithynius	
Boeotia	
Boeotius	Boeotian
Britannia	
Brundisini	
Brundisino	
Brundisium	
Bruttii	
Bruttius	
Brutus	
Buthrotos	
Buthrotum	
Byllidenses	
Byllis	
c	
ca	
caaderent	
cadaver	a dead body, corpse, carcass
cado	to fall, fall down, descend
caecum	
caecus	not seeing, blind
caedes	a cutting-down
caedo	to cut, hew, cut down, fell, cut off, cut to pieces
caelo	to engrave in relief, make raised work, carve, engrave
caelum	the sky, heaven, heavens, vault of heaven
caelus	
caesa	
caespes	a turf, cut sod
caesum	
caesus	
caetrati	
caetratus	armed with a caetra, shield-bearing
calamitas	loss, injury, damage, mischief, harm, misfortune, calamity, disaster
calidum	
calidus	warm, hot
calo	
campaneus	
campe	
campestre	
campestres	
campus	a plain, field, open country, level place
canalis	a pipe, groove, channel, canal, passage for a fluid, conduit
cani	
caninus	of a dog, canine
canis	a dog
cano	to utter melodious notes, make music, sing, sound, play
cantabrum	
canus	white, hoary
capero	
capio	to take in hand, take hold of, lay hold of, take, seize, grasp
capitum	
capreola	
capreolus	a wild goat, chamois, roebuck
captiva	a female captive, woman prisoner
captivus	taken prisoner, captive
capto	to strive to seize, lay hold of, catch at, snatch, chase, hunt, capture
captus	
capus	
caput	the head
carina	a keel
caro	flesh
caros	
carpo	to pick, pluck, pluck off, cull, crop, gather
carrum	
carrus	a wagon for freight, baggagewagon
carus	dear, precious, valued, esteemed, beloved
casses	
cassus	empty, void, hollow
castellum	a castle, fort, citadel, fortress, stronghold
castigo	to set right, correct, chastise, punish, blame, reprove, chide, censure, find fault with
castor	the castor, beaver
castra	a military camp, encampment
castro	to emasculate
castrum	a fortified place, castle, fort, fortress
casus	a falling, falling down, fall
catapulta	an engine for hurling missiles, catapult
catus	clear - sighted, intelligent, sagacious, wise
causa	a cause, reason, motive, inducement, occasion, opportunity
caveant	
caveo	to be on one's guard, take care, take heed, beware, guard against, avoid
caverna	a hollow, cavity, cave, cavern, grotto, hole
cavo	to make hollow, hollow out, excavate
cc	
ccc	
cccc	
ccxx	
ccxxx	
ce	here, there
cedo	
celer	swift, fleet, quick, speedy
celeritas	swiftness, quickness, speed, celerity
celeriter	quickly, swiftly, speedily, in haste, immediately, promptly
celero	to quicken, hasten, accelerate
celo	to hide from, keep ignorant of, conceal from
censeo	to tax, assess, rate, estimate
censor	the title of a Roman magistrate, instituted
cento	a rag cushion, patchwork quilt
centuria	a division of a hundred, century, company
centuriatim	by companies
centurio	
ceraunius	
cerno	to separate, part, sift
certamen	a decisive contest, measuring of forces, struggle, strife, dispute, dissen
certioro	
certo	
certus	determined, resolved, fixed, settled, purposed, certain
ceter	
ceterum	for the rest, in other respects, else, otherwise
ceterus	the other, remainder, rest
chara	a wild cabbage
cibaria	food, nutriment
cibarium	
cibarius	given as rations, made as an allowance
cilicium	a covering, originally of Cilician goat's hair, used by soldiers and seamen
cingo	to go around, surround, encompass, environ, gird, wreathe, crown
cingulum	
circiter	about, not far from
circito	
circo	
circos	
circuitor	
circuitus	a going round, circling, revolving, revolution
circularis	
circulo	
circulor	to form a circle, gather in a company
circum	around, round about, all around
circumcludo	to shut in, enclose, surround
circumdati	
circum-dedo	
circum-do	
circumdo	to place around, cause to surround, set around
circumduco	to lead around, draw around
circumductum	
circumeo	to go around, travel around, march around
circumfundo	to pour around
circummitto	
circummunio	to wall around, fortify, secure
circummunitio	an investing, circumvallation
circumque	
circumscribo	to encircle, circumscribe, enclose in a ring
circumsisto	to take one's stand around, surround, stand around
circumvallo	to surround with a wall, circumvallate, blockade, invest, encompass
circumvehor	
circumvenio	to come around, be around, encircle, encompass, surround
circumventor	
circumjacio	
circumjecta	
circus	a circular line, circle
citatus	quick, rapid, speedy, swift, in haste, at full speed
citer	
cito	to put in quick motion, rouse, excite
citra	on this side, on the hither side
citro	to this side
citrum	
civile	
civilis	of citizens, civil, civic
civis	a citizen
civitas	the condition of a citizen, citizenship, freedom of the city, membership in the community
clam	secretly, privately, covertly, in secret
clamo	to call, cry out, shout aloud, complain aloud
clamor	a loud call, shout, cry
clareo	to be bright, shine
clarus	clear, bright, shining, brilliant
classiarii	
classiarius	of the navy
classis	a class, great division
claudeo	
claudo	to limp
claudus	limping, halting, lame
clausum	an enclosure
clava	a knotty branch, rough stick, cudgel, club
clavis	a key
clavus	a nail
clemens	mild, calm, gentle
clementer	quietly, placidly, tranquilly, calmly
cliens	a personal dependant, client
clientela	clientship, patronage, protection, the relation of a client to his patron
cliva	
clivus	a declivity, slope, ascent, hill, eminence
clupea	
clxxx	
coacto	
coactum	
coactus	compulsion, constraint
coagmento	to join, cement together, connect
coagmentum	a joining together, joint
coemo	
coeo	
coepio	to begin, commence
coeptum	a work begun, beginning, undertaking
coeptus	a beginning, undertaking
coerceo	
cogitata	
cogitatio	a thinking, considering, deliberating, thought, reflection, meditation, imagination
cogitatum	a thought, reflection, notion, idea
cogitatus	deliberate
cogito	to consider thoroughly, ponder, weigh, reflect upon, think
cognitus	known, acknowledged, approved
cognosco	to become acquainted with, acquire knowledge of, ascertain, learn, perceive, understand ; perf., to know
cogo	to drive together, collect, crowd, bring together, summon, congregate, convene
cohors	a court, enclosure, yard, pen, cattle-yard
cohortatio	an exhorting, inciting, exhortation, encouragement
cohorto	
cohortor	to animate, encourage, advise, incite, exhort, admonish
collaudo	
collega	
collegium	
colligo	
collis	an elevation, high ground, hill
colloco	
colloquium	
colloquor	
collum	the neck
collus	
colona	a countrywoman
colonia	a colony, colonial town, settlement
colonica	
colonicus	colonial
colonus	a husbandman, tiller of the soil
columella	a small column, pillar
columnaris	
columnarium	a duty on pillars in buildings, pillar-tax
columnarius	
comes	a compan
comitatus	
comitialis	of an election, proper for comitia
comitio	
comitium	a place of assembly, place of meeting
comito	to accompany, attend, follow
comitor	to join as an attendant, accompany, attend, follow
commagenum	
commeatus	a going to and fro, passing back and forth
commemoro	to recall to memory, call to mind, be mindful of, keep in mind, remember
commendatio	a commit ting, commending, recommending, recommendation
commendo	to commit for protection, intrust, confide, deposit with
commentarium	
commentarius	a notebook, notes, memorandum
commilito	a comrade, fellow-soldier
comminus	in close contest, hand to hand, at close quarters
commissum	an undertaking, enterprise
committo	
commodo	to serve with, accommodate, grant, supply, lend
commodum	
commodus	with due measure, full, complete, of full weight
commoro	
commoror	to tarry, linger, abide, sojourn, remain, stay
commoveo	To put in violent motion, move, shake, stir
commune	that which is common
communico	to divide with, communicate, impart, share
communio	a community, mutual participation, fellowship
communis	common, general, universal, public
commutatio	a changing, change, alteration
commuto	to alter wholly, change entirely
comparo	
compello	to accost, address
comperio	to obtain knowledge of, find out, ascertain, learn
compertus	ascertained, clearly known
complector	to clasp, embrace, grasp
compleo	to fill up, fill full, fill out, make full, cram, crowd
complexus	a surrounding, encompassing, encircling, embracing, embrace, clasp, grasp
complura	
complures	more than one, not a few, several, a number, many
compono	to bring together, place together, collect, unite, join, connect, aggregate
comporto	to bring in, carry together, collect, accumulate, gather
compositio	a putting together, connecting, arranging, composition
comprehendo	to bind together, unite
comprimo	to press together, bring together, compress, close
comprobo	to approve, assent to, sanction, acknowledge
conata	an undertaking, attempt, venture, hazard, plan
conatum	
conatus	an attempt, effort, undertaking, enterprise, endeavor
conbustae	
concaedes	an abattis, barricade of felled trees
concapit	
concedo	to go away, pass, give way, depart, retire, withdraw, remove
concelebro	to attend in numbers, frequent, celebrate, solemnize
concepto	
conceptus	a conceiving, conception
concessus	
concido	
concilio	to bring together, unite, reconcile, make friendly, win over, conciliate
concilium	a meeting, rendezvous
concino	to sound in concert, sing harmoniously
concipio	to take hold of, take up, take in, take, receive
concitatio	a quickening, quick movement
concito	to put in quick motion, rouse, excite, urge, drive, incite, spur, agitate, disturb
conclamatio	a loud shout, acclamation
conclamo	to cry out together, shout, make acclaim
conclusio	a shutting up, shutting in, siege, blockade
concurro	to run together, assemble, flock together
concurso	to run to and fro, run about, fly around
concursus	a running together, concourse, throng, mob, tumult
condicio	an agreement, stipulation, condition, compact, proposition, terms, demand
conduco	to draw together, assemble, collect, gather, unite
conductor	a hirer, lessee, farmer, tenant.—Plur
confacio	
confercio	
confero	To bring together, collect, gather, unite, join
confertus	pressed close, crowded, thick, dense
confestim	immediately, speedily, without delay, forthwith, suddenly
conficio	to make ready, make, prepare, bring about, complete, accomplish, execute, consummate, fulfil
confido	to trust, confide, rely upon, believe, be assured
confirmatio	a securing
confirmo	to make firm, make strong, establish, strengthen
confiteor	to acknowledge, confess, own, avow, concede, allow, grant
conflicto	to come in conflict, collide
confligo	to come into collision, dash together
confuga	
confugio	to flee, take refuge, run for succor
congero	to bring together, collect, heap up, throw together
congesticius	heaped, piled up, thrown together
congesto	
congredior	to come together, meet, have an interview
congressus	a meeting, assembly, conference, conversation, interview
conicio	To throw together, unite, collect
conitor	to put forth all one's strength, make an effort, strive, struggle, endeavor
conlabefieret	
conor	to undertake, endeavor, attempt, try, venture, seek, aim, make an effort, begin, make trial of
con-paro	
con-pasco	
con-paveo	
con-pello	
conpendio	
con-pleo	
conpletas	
conplexus	
conplures	
conpluresque	
conpluribus	
con-porto	
con-prehenso	
conquaero	
conquiesco	to find rest, rest, repose, be idle, be inactive
conquiro	to seek for, hunt up, search out, procure, bring together, collect
con-rogo	
consanguinea	
consanguinei	
consanguineus	of the same blood, related by blood, kindred, fraternal
conscendo	to mount, ascend, climb
conscientia	joint knowledge, consciousness, common knowledge, privity, cogni
conscio	to be conscious, feel guilty
conscribo	to write together, write in a roll, enroll, enlist, levy
conscriptus	one enrolled
consecro	to dedicate, devote, offer as sacred, consecrate
consector	to follow eagerly, attend continually, go after
consentio	to agree, accord, harmonize, assert unitedly, determine in common, decree, unite upon
consequens	according to reason, correspondent, suitable, fit
consequor	to follow, follow up, press upon, go after, attend, accompany, pursue
con-sequor	
consequus	
consero	
conservo	to retain, keep safe, maintain, preserve, spare
considero	to look at closely, regard attentively, inspect, examine, survey
consido	to sit down, take seats, be seated, settle
consilior	to take counsel, consult
consilium	a council, body of counsellors, deliberative assembly
consisto	to stand still, stand, halt, stop, take a stand, post oneself
consolo	
consolor	to encourage, animate, console, cheer, comfort
conspectus	
conspicio	to look at attentively, get sight of, descry, perceive, observe, fix eyes upon
conspicor	to get sight of, descry, see, perceive
conspirati	
conspiratus	conspiring, agreeing, in conspiracy
conspiro	to blow together, sound in unison
constantia	steadiness, firmness, constancy, perseverance
consterno	to confound, perplex, terrify, alarm, affright, dismay
constituo	to put, place, set, station
constitutum	an agreement, appointment, compact
consto	to agree, accord, be consistent, correspond, fit
constratum	
con-suesco	
consuesset	
consuetudo	a custom, habit, use, usage, way, practice, familiarity, experience, tradition, precedent
consul	a consul
consularis	of a consul, consular
consularius	
consulatus	the office of consul, consulate, consulship
consulo	to meet and consider, reflect, deliberate, take counsel, consult, take care, have regard, look out, be mindful
consulto	
consultum	deliberation, consideration
consultus	well considered, weighed, deliberated upon, maturely pondered
consumo	to use up, eat, devour
consuo	
consurgo	to rise, stand up, arise, start up, rise in a body, lift oneself
contabulatio	a structure of planks, flooring, floor, story
contectus	
contego	to cover, roof, bury
contemno	
contemptio	a despising, disregard, contempt, scorn, disdain
contendo	to stretch, bend, draw tight, strain
contentio	a stretching, straining, exertion, tension, effort, struggle
contexo	to weave, entwine, join, bind
contextus	
contignatio	a floor, storey
contigno	to join with beams, furnish with joists
continens	
continenter	continuously, without interruption
continentia	a restraint, abstemiousness, continence, temperance, moderation
contineo	to hold together, bound, limit, comprise, enclose, surround, environ
contingo	to touch, reach, take hold of, seize
continuo	
continuus	joining, connecting, uninterrupted, continuous, unbroken
contio	a meeting, assembly, convocation, gathering, audience
contionarius	of a public assembly, mob-like
contionor	to meet, convene, form an assembly
contra	in opposition, opposite, face to face, in front, on the other side
contradico	to speak against, contradict
contraho	to draw together, collect, assemble
contrarium	
contrarius	lying over against, opposite
contribuo	to unite, incorporate, associate, enroll together
controversia	a contention, quarrel, question, dispute, controversy, debate
contubernium	companionship in a tent, the relation of a general and his personal follower
contumelia	insult, abuse, affront, reproach, invective, contumely
contumeliosus	full of abuse, reproachful, abusive, insulting
contundo	to beat, bruise, grind, crush, pound, break to pieces
contusum	
conveho	to carry together, collect, store
convello	to tear away, pluck up, pull off, wrest, rend
convenio	to come together, meet, assemble, gather, come in a body
conventus	a meeting, assembly, throng
converro	to sweep together
converso	to turn around
converto	to turn round, cause to turn, turn back, reverse, direct
convicior	to revile, reproach, taunt, rail at
convicium	a loud noise, cry, clamor, outcry
convoco	to call together, convoke, assemble, summon
convoluto	
conjecto	
conjectura	
conjuncto	
conjunctum	
conjunctus	
conjungo	
coorior	to come forth, stand up, arise, appear, rise, break forth
copia	an abundance, ample supply, plenty
copis	a short, curved sword, yataghan
cora	
coram	in the presence, before the eyes, in the face, openly, face to face
corion	
corium	skin, hide, leather
corius	
cornu	a horn, antler
cornus	a cornel cherry-tree
corporo	
corpus	a body
corripio	to seize, snatch up, grasp, collect, take hold of, arrest
corrumpo	to destroy, ruin, waste
corrupta	
corruptus	spoiled, marred, corrupted, bad
cortex	the bark, rind, shell, hull
cottidianus	of every day, daily
cottidie	daily, every day
co-jacio	
crassitudo	thickness
crassus	solid, thick, fat, gross, stout
crastinum	
crastinus	of to-morrow, to-morrow's
cratis	wicker-work, a hurdle
creber	thick, close, pressed together, frequent, numerous, repeated
crebro	in quick succession, repeatedly, often, frequently, many times
creditor	a creditor
credo	to give as a loan, lend, make a loan
creo	to bring forth, produce, make, create, beget, give origin to
creta	Cretan earth, pipe - clay, chalk
cretus	
crinis	the hair, hair of the head
crudelis	rude, unfeeling, hard, unmerciful, hard - hearted, cruel, severe, fierce
crudelitas	harshness, severity, cruelty, barbarity
culpa	a fault, error, blame, guilt, failure, defect
culpo	to reproach, blame, censure, reprove, disapprove, condemn
cum	
cumque	whenever, always
cuncto	
cunctor	to delay, linger, loiter, hesitate, doubt
cunctus	all in a body, all together, the whole, all, entire
cupa	a cask, tun, barrel
cupiditas	a longing, desire, passion, eagerness
cupidus	longing, desiring, desirous, eager, zealous, wishing, loving, fond
cupio	to long for, desire, wish
cur	why? wherefore? for what reason?
cura	trouble, care, attention, pains, industry, diligence, exertion
curio	the priest of a curia
curionius	
curo	to care for, take pains with, be solicitous for, look to, attend to, regard
curro	to run, move quickly, hasten
cursus	a running, course, way, march, passage, voyage, journey
cuspis	a point, pointed end, blade, head
custodia	a watching, watch, guard, care, protection
custodio	to watch, protect, keep, defend, guard
custos	a guard, watch, preserver, keeper, overseer, protector, defender, attendant
cujus	
cx	
cxx	
cyclas	a circular, white or purple state-robe, with a border
cyprus	
C	
Caecilius	
Caelius	
Caesar	
Calagurritani	
Caleni	
Calenum	
Calenus	
Calidius	
Calvinus	
Calvisius	
Calydon	
Camerinum	
Camerinus	a cognomen in the Sulpician
Campania	
Campanius	
Candavia	
Caninius	a Roman
Cantabras	
Cantabri	
Canuleius	
Canusium	
Capitolium	the Capitol, temple of Jupiter, at Rome
Cappadocia	
Cappadocius	
Capua	
Caralitani	
Caralitanus	
Carmonenses	
Casilinum	
Casilinus	
Casseius	
Cassi	
Cassianam	
Cassius	
Castor	
Castulonensis	
Cato	
Celtiberia	
Ceraunia	
Cilices	
Cilicia	
Ciliciensis	
Cilicius	
Cinga	
Cingulum	
Civilis	
Claudius	
Cleopatra	
Cn	
Commagenus	
Compsa	
Considius	
Coponius	
Corcyra	
Corduba	
Corfinienses	
Corfiniensis	
Corfinium	
Corfinius	
Cornelius	
Cos	
Cosanum	
Cosanus	
Cotta	
Cottam	
Cottus	
Cotus	
Crassus	
Crastinus	
Cremona	
Creta	
Cures	
Curiatii	
Curictam	
Curio	
Curius	
Cyclades	
Cyprium	
Cyprius	
Cyprus	
Cyrenae	
Cyrene	
d	
da	
damno	to adjudge guilty, condemn, convict
data	
datus	
dc	
dccc	
dcccc	
dcccclx	
de	from, away from, down from, out of
debeo	to withhold, keep back
debitor	a debtor
decedo	to go away, depart, withdraw, retire
deceptus	
decerno	to decide, determine, pronounce a decision, judge, decree, resolve, vote
decerto	to go through a contest, fight out
decimanus	
decipio	to catch, ensnare, entrap, beguile, elude, deceive, cheat
declive	
declivis	inclining downwards, sloping
decretum	a decree, decision, ordinance, vote, resolution
decumana	
decurio	
decurro	to run down, hasten down, run, hasten
dedecus	disgrace, dishonor, infamy, shame
dedisco	to unlearn, forget
deditio	a giving up, surrender, capitulation
dedo	to give away, give up, surrender, deliver, consign, yield, abandon, render
deduco	to lead away, draw out, turn aside, divert, bring out, remove, drive off, draw down
deductor	
deductus	lowered, unambitious, modest
de_-fateor	
defatigo	to weary out, tire, fatigue, exhaust
defectio	a failing, failure, want, lack, disappearance
defendo	to ward off, repel, avert, keep off
defensio	a defending, defence
defensor	an averter, protector against
defero	to bring away, carry off, take down, carry, take, remove
deficio	to withdraw, revolt, desert, fall off
defigo	to fasten, fix, set, drive, set up, plant
definio	to bound, set bounds to, limit, terminate, define
defugio	to run off, flee away, make an escape
deicio	to throw down, hurl down, precipitate, prostrate, raze, fell, cut down, tear down, destroy
deinceps	one after another, in order, in succession
deinde	then, next, thereafter, thence
delabor	to fall, sink, slip down, glide down, descend
delecto	to allure, attract, delight, charm, please, entertain, interest
delector	
delectus	picked, choice, select, chosen
deleo	to erase, efface, obliterate, blot out
deliberatus	resolved upon, determined
delibero	to weigh well, consider maturely, deliberate, ponder, meditate, take counsel, consult, advise upon
deligo	
deminuo	to make smaller, lessen, diminish
deminutio	a diminution, decrease, lessening, abatement
demissio	a letting down, sinking, lowering
demissus	lowered, sunken, low-lying, low
demitto	to send down, let down, drop, lower, put down, let fall, sink
demonstro	to point out, indicate, designate, show
demoror	to retard, detain, delay
demoveo	to move away, put away, remove, expel, drive out
denarius	containing ten each
denego	to reject, refuse, deny
denique	and thenceforward, and thereafter, at last, at length, finally, lastly, only, not until
denuntiatio	an indication, announcement, declaration, proclamation, threat
denuntio	to announce, declare, denounce, menace, threaten, intimate, order, command
depello	to drive out, drive away, remove, expel, put out, put off, turn aside
depereo	to go to ruin, perish, die, be lost, be undone
depono	to lay away, put aside, set down, lay, place, set, deposit
deporto	to carry down, carry off, take away
deposco	to demand, require, request earnestly, call for
depositum	a deposit, trust, bailment
depravo	to distort, disfigure
deprecor	to avert by prayer, deprecate, plead against, beg to escape, seek to avoid
deprehendo	to take away, seize upon, catch, snatch
de_-prehendo	
deprensus	
deprimo	to press down, weigh down, sink down, depress
de_-recingo	
de_-rego	
descendens	
descendo	to climb down, come down, descend, fall, sink
descensus	a descent, way down
descisco	to withdraw, leave, revolt from, desert, go over
deseco	to cut off, cut away
desero	to leave, forsake, abandon, desert, give up
desertus	deserted, desert, solitary, lonely, waste
deservio	to serve zealously, be devoted, be subject, be of service
desidero	to long for, ask, demand, call for, wish for, desire, require, expect
designo	to mark out, point out, trace, designate, define
desino	to leave off, give over, cease, desist, forbear
de_-sisto	
desisto	to leave off, cease, give over, desist from
despecto	to look down upon
despectus	
desperatio	hopelessness, despair
despero	to be hopeless, have no hope, despair of, give up
despicio	to look down upon
destino	to make fast, make firm, bind, fix, stay
destituo	to set down, set forth, put away, bring forward, leave alone
de_-sto	
destrictus	severe, rigid
destringo	to strip off
desum	to be away, be absent, fail, be wanting, be missing
desuper	from above, from overhead
detendo	to unstretch
detergeo	to wipe off, wipe away
deterreo	to frighten off, deter, discourage, prevent, hinder
detineo	to hold off, keep back, detain, check
detraho	to draw off, take down, pull down, take away, remove, withdraw, drag, bring
detrimentum	that which is worn away
deturbo	to thrust down, beat down, expel, overthrow, tear down, hurl, strike down
deus	a god, deity
deveho	to carry down, carry off, convey, take away
devincio	to bind fast, tie up, fetter, clamp
devinco	to conquer completely, overcome, subdue
devinctus	devoted, strongly attached
devolvo	to roll down
dexter	to the right, on the right side, right
dextera	the right hand
dejecto	
dico	
dictator	a dictator, chief magistrate with unlimited power
dictatura	the office of a dictator, dictatorship
dictito	to say often, declare, maintain, assert, insist
dicto	to dictate, suggest, remind
dictum	something said, a saying, word, assertion, remark
diduco	to draw apart, part, split, separate, sever, sunder, divide, undo, relax
dies	a day, civil day
differo	to carry apart, spread abroad, scatter, disperse, separate
differtus	stuffed, crammed, crowded, swarming
difficilis	hard, difficult, troublesome, impracticable, laborious, perilous
difficillimae	
difficillimum	
difficultas	difficulty, trouble, distress, poverty, want, embarrassment
difficulter	with difficulty, hardly
diffido	to distrust, be diffident, be distrustful, despair
diffisus	
digitus	a finger
dignitas	worth, merit, desert, character
digredior	to go apart, go asunder, separate, part, go away, depart
digressus	a parting, separating, departure
dilectus	
diligens	industrious, careful, assiduous, attentive, diligent, accurate, scrupulous, faithful
diligenter	industriously, attentively, diligently, assiduously
diligentia	attentiveness, earnestness, diligence, industry, assiduity, care, faithfulness
diligo	to single out, value, esteem, prize, love
diluo	to wash away, dissolve, dilute, wash, drench
dimicatio	a fight, combat, struggle, encounter
dimico	to fight, struggle, contend
dimidia	
dimidio	
dimidium	the half
dimidius	half, one half
dimitto	to send different ways, send out, send forth, send about, scatter, distribute
direptio	a plundering, pillaging, sack
dirigo	to distribute, scatter
dirimo	to take apart, part, separate, divide, cut off
diripio	to tear asunder, tear in pieces
discedo	to go apart, part asunder, divide, separate, disperse, scatter
discepto	to decide, determine, judge, arbitrate, sit as umpire
discerno	to separate, set apart, mark off, bound, part, divide
discessus	a going asunder, parting
disciplina	instruction, tuition, teaching, training, education
discolorius	
discribo	to distribute, divide, apportion, assign
discurro	to run different ways, run to and fro, run about, wander, roam
discutio	to strike asunder, dash to pieces, shatter
dispello	to drive asunder, scatter, disperse
dis-permulceo	
dis-persero	
dispono	to place here and there, array, distribute, set in order, arrange, dispose
dispositus	a disposition, arrangement
disputatio	an argument, discussion, debate, dispute
disputo	to weigh, examine, investigate, treat, discuss, explain
dissensio	difference of opinion, disagreement, dissension, discord, strife
dissentio	to differ, dissent, disagree, be at odds, contradict, quarrel
dissimulo	to make unlike, disguise
dissipatos	
dissolvo	to take apart, disunite, part, destroy
distendo	to stretch asunder, stretch out, extend
distineo	to keep asunder, separate, part, hold back
disto	to stand apart, be separate, be distant
distraho	to pull asunder, tear in pieces, part, divide
distribuo	to divide, distribute, apportion, spread
disturbo	to drive asunder, separate by violence, throw into disorder, disturb
diu	by day, all day
diurnum	
diurnus	of the day, by day
dius	godlike, divine, worshipful, adorable
diutinus	of long duration, lasting, long
diutissime	
diuturnitas	length of time, long duration, durability
diuturnus	of long duration, lasting, long
diverto	
divido	to divide, force asunder, part
divina	
divino	to foresee, divine, foretell, predict, prophesy, expect, dread, conjecture
divinum	
divinus	of a god, of a deity, divine
divisor	one who distributes
divisus	a division, distribution
divorto	
divulgo	
divus	
dijudico	
do	to hand over, deliver, give up, render, furnish, pay, surrender
doceo	to cause to know, make aware, teach, instruct, inform, show, prove, convince, tell
docti	
documentum	a lesson, example, instance, pattern, warning, evidence, proof, specimen
doleo	to feel pain, suffer, be in pain, ache
dolium	a large, wide - mouthed, globular jar
dolo	
dolor	pain, smart, ache, suffering, anguish
dolus	a device, artifice, contrivance
domestici	
domesticus	of the house
domicilium	a habitation, dwelling, domicile, abode
dominatus	rule, command, sovereignty, mastery, tyranny
dominium	a feast, banquet
dominor	to be lord, be in power, have dominion, bear rule, domineer
dominus	a master, possessor, ruler, lord, proprietor, owner
domitius	
domo	to domesticate, tame, break, subdue, master
domus	a house, dwelling-house, building, mansion, palace
donatio	a presenting, giving, donation
dono	To give as a present, present, bestow, grant, vouchsafe, confer
donum	a gift, present
dubito	to waver in opinion, be uncertain, be in doubt, be perplexed, doubt, question
dubius	moving two ways, fluctuating
ducenti	
duco	to lead, conduct, guide, direct, draw, bring, fetch, escort
ductus	a leading, conducting
dum	
dumtaxat	while one examines
duo	two
duoviri	
duplex	twofold, double
duplicato	
duplico	to double, multiply by two, repeat
durius	
durus	hard
duumvira	
dux	a leader, conductor, guide
dynastes	a ruler, prince, petty monarch
D	
Dalmatae	
Damasippus	
Dardani	
Dardanus	
Decidius	
Deiotarus	
Delphi	
Diana	the goddess of light and of the moon
Dioscorides	
Domitianus	
Domitius	
Domnilaus	
Dyrrachini	
Dyrrachino	
Dyrrachium	
eadem	by the same way
edico	to declare, publish, make known, proclaim, order, establish, decree, ordain
edicto	
edictum	a proclamation, ordinance, edict, manifesto
editor	
editum	Heights, elevations
edo	
edoceo	to teach thoroughly, instruct, inform, apprise
educo	to bring up, rear, train, educate
eductor	
effectum	an effect
effectus	an effecting, execution, accomplishment, performance
effero	
efficio	to make out, work out, bring to pass, bring about, effect, cause, produce, make, form, execute, finish, complete, accomplish
effodio	to dig out, dig up, mine, excavate
effugio	to flee away, get away, escape
effundo	to pour out, pour forth, shed, spread abroad
egeo	to be needy, be in want, be poor, need, want, lack, have need
egero	to carry out, bring out, take away, remove, discharge
ego	I, me, we, us
egredior	to go out, come forth, march out, go away
egressus	a going out, going away, egress, departure
ei	
eicio	to cast out, thrust out, drive away, put out, eject, expel
eiusmodi	
elabor	to slip away, glide off, fall out, get off, escape
elate	loftily, proudly
electa	
elephas	
elevo	to lift up, raise
elices	
elicio	to draw out, entice out, lure forth, bring out, elicit
elido	to strike out, dash out, tear out, force out, squeeze out
eligo	to pluck out, root out
elix	an artificial watercourse, ditch
eludo	to stop playing, cease to sport
eminentes	
eminentia	a distinctive feature, conspicuous part
emineo	to stand out, project, reach upward
eminus	aloof, beyond sword reach, at a distance, a spear's-throw off
emissus	
emitto	to send out, send forth
enim	for, for instance, namely, that is to say, I mean, in fact
eniteo	to shine forth, shine out, gleam, brighten
enitor	to force a way out, struggle upwards, mount, climb, ascend
enumero	to reckon up, count over, count out
eo	
eodem	loci, in the same place
equa	a mare
eques	a horseman, rider
equestre	
equestri	
equestribus	
equestris	
equidem	verily, truly, indeed, at all events
equio	
equitatus	cavalry
equito	to ride, be a horseman, practise riding
equus	a horse, steed, charger
ereptor	a robber, plunderer
erga	towards, in respect of, in relation to
ergastula	
ergastulum	a workhouse, house of correction, penitentiary
ergo	in consequence of, on account of, because of, for the sake of
ericius	a beam set with spikes, chevaux-de-frise
erigo	to raise up, lift, set up, erect, elevate
eripio	to tear out, snatch away, wrest, pluck, tear, take away
erro	
error	a wandering, straying, strolling
erumpo	to cause to break forth, emit, throw out
eruptio	a breaking out, bursting forth
et	also, too, besides, moreover, likewise, as well, even: Ph
etesiae	Etesian winds, trade-winds, N. W. winds which prevail in summer in the eastern parts of the Mediterranean Sea
etesias	
etesius	
etiam	now too, yet, as yet, even yet, still, even now
etiamtum	
etsi	though
eum	
eunuchus	a eunuch
evenio	to come out, come forth
eventum	an occurrence, chance, event
eventus	an occurrence, accident, event, fortune, fate, lot
evocati	
evocator	a summoner, recruiter, one who drums up
evocatus	called out.— Plur. m
evoco	to call out, call forth, summon, evoke
ex	out of, from
exactor	a driver-out, expeller
exaedifico	to finish building, complete, erect, build, construct
exaequo	to make equal, place on a level, equal
exagito	to rouse, keep in motion, disquiet, harass, persecute, disturb, torment, vex
exanimo	to put out of breath, tire fatigue, weaken, exhaust
exaresco	to dry up, become dry
exaudio	to hear clearly, distinguish, discern, hear
ex-caedo	
excedo	to go out, go forth, depart, retire, withdraw
excello	to be eminent, be superior, surpass, excel
excelsi	
excelsum	
excepto	to take out, take up, catch
excipio	To take out, withdraw
excito	to call out, summon forth, bring out, wake, rouse
excludo	to shut out, exclude, cut off, remove, separate
excogito	to think out, contrive, devise, invent
excubo	to lie out of doors, camp out
excurro	to run out, run forth, hasten forwards
excursus	a running out, running forth, excursion
excusatio	an excusing, excuse
excuso	to excuse, make an excuse for
exemplo	
exemplum	a sample, specimen
exeo	to go out, go forth, go away, depart, withdraw, retire
exerceo	to drive, keep busy, keep at work, oversee, work, agitate
exercio	
exercito	
exercitus	
exigo	to drive out, push forth, thrust out, take out, expel
exiguum	
exiguus	strict, exact, scanty, small, little, petty, short, poor, mean, inadequate, inconsiderable, paltry
eximius	taken out, excepted, exempt
exinanio	to empty, make empty, desolate
existimatio	a judging, judgment, opinion, supposition, decision, estimate, verdict
existimo	to value, estimate, reckon
exitus	a going out, going forth, egress, departure
ex-loquor	
exorior	to come out, come forth, spring up, rise, appear
expectabant	
expectabat	
expectans	
expectarent	
expectaret	
expectari	
expectatio	
expectavissent	
ex-pecto	
expedio	to extricate, disengage, let loose, set free, liberate
expeditus	unfettered, unimpeded, unencumbered, without a burden
expello	to drive out, drive away, thrust out, eject, expel
experior	to try, prove, test, experience, endure
expers	having no part in, not sharing in, not privy to
expeto	to seek after, strive for aim at, demand, ask
expio	to make amends for, atone for, purify, expiate, purge by sacrifice
ex-pleo	
expleo	to fill up, fill full, fill, stuff
explicaturos	
explico	to unfold, uncoil, unroll, unfurl, unclose, spread out, loosen, undo
explorator	an explorer, spy, scout
exploro	to cause to flow forth, bring out, search out, examine, investigate, explore
expono	to put out, set forth, expose, exhibit
exposco	to ask earnestly, beg, request, entreat, implore
exposita	
expugno	to take by assault, storm, capture, reduce, subdue
expulso	
ex-sisto	
exsisto	to step out, come forth, emerge, appear
exspectatio	an awaiting, expecting, expectation, longing, desire
exspecto	to look out for, await, wait for
exstinguo	to put out, quench, extinguish
ex-sto	
exstruo	to pile, heap up, accumulate
extarent	
extendo	to stretch out, spread out, extend
exter	on the outside, outward, of another country, foreign, strange
externus	outward, external
extero	to tread down, crush
exterreo	to strike with terror, frighten, affright
extorqueo	to twist out, wrench out, wrest away
extra	on the outside, without
extraho	to draw out, draw forth, pull out, drag
extraordinarius	out of the common order, extraordinary, uncommon
extre	
extremo	at last, finally
extremum	at last, finally
extremus	outermost, utmost, extreme, farthest, last
extro	
extructa	
extruerentur	
extruxit	
exulesque	
Elis	
Eos	
Ephesius	
Ephesus	
Epirus	
faber	
facilis	easy to do, easy, without difficulty
facinus	a deed, act, action, achievement
facio	to make, construct, fashion, frame, build, erect, produce, compose
factio	a making, doing, preparing
factum	a deed, act, exploit, achievement
factura	
factus	elaborate, finished, artistic
facultas	capability, possibility, power, means, opportunity, skill, ability
fallo	to trip, cause to fall
falso	untruly, unfaithfully, deceitfully, falsely, erroneously
falsum	an untruth, falsehood, fraud, deceit
falsus	deceptive, feigned, spurious, deceitful, false, pretended, delusive, unfounded
fama	a report, rumor, saying, talk, tradition
fames	hunger
familia	the slaves in a household, a household establishment, family servants, domestics
familiaris	of a house, of a household, belonging to a family, household, domestic, private
fano	
fanum	a shrine, sanctuary, temple
fas	the dictates of religion, divine law
fascis	a bundle, fagot, fascine, packet, parcel
fastigatus	pointed, sharp, wedge-shaped
fastigium	the top of a gable, gable end, pediment
fastigo	
fateor	to confess, own, grant, acknowledge
fatigo	to weary, tire, fatigue, vex, harass, fret
fatum	an utterance, prophetic declaration, oracle, prediction
fatus	
fauces	the upper part of the throat, pharynx, throat, gullet
faustus	of favorable omen, wellomened, fortunate, favorable, auspicious, lucky
faveo	to be favorable, be well disposed, be inclined towards, favor, promote, befriend, countenance, protect
felicitas	fertility, happiness, felicity, good-fortune, luck
felicito	
felix	fruitful, productive
fenestra	an opening for light, window
fenestro	
fera	a wild beast, wild animal
fere	closely, quite, entirely, fully, altogether, just
feriae	days of rest, holidays, festivals
fero	to bear, carry, support, lift, hold, take up
ferreus	made of iron, iron
ferrum	iron
ferus	wild, untamed, uncultivated
ficio	
fides	
fido	to trust, confide, put confidence in, rely upon
fiducia	trust, confidence, reliance, assurance
fiduciarius	intrusted, held in trust
fiducio	
fidus	trusty, trustworthy, faithful, sure, credible
filia	a daughter
filiabus	
filius	a son
fingo	to touch, handle
finio	to limit, bound, enclose within boundaries
finis	that which divides, a boundary, limit, border
finitimi	
finitimus	bordering upon, adjoining, neighboring
fio	
firmamentum	a strengthening, support, prop
firmitas	firmness, durability, strength, vigor
firmitudo	firmness, durability, strength
firmo	to make firm, strengthen, fortify, sustain
firmus	strong, steadfast, stable, enduring, powerful
flaccus	flabby, flap-eared
flagito	to demand urgently, require, entreat, solicit, press, importune, dun
flamma	a blazing fire, blaze, flame
flammo	to kindle, inflame, blaze, burn
fleo	to weep, cry, shed tears, lament, wail
fletus	a weeping, wailing, lamenting
flo	to blow
fluctus	a flood, flow, tide, wave, billow, surge
flumen	a flowing, flood, stream, running water
fluo	to flow, stream,
fodio	to dig, dig up
foedero	
foedus	
folium	a leaf
fons	a spring, fountain, well, source
for	to speak, say
foramen	an opening, aperture, orifice, hole
foras	out through the doors, out of doors, forth, out
fores	
fori	
foris	
forma	a form, contour, figure, shape, appearance, looks
formo	to shape, fashion, form, build
formus	
foro	
fors	chance, hap, luck, hazard, accident
fortasse	perhaps, peradventure, probably, possibly
fortis	strong, powerful, mighty
fortiter	strongly, powerfully, vigorously
fortuna	chance, hap, luck, fate, fortune
fortuno	to make prosperous, make happy, speed, further, prosper, bless
forum	an open space, public place, court, market-place
forus	a gangway
fossa	a dilch, trench, fosse
fosso	
frater	a brother
fraudo	to cheat, beguile, defraud, rob
fraus	a cheating, deceit, imposition, fraud
fremitus	a rushing, resounding, murmuring, humming, loud noise
fremo	to roar, resound, growl, murmur, rage, snort, howl
frequens	often, regular, constant, repeated, assiduous
frequentia	an assembling in great numbers, concourse, multitude, crowd, throng
frequento	to visit frequently, frequent, resort to, do frequently, repeat
fretum	a strait, sound, channel
fretus	leaning, supported, relying, depending, trusting, daring, confident
frigor	
frigus	cold, coldness, coolness, chilliness
frons	
fructus	an enjoying, enjoyment, delight, satisfaction
frumentarius	of corn
frumentor	to fetch corn, forage, purvey
frumentum	corn, grain, harvested grain
fruor	to derive enjoyment from, enjoy, delight in
frustra	in deception, in error
frustro	
fuga	a fleeing, flight, running away
fugio	to flee, fly, take flight, run away, make off
fugitivus	fleeing away, fugitive
fugo	to cause to flee, put to flight, drive off, chase away, rout, discomfit
fumo	to smoke, steam, reek, fume
fumus	smoke, steam, fume
funda	a sling
fundamentum	a foundation, ground-work, basis
funditor	a slinger
fundo	
fundus	the bottom, lowest part
funis	a rope, sheet, line, cord
furca	a two-pronged fork
fusus	
futurus	going to be, yet to be, to come, future
Fabiani	
Fabianus	
Fabius	
Fanum	
Faustus	
Favonius	the west wind
Felginatem	
Firmum	
Flaccus	
Frentranorum	
Fufius	
Fulginius	
Fulvius	
galea	a helmet, head-piece
galla	a gall-apple, gall-nut
gallica	
gallus	a cock, domestic cock
gemellus	born together, twin-born, twin-
gener	a daughter's husband, son-in-law
generatim	by kinds, by species, in classes, in detail
gens	a race, clan, house
genu	a knee
genus	
germanus	full, own
gero	to bear about, bear, carry, wear, have, hold, sustain
gesta	deeds, acts, achievements
gestio	
gesto	to bear, carry, have, wear, wield
gestus	bearing, carriage, posture, attitude, motion, gesture, movement, action, sign
gladiator	a swordsman, gladiator, fighter
gladiatorius	of gladiators, gladiatorial
gladium	
gladius	a sword
gloria	glory, fame, renown, praise, honor
glorior	to boast, vaunt, glory, brag, pride oneself
gomphus	
gratia	favor, esteem, regard, liking, love, friendship, partiality
gratulatio	a manifestation of joy, wishing joy, congratulation, rejoicing, joy
gratulor	to manifest joy, be glad, congratulate, rejoice
gravis	heavy, weighty, ponderous, burdensome, loaded, laden, burdened
gravitas	weight, heaviness
graviter	weightily, heavily, ponderously
gravo	to make heavy, load, burden, weigh down, weight, oppress
gubernator	a steersman, helmsman, pilot
guberno	to steer, pilot
Gabinianus	
Gabinius	
Gabinus	
Gades	
Gaditanae	
Gaditani	
Gaditanus	
Gaius	
Galla	
Gallae	
Galli	The priests of Cybele
Gallia	
Gallicus	
Gallius	
Gallograecia	
Gallonius	
Gallus	of Gaul, Gallic
Genusus	
Gergovia	
Germani	
Germania	
Germanus	
Gomphenses	
Gomphi	
Gracchus	
Graeci	
Graecia	
Graecum	
Graecus	of the Greeks, Greek, Grecian
Granius	
habeo	to have, hold, support, carry, wear
habitatio	a dwelling, habitation
habito	to dwell, abide, reside, live
habiturio	
harpago	a hook, grappling-hook, grapple, drag
harundo	a reed, cane
hastatus	armed with a spear
haustrum	
hedera	ivy, ivy-vine
helvus	
herba	an herb, grass, green blades, herbage, turf
hereditas	heirship, inheritance
heredito	
heres	an heir, heiress
hiberna	
hiberno	to pass the winter, winter, occupy winter-quarters
hibernum	
hibernus	of winter, wintry, winter-
hic	
hiemo	to winter, pass the winter, keep winter-quarters
hiems	the winter, winter time, rainy season
hinc	from this place, hence
hippotoxotae	mounted archers
hirrio	
hodie	to-day
homo	a human being, man, person
honesto	to honor, dignify, decorate, adorn, grace, embellish
honestum	honesty, integrity, virtue
honestus	regarded with honor, respected, honored, of high birth, distinguished, honorable, respectable, noble
honor	
honoro	to honor, respect, adorn, ornament, embellish, decorate
honorus	conferring honor, honorable
hora	an hour
horae	
hordeum	barley
horreum	a storehouse, barn, granary, magazine, cellar
hortatus	incitement, encouragement, exhortation
horto	
hortor	to urge, press, incite, instigate, encourage, cheer, exhort
hospes	an entertainer, host
hospitium	a hospitable reception, entertainment
hostio	
hostis	a stranger, foreigner
hostus	
huc	to this place, hither
huiusmodi	
humana	
humanitas	human nature, humanity
humano	
humanum	
humanus	of man, human
humilis	low, lowly, small, slight
humilitas	lowness, small stature, depression
humilito	
Hadriaticum	
Hadrumetum	
Hadrumetus	
Haliacmon	
Hegesaretos	
Helvii	
Helvius	
Heraclea	
Heracleus	
Heraclius	
Herculis	
Hiberes	
Hiberi	
Hiberus	
Hirpinus	
Hirrus	
Hispalis	
Hispane	
Hispani	
Hispania	
Hispaniae	
Hispanus	
HS	
ibi	in that place, there
ictus	a blow, stroke, stab, cut, thrust, bite, sting, wound
idcirco	on that account, for that reason, therefore
idem	the same
ideo	for that reason, on that account, therefore
idoneus	fit, meet, proper, becoming, suitable, apt, capable, convenient, sufficient
igitur	then, therefore, thereupon, accordingly, consequently
ignio	
ignis	fire
ignominia	disgrace, dishonor, ignominy
ignorantia	want of knowledge, unacquaintance, ignorance
ignoro	not to know, to be unacquainted, be ignorant, mistake
iii	
iiii	
illa	in that way, in that direction, there
ille	dem
illic	
imbecillitas	helplessness, imbecility, weakness, feebleness
immitto	to send in, let in, throw into, admit, introduce
immortales	
immortalis	undying, immortal
imparatus	not ready, unprepared, unprovided, unfurnished
impedimentum	a hinderance, impediment
impedio	to entangle, ensnare, shackle, hamper, hinder, hold fast
impedito	
impello	To strike against, push, drive, smite, strike, reach
imperator	a commander-in-chief, general
imperatorius	of a general
imperatum	a command
imperatus	
imperitus	inexperienced, unversed, unfamiliar, not knowing, unacquainted with, unskilled, ignorant
imperium	a command, order, direction, injunction
impero	to command, order, enjoin, bid, give an order: Pa
impetratus	
impetro	to gain one's end, achieve, bring to pass, effect, get, obtain, procure
impetus	an attack, assault, onset
implico	to infold, involve, entangle, entwine, inwrap, envelop, encircle, embrace, clasp, grasp
imploro	to invoke with tears
impono	to place upon, set on, impose, establish, introduce, set, place
improbo	to disapprove, blame, condemn, reject
improbus	not good, bad, wicked, reprobate, abandoned, vile, base, impious, bold, shameless, wanton
improvide	recklessly, improvidently
improviso	on a sudden, unexpectedly
improvisum	
improvisus	not foreseen, unforeseen, unexpected
imprudens	not foreseeing, not expecting, without knowing, unaware, unsuspecting, ignorant, inconsiderate, heedless, inadvertent
imprudentia	want of foresight, inconsiderateness, imprudence, ignorance, inadvertence
impudentia	shamelessness, impudence
impulsor	one who incites, an inciter, instigator
impulsus	a striking against, push, pressure, shock, impulse
in	unequal
inaedifico	to build as a superstructure, erect as an addition, erect, construct
inaequo	to make even, level
inane	an empty space, void, open space
inanis	empty, void
inaudio	to hear whispered, get an inkling of
inauditus	unheard-of, unusual, strange, new, incredible
incautus	incautious, improvident, inconsiderate, heedless, reckless
incedo	to advance, march, proceed, stride, move, stalk, strut
incendium	a burning, fire, conflagration
incendo	to set fire to, kindle, burn
incerto	
incertum	
incertus	not fixed, unsettled, undetermined
incesso	to fall upon, assault, assail, attack
incido	
incipio	to take hold, take in hand, begin
incitatio	an inciting, incitement, rousing, instigating
incitatus	hurried, rapid, swift, at full speed
incito	to set in rapid motion
inclino	to cause to lean, bend, incline, turn, divert
includo	to shut up, shut in, confine, enclose, imprison, keep in
incognitus	not examined, untried, not investigated
incolo	to be at home, abide, dwell
incolumis	unimpaired, uninjured, unharmed, safe, sound, entire, whole
incolumitas	freedom from harm, safety, security
incommodo	to occasion inconvenience, be inconvenient, trouble, annoy
incommodum	inconvenience, trouble, disadvantage, detriment, injury, misfortune, loss
incommodus	inconvenient, unsuitable, unfit, unseasonable, troublesome, disagreeable
inconsultus	not consulted, unasked
increbruit	
incredibilis	not to be believed, incredible, beyond belief, extraordinary, unparalleled
incursus	a running to, hurried approach, rush, dash
inde	from that place, thence
indico	
indigeo	to need, want, stand in need of, demand, require
indignor	to deem unworthy, be indignant, despise, resent, be offended
indiligentia	carelessness, heedlessness, negligence
indo	to put into, insert
induco	to lead in, bring in, introduce, conduct, lead up, bring forward
inductus	
indulgeo	to be complaisant, be kind, be tender, exercise forbearance, incline, yield, indulge, concede, grant, allow
industria	diligence, activity, assiduity, industry, zeal
industrius	active, diligent, assiduous, industrious
indutiae	a suspension of hostitities, truce, armistice
ineo	to go into, enter
inermis	unarmed, without weapons, defenceless
infamia	ill fame, ill report, bad repute, dishonor, disgrace, infamy
infamis	of ill repute, disreputable, notorious, infamous
infectus	not done, unwrought, unmade, undone, unaccomplished, unfinished
inferiores	
infero	to bring in, introduce, bring to, carry in
inferus	below, beneath, underneath, lower
infesto	to annoy, disturb, infest
infestus	made unsafe, disturbed, molested, infested, unquiet, unsafe
inficio	to stain, tinge, dye, color
infidelitas	unfaithfulness, faithlessness, infidelity
infimo	
infimus	lowest, last
infinitum	
infinitus	not limited, infinite, endless, boundless, unlimited
infirma	
infirmis	
infirmus	not strong, weak, feeble, infirm
inflatus	
inflo	to blow into, blow, inflate, swell
infra	
infrequentiores	
infringo	to break off, break, bruise
infula	a band, bandage
ingratus	unpleasant, disagreeable, unacceptable
ingravesco	to grow burdensome, be wearied
ingredior	to advance, go forward, march, proceed
ingressus	an advancing, walking, gait
inicio	to throw in, put in, hurl upon, put on, cast on, set into
inimica	
inimicitia	enmity, hostility
inimicus	unfriendly, hostile, inimical
iniquitas	inequality, unevenness
iniquo	
iniquus	uneven, slanting, steep
initio	to begin, initiate, consecrate, admit
initium	a going in, entrance
inito	
inminebat	
in-mitto	
innascor	to be born in, grow upon, spring up in
innato	to swim in, float upon
innatus	native, inborn, innate, inherent, natural
inno	to swim in, float upon
inopia	want, lack, scarcity
inopinor	
inops	without resources, helpless, weak
in-pario	
inpedire	
in-pedito	
in-pedo	
in-pono	
in-porto	
in-probo	
inpuberes	
inquam	to say
in-reicio	
insequor	to follow, follow after, come next
insidiae	a snare, trap
insidior	to lie in ambush, lie in wait for
insigne	a mark, indication, proof, sign, token, signal
insignio	to mark, make conspicuous, distinguish
insignis	distinguished by a mark, remarkable, noted, eminent, distinguished, prominent, extraordinary
insolens	unaccustomed, unusual, not used, contrary to custom
insolenter	unusually, contrary to custom
insolentia	unusualness, strangeness, novelty
insoleo	
insolitus	unaccustomed, unused, unfamiliar, strange
inspecto	to look at, observe, view
instar	an image, likeness, resemblance, appearance
instituo	to put in place, plant, fix, set
institutum	a purpose, intention, design
insto	to stand upon, take a position
instructus	
instruo	to build in, insert
insueta	
insuetus	unaccustomed, unused, inexperienced
insula	an island, isle
insuper	above, on the top, overhead
integer	untouched
intego	to cover over
integro	to make whole
intellego	to come to know, see into, perceive, understand, discern, comprehend, gather
intendo	to stretch out, reach forth, extend
intentus	
inter	between, betwixt
intercedo	to come between, intervene, be between
intercessio	a mediation, suretyship
intercipio	to seize in passing, intercept
intercludo	to shut out, shut off, cut off, hinder, stop, block up, intercept
interdiu	during the day, in the daytime, by day
interea	meanwhile, in the meantime, in the interim
intereo	to go among, be lost
interfacio	
interficio	to put out of the way, destroy, bring to naught
interim	meanwhile, in the meantime
interior	inner, interior, middle
intermissus	
intermitto	to leave off, intermit, omit, suspend, interrupt, neglect
internuntia	a mediator, messenger
internuntium	
internuntius	a mediator, messenger, gobetween
intero	to rub in, crumble in
interpellatus	
interpello	to interrupt, break in upon
interpono	to put between, place among, interpose, insert, intersperse
interrogo	to ask, question, inquire, interrogate
interrumpo	to break apart, break off, interrupt, break to pieces, break up
intersum	to be between, lie between
intervallo	
intervallum	the space between palisades, an intermediate space, interval, distance
inter-jacio	
interjacio	
interjecta	
interjectus	
intra	
intro	
introduco	to lead in, bring in, introduce, conduct within, admit
introeo	to go in, enter
introitus	a going in, entering, entrance
intus	on the inside, within
inusitatus	unusual, uncommon, extraordinary, very rare
inutilis	useless, unserviceable, unprofitable
invado	to go into, enter
invenio	to come upon, find, meet with, light upon
inventor	a contriver, author, discoverer, inventor
inventum	an acquisition:
inventus	
inveterasco	to grow old, become fixed, be established, continue long
invetero	to make old, give age to
invicem	by turns, in turn, one after another, alternately
invidia	envy, grudge, jealousy, ill-will, prejudice
invisitatus	unseen, unknown
invito	to invite, treat, feast, entertain
invitus	against the will, unwilling, reluctant, perforce, on compulsion
involvo	to roll, roll upon
in-jacio	
injecto	
injungo	
injuria	
injurius	
injussus	
ipse	Self, in person
iracundia	a proneness to anger, hasty temper, irascibility
irasco	
irascor	to be angry, be in a rage
irrisus	
irrumpo	
is	he, she, it, the one mentioned
ita	in this manner, in this wise, in such a way, so, thus, accordingly, as has been said
item	likewise, besides, also, further, moreover, too, as well
iter	a going, walk, way
iterum	again, a second time, once more, anew
itis	
ito	to go
itus	a going away, departure
iulus	
iuniores	
iurisiurandi	
iusiurandum	
iv	
ivx	
ix	
Ian	
Igilium	
Iguinorum	
Iguium	
Ilerda	
Ilergavonenses	
Illurgavonensis	
Illyricum	
Illyricus	
Issa	
Isse	
Isthmus	the Isthmus of Corinth
Italia	
Italica	
Italicus	of Italy, Italian
Iulius	Julian, of Julius
Iulus	
l	
labefacio	to cause to totter, shake, loosen, make ready to fall
labefacto	to cause to totter, shake, overthrow
labo	to totter, be ready to fall, begin to sink, give way, be loosened
labor	
laboro	to labor, take pains, endeavor, exert oneself, strive
lac	milk
lacesso	to excite, provoke, challenge, exasperate, irritate
lacteo	
laedo	to hurt, wound, injure, damage
laetitia	joy, exultation, rejoicing
laetus	joyful, cheerful, glad, gay, joyous, rejoicing, happy, pleased, delighted, full of joy
lamina	a thin slice, plate, leaf, layer, lamina
langueo	to be faint, be weary, be languid
languidus	faint, weak, dull, sluggish, languid
lapido	to stone, throw stones
lapis	a stone
largitio	a giving freely, granting, bestowing, dispensing, generosity, largess
lassitudo	faintness, weariness, heaviness, lassitude
lateo	to lurk, lie hid, be concealed, escape notice, skulk
later	a brick, tile
laterculus	
latericium	
latericius	made of bricks
latitudo	breadth, width
lator	a bringer
latro	
latus	
laudo	to praise, laud, commend, honor, extol, eulogize, approve
laurea	the laurel-tree
laureus	of laurel, of bay-leaves, laurel-
laus	praise, commendation, glory, fame, renown, esteem
legatio	the office of ambassador, embassy, legation
legator	
legatum	a bequest, legacy
legatus	an ambassador, legate
legio	a body of soldiers, legion
legionarius	of a legion, legionary
legitimus	fixed by law, according to law, lawful, legal, legitimate
lego	
legumen	pulse, a leguminous plant
lenis	soft, smooth, mild, gentle, easy, calm
lenitas	softness, smoothness, gentleness, mildness
lens	a lentil
lenteo	
lentus	pliant, flexible, tough, tenacious, sticky, viscous
lenunculus	a small sailing-vessel, bark, skiff
lepidus	pleasant, agreeable, charming, fine, elegant, neat
levis	
levo	
lex	a formal proposition for a law, motion, bill
libenter	willingly, cheerfully, gladly, with pleasure
liber	free, unrestricted, unrestrained, unimpeded, unembarrassed, unshackled
liberalis	of freedom, relating to freedom
liberalitas	a characteristic of a freeman, ingenuousness, frankness, affability
liberaliter	like a freeman, nobly, ingenuously, liberally, courteously, graciously
liberi	free persons
libero	to set free, free, liberate, manumit
liberta	a freedwoman
libertas	freedom, liberty, absence of restraint, permission
libertus	a freedman, emancipated person
libet	it pleases, is pleasing, is agreeable
libo	to take out as a sample, take a little of
libra	a balance, pair of scales
libum	a cake, pancake
licentia	freedom, liberty, license, leave
liceo	to be for sale, be priced, be valued
liceor	to bid, make a bid
licet	It is lawful, is allowed, is permitted
licinus	
lictor	a lictor, official attendant upon a magistrate
ligneus	of wood, wooden
lignor	to fetch wood, collect wood
lignum	gathered wood, firewood
limen	a cross-piece, threshold, head-piece, lintel, sill
lintribusque	
liqueo	to be fluid
littera	a letter, alphabetical sign, written sign of a sound
litus	the sea-shore, sea-side, beach, strand
locarium	
locarius	
loco	to place, put, lay, set, dispose, arrange
locum	
locupletissimas	
locupleto	to make rich, enrich
locupletum	
locus	a place, spot
locutus	
longinquitas	distance, remoteness
longinquus	far removed, far off, remote, distant
longitudo	length
longurius	a long pole
longus	long, extended
loquor	to speak, talk, say, tell, mention, utter
luceo	to be light, be clear, shine, beam, glow, glitter
luci	by daylight
lucius	
luctus	sorrow, mourning, grief, affliction, distress, lamentation
lucus	
ludo	to play, play at a game
ludus	a play, game, diversion
lugeo	to mourn, lament, bewail, deplore
lum	
lupus	a wolf
lus	
luto	
lutum	
lutus	
lux	light, brightness
luxuries	rankness, luxuriance
luxurio	to be rank, be luxuriant, abound to excess
luxurior	to wanton, revel
lx	
lxx	
lxxx	
L	
Labienus	
Lacedaemon	
Laelianus	
Laelius	
Larinates	
Larisaeus	
Larisam	
Latinae	the festival of the Latins, Latin holidays
Latini	
Latinum	
Latinus	of Latium, Latin
Lentulus	
Lepidus	
Leptitani	
Leptitanus	
Liber	an Italian deity of planting and fructification
Libo	
Liburna	
Liburnica	
Liburnicus	
Liburnus	of Liburnia
Licinius	
Lissum	
Lissus	
Litterae	
Longinus	
Lucani	
Lucanus	of Lucania
Lucceius	
Luceria	
Lucilius	
Lucius	
Lucretius	
Lucus	
Lupus	
Lusitani	
Lusitania	
Lusitanus	
m	
machinatio	a contrivance, mechanism, mechanical artifice
macies	leanness, thinness, meagreness, atrophy
magis	
magister	a master, chief, head, superior, director, president, leader, commander, conductor
magistra	a mistress, directress
magistratus	the office of master, magisterial office, civil office, magistracy
magistro	
magnitudo	greatness, size, bulk, magnitude
magnopere	very much, greatly, exceedingly, particularly
magnus	
magus	
mala	the cheek-bone, jaw
maleficium	an evil deed, misdeed, wickedness, offence, crime
malo	to choose rather, prefer
malum	
malus	an upright pole, beam, mast
mancipium	a taking by hand, formal acceptance, taking possession, seisin, legal purchase
mandator	
mandatum	a charge, commission, injunction, command, order
mando	
maneo	to stay, remain, abide, tarry
manes	a departed spirit, ghost, shade
manipularis	belonging to a maniple of a company, manipular
manipulus	a handful, bundle
mano	to flow, run, trickle, drop, drip
manon	
manos	
manuballista	
manus	a hand
mare	the sea
maritima	
maritimus	of the sea, sea-, marine, maritime
marum	
mater	a mother
materia	stuff, matter, material, timber, substance
materio	
maturesco	to become ripe, ripen, come to maturity
maturitas	ripeness, maturity
maturo	to make ripe, ripen, bring to maturity
maturus	ripe, mature
maxime	in the highest degree, most particularly, especially, exceedingly, altogether, very
maximus	large, great, big, high, tall, long, broad, extensive, spacious
majestas	
majores	
majus	
medio	
mediocris	of middling size, medium, middling, moderate, ordinary
medion	
medium	the middle, midst, centre, interval, intervening space
medius	in the middle, in the midst, mid, mean, middle
mei	
meio	to make water
melius	
memini	I remember, recollect, think of, am mindful of, bear in mind
memor	mindful, remembering, heedful
memoria	memory, remembrance
memoro	to bring to remembrance, mention, recount, relate, speak of, say, tell
mendacium	a lie, untruth, falsehood, fiction
mens	the mind, disposition, feeling, character, heart, soul
mensis	a month
mensus	
mentio	a calling to mind, making mention, mentioning, naming, mention
mentum	the chin
meo	to go, pass
mercenarius	
merces	price, hire, pay wages, salary, fee, reward
mereo	to deserve, merit, be entitled to, be worthy of
mereor	to deserve, merit, be entitled to
meridianus	of mid-day, of noon
meridies	mid-day, noon
meridio	to take a mid-day nap, have a siesta.—Supin. acc
meridior	
meritum	a merit, service, kindness, benefit, favor
metarius	
metior	to measure, mete
meto	to reap, mow, crop, gather, collect, harvest
metor	to measure, mete, measure off, mark out, lay out
metropolis	
metropolita	
metus	fear, dread, apprehension, anxiety
meum	
meus	of me, my, mine, belonging to me, my own
miles	a soldier
militaris	of a soldier, of war
militarius	
milito	to be a soldier, perform military service, serve as a soldier
milium	millet
mille	a thousand, ten hundred
mina	a silver mina
minae	projecting points, pinnacles
minimus	least, smallest, very small, minute, trifling, insignificant
mino	
minor	
minoro	
minuo	to make small, lessen, diminish, divide into small pieces
mirificus	wonderful, admirable, marvellous, extraordinary, strange
miser	wretched, unfortunate, miserable, pitiable, lamentable, in distress
miseratio	pity, compassion, sympathy
misericordia	tenderheartedness, pity, compassion, sympathy, mercy
misero	
miseror	to lament, deplore, commiserate
miserum	
missa	
missio	a sending, despatching
missum	
missus	a sending away, sending, despatching
mitto	to cause to go, let go, send, send off, despatch
mobilitas	activity, speed, rapidity, quickness, mobility
mobilito	
moderatus	within bounds, observing moderation, moderate
modero	
moderor	to set a measure, set bounds, put restraint upon, moderate, mitigate, restrain, allay, temper, qualify
modium	
modius	a corn-measure, measure, peck
modo	by a measure, with a limit
modus	a measure, extent, quantity
moenia	defensive walls, ramparts, bulwarks, city walls
mola	a millstone, grindstone
moles	a shapeless mass, huge bulk, weight, pile, load
molio	
molior	to make exertion, exert oneself, endeavor, struggle, strive, toil
molle	
mollio	to make soft, make supple, soften
mollis	yielding, pliant, flexible, supple, soft, tender, delicate, gentle, mild, pleasant
molo	to grind
momentum	a movement, motion
moneo	to remind, put in mind of, admonish, advise, warn, instruct, teach
moneris	a vessel with a single bank of oars, galley
monimentaque	
monitum	an admonition, advice, counsel, suggestion, oracle
monitus	a reminding, warning, admonition
mons	a mountain, mount, range of mountains
montanus	of mountains, belonging to mountains
montuosa	
montuosus	mountainous, full of mountains
mora	
moratus	
morbus	a sickness, disease, disorder, distemper, ailment, illness, malady
morior	to die, expire
moror	to delay, tarry, stay, wait, remain, linger, loiter
mors	death
mortuus	dead
morum	a mulberry
morus	a mulberry-tree
mos	a will, way, habit, manner, fashion, caprice, humor
motus	a moving, motion
moveo	to move, stir, set in motion, shake, disturb, remove
mulier	a woman, female
multa	much, very, exceedingly, greatly, earnestly
multi	
multiplico	to multiply, increase, augment
multitudo	a great number, multitude, crowd, throng
multo	by much, much, a great deal, far, by far
multus	adjec
mum	
munia	duties, functions, official duties
municipem	
municipes	
municipium	a free town, town whose people were Roman citizens, governed by their own laws and magistrates
munio	to wall, defend with a wall, fortify, defend, protect, secure, strengthen
munitio	a defending, fortifying, protecting
munito	to make passable, open
munitus	defended, fortified, protected, secured, safe
munus	a service, office, post, employment, function, duty
murcus	
muro	
murus	a wall, city wall
mus	a mouse
musculus	a little mouse
mutatio	a changing, change, alteration, mutation
mutatus	different, successive
muto	
mutuatus	
mutuo	mutually, in return
mutuor	to borrow, obtain as a loan
mutuus	borrowed, lent
M	
Macedones	
Macedonia	
Macedonius	
Magius	
Manlius	a gentile name
Marcellinus	
Marcellus	
Marcius	
Marrucini	
Marrucinus	
Marsi	
Marsus	
Massilia	
Massilienses	
Massiliensis	
Mauretania	
Media	
Menedemus	
Messana	
Metellus	
Metropolis	
Metropolitae	
Metropolitum	
Milo	
Minerva	the goddess of wisdom, sense, and reflection, of the arts and sciences, of poetry, and of spinning and weaving, identified with the Grecian Athene
Minucius	
Missus	
Murcus	
Mytilenae	
Mytilene	
nam	for
nanciscor	to get, obtain, receive, meet with, stumble on, light on, find
nasco	
nascor	to be born, begin life, be produced, proceed, be begotten
natio	a birth, origin
natis	the rump, buttocks
natura	birth
naturalis	natural, by birth, one's own
naturaliter	naturally, conformably to nature, by nature
natus	birth, age, years
naufragium	a shipwreck
nausea	sea-sickness
nauta	a sailor, seaman, mariner, boatman
navale	
navalia	
navalis	of ships, ship-, nautical, naval
navicula	a small vessel, boat, skiff
navigatio	a sailing, navigation, voyage
navigium	a vessel, ship, bark, boat
navigo	to sail, cruise
navis	a ship
navo	to do zealously, perform diligently, accomplish, effect, prosecute
navus	busy, diligent, assiduous, active
ne	no
necessaria	
necessarius	unavoidable, inevitable, indispensable, pressing, needful, requisite, necessary, compulsory
necesse	unavoidable, inevitable, indispensable, necessary
necessitas	unavoidableness, inevitableness, necessity, compulsion, force, exigency
necessitudo	necessity, compulsion, inevitableness, want, need, distress
neco	to kill, slay, put to death, destroy
nefarium	
nefarius	impious, execrable, abominable, nefarious
neglego	to disregard, not heed, not trouble oneself about, not attend to, slight, neglect, be regardless of, be indifferent to
nego	to say no, deny, refuse
negotiator	a wholesale dealer, merchant, banker, factor
negotior	to carry on business, do wholesale business, act as banker
negotium	a business, employment, occupation, affair
nemen	
nemo	no man, no one, nobody
neo	to spin
nequa	
nequam	worthless, good for nothing
nequaquam	in no wise, by no means, not at all
neque	
nequedum	
nequem	
nequi	
nequid	
nequiquam	
nequo	
nequod	
neu	
neubi	
neuquid	
neuter	neither the one nor the other, neither
neve	and not, nor, and that not, and lest
nihil	
nihilominus	none the less, just as much
nihilum	
nimium	too much, too
nimius	beyond measure, excessive, too great, too much
nisi	if not, unless
niteo	to shine, look bright, glitter, glisten
nitor	
nivit	
nix	snow
no	to swim, float
nobilis	that is known, well-known, famous, noted, celebrated, renowned
nobilitas	celebrity, fame, renown
nobilito	to make known, render famous, make renowned
noceo	to do harm, inflict injury, hurt
nocturnus	of night, by night, nocturnal
nolo	to wish . . . not, will . . . not, not to wish, to be unwilling
nome	
nomen	a means of knowing, name, appellation
nominatim	by name, expressly, especially, particularly, one by one, in detail
non	not, by no means, not at all
nona	
nondum	not yet
nonne	interrog
nonnulli	
nonnullus	some, several
nonnumquam	sometimes, a few times
nonnus	
nonus	the ninth
nos	
nosco	to get knowledge of, become acquainted with, come to know, learn, discern
noster	our, our own, ours, of us
nota	a means of recognition, mark, sign, stamp, impression
notitia	a being known, celebrity, note, fame
noto	to mark, designate with a mark
notus	known
novi	
novissima	
novissimi	
novissimum	
novissimus	
novitas	newness, novelty
novo	to make new, renew, renovate
novum	
novus	new, not old, young, fresh, recent
nox	night
nudo	to make naked, strip, bare, lay bare, expose, uncover
nullus	not any, none, no
numero	to count, enumerate, reckon, number, take account of
numerus	a number
numquam	at no time, never
nunc	now, at present, at this time
nuncupo	to call by name, call, name
nuntia	a female messenger, she that brings tidings
nuntio	to announce, declare, report, relate, narrate, make known, inform, give intelligence of
nuntium	
nuntius	that announces, making known, informing
nuper	newly, lately, recently, freshly, not long ago, just
nus	
nutricius	a bringer-up, tutor
nutus	a nodding, nod
N	
Narbo	
Nasidianus	
Nasidius	
Naupactum	
Naupactus	
Neapolis	
Nona	
Nonae	the Nones, ninth day before the ides
Noricum	
Noricus	
Numida	a nomad
Numidae	
Nymphaeum	
Nymphaeus	
ob	towards, to
obduco	to draw before, draw forward, bring over
obicio	to throw before, throw to, cast, offer, present, expose
obliquo	to turn aside, twist, turn awry
obliquus	sidelong, slanting, awry, oblique, crosswise
obliviscor	to forget
ob-pugno	
ob-reicio	
obscurus	dark, darksome, dusky, shady, obscure
obsecro	to beseech, entreat, implore, supplicate, conjure
ob-sedeo	
obsessio	a blocking up, be sieging, blockade
obsideri	
obsidio	a siege, investment, blockade
obsido	to beset, invest, besiege, blockade
obsidum	
obsigno	to seal, seal up, attest under seal
obstrictus	
obstringo	to shut in, confine
obstruo	to build against, build up, block, stop up, bar, barricade, make impassable
obtectus	
obtego	to cover over, cover up, protect
obtempero	to comply, attend, conform, submit, obey
obtestor	to call as a witness, protest, make appeal to
obtineo	to hold fast, have, occupy, possess, preserve, keep, maintain
obtrectatio	a belittling, detraction, disparagement
obvenio	to come up to, go to meet
obviam	in the way, towards, against, to meet, in face of
obvius	in the way, so as to meet, meeting, to meet
ob-jacio	
objecta	
objectatio	
objecto	
objectus	
occaedes	
occasio	an opportunity, fit time, occasion, convenient season, favorable moment
occasus	a falling, going down, setting
occido	
occulo	to cover, cover over
occulta	
occulto	to hide, conceal, secrete
occultum	
occupatio	a taking possession, occupying, seizure
occupatus	taken up, engrossed, absorbed, occupied, employed, busy, engaged
occupo	to take into possession, seize, occupy, master, win
occurro	to run up, run to meet, go to meet, meet, fall in with
octava	
octavus	the eighth
octo	eight
oculus	an eye
odium	hatred, grudge, ill-will, animosity, enmity, aversion
odor	
odorus	emitting odor, scented, fragrant
offendo	to hit
offensio	a striking against, tripping, stumbling
offensum	
offensus	offended, displeased, vexed, incensed, imbittered
offertor	
officina	a workshop, manufactory
officio	to come in the way of, hinder, oppose, thwart, obstruct
officium	a service, kindness, favor, courtesy
om	
omitto	to let go, let loose, let fall
omne	
omnes	
omnia	
omnino	altogether, wholly, entirely, utterly, at all
omnis	all, every
oneraria	
onerarius	of burden, of transport, for freight
onero	to load, burden, fill, freight
onus	a load, burden
onustus	loaded, laden, burdened, freighted
opera	service, pains, exertion, effort, work, labor
operio	to cover, cover over
opero	
opimus	fat, plump, corpulent
opinio	opinion, supposition, conjecture, fancy, belief, expectation
oportet	it is necessary, is proper, is becoming, behooves
opos	
oppidani	
oppidanus	of a town, of a country town, provincial, rustic
oppido	very, very much, completely, exceedingly, exactly, precisely
oppidum	a town, city, collection of dwellings
oppleo	to fill completely, fill up, fill
oppono	to set against, set before, place opposite, oppose
opportunitas	fitness, convenience, suitableness
opportunus	fit, meet, adapted, convenient, suitable, seasonable, opportune
opposita	
oppositus	
oppressor	
oppressus	
opprimo	to press against, press together, press down, close
oppugnatio	a storming, besieging, attack, assault, siege
oppugno	to fight against, attack, assail, assault, storm, besiege, war with
ops	aid, help, support, assistance, succor
optime	well, better, best
optimum	
opto	to choose, select, prefer
optume	
opulento	to make rich, enrich
opulentus	rich, wealthy, opulent
opus	work, labor, toil
ora	
oratio	a speaking, speech, discourse, language, faculty of speech, use of language
orbis	a ring, circle, re-entering way, circular path, hoop, orbit
orbo	to deprive, strip, spoil, rob, make destitute
ordinatim	in order, in succession, in good order
ordino	to order, set in order, arrange, adjust, dispose, regulate
ordo	a row, line, series, order, rank
orior	to arise, rise, stir, get up
ornamentum	apparatus, accoutrement, equipment, furniture, trappings
oro	to speak
os	
ostendo	to stretch out, spread before, expose to view, show, point out, exhibit, display
ostentatio	a showing, exhibition, display
ostento	to present to view, show, exhibit
ostiaria	
ostiarium	a tax upon doors, door-tax
ostiarius	
ostium	a door
otiosus	at leisure, unoccupied, disengaged, unemployed, idle
otium	leisure, vacant time, freedom from business
Oceanum	
Oceanus	the great sea, outer sea, ocean
Octavianus	
Octavius	
Opimius	
Orchomenus	
Oricius	
Oricos	
Oricum	
Oscenses	
Oscensis	
Otacilius	
Otogesam	
pabularis	
pabularius	
pabulatio	a collecting of fodder, foraging
pabulator	a forager
pabulor	to forage
pabulum	food, nourishment, food for cattle, fodder, pasturage, grass
pacandas	
pacaverat	
pacaverint	
pacavissent	
pactio	an agreeing, agreement, covenant, contract, stipulation, bargain, pact
paene	nearly, almost, as I may say
paeniteo	to make sorry, cause to repent
pala	a spade
palaestes	
palam	
pale	
palma	the palm, flat hand
palmo	
palmus	
paludatus	with a military cloak, in the garb of a general, in field dress
palustria	
panicum	panic-grass
panis	bread, a loaf
panus	
par	equal
pararius	
paratus	
parco	to act sparingly, be sparing, spare, refrain from, use moderately
parens	
parento	to offer a solemn sacrifice in honor of dead kindred
pareo	to appear, be visible, be at hand
paries	a wall
pario	to bring forth, bear, give birth, drop, lay, spawn, produce
pariter	equally, in an equal degree, in like manner, as well, as much, alike
parito	
paro	
pars	a part, piece, portion, share, division, section
parta	
participo	to make partaker
partio	to share, part, distribute, apportion, divide
partior	to share, part, distribute, apportion, divide
partus	
parum	too little, not enough, insufficiently
parus	
parvulus	
parvus	little, small, petty, puny, inconsiderable
pasco	to cause to eat, feed, supply with food
pascor	
passim	spread, scattered about far and wide, at different places, generally, in every direction, at random
passum	
passus	
pastor	a herdsman, shepherd
patefacio	to lay open, open, throw open
pateo	to stand open, lie open, be open
pater	a father, sire
paternus	of a father, fatherly, paternal
patienter	patiently, with endurance, submissively
patientia	the quality of suffering, patience, endurance, submission
patior	to bear, support, undergo, suffer, endure
patria	a fatherland, native land, own country, native place
patrium	
patrius	
patro	to bring to pass, execute, perform, achieve, accomplish, bring about, effect, finish, conclude
patronus	a protector, defender, patron
pauca	
pauci	
paucitas	a small number, fewness, scarcity, paucity
paucus	few, little
paulatim	by little and little, by degrees, gradually
paulisper	for a little while, for a short time
paulum	a little, somewhat
paulus	little, small
paveo	to be struck with fear, be in terror, tremble, quake with fear, be afraid, be terrified
pavimento	
pavimentum	a level surface beaten firm, hard floor, pavement
pax	a compact, agreement, treaty, peace, treaty of peace, reconciliation
pecco	to miss, mistake, do amiss, transgress, commit a fault, offend, sin
pectus	a breast, breast-bone
pecunia	property, riches, wealth
pecuniarius	of money, pecuniary
pecus	
pedalis	of the size of a foot
pedestri	
pedis	
peditatus	foot-soldiers, foot, infantry
pedito	
peditum	
peditumque	
pedo	to break wind
pedum	a shepherd's crook, sheephook
pellis	a skin, hide, felt, pelt
pello	to beat, strike, knock, push, drive, hurl, impel, propel
penis	a tail
per	through, across, through the midst of, from side to side of, traversing
peragito	to harass, disturb
perago	to thrust through, pierce through, transfix
percello	to beat down, throw down, overturn, upset
percipio	to take wholly, seize entirely, take possession of, seize, occupy
percrebresco	to become frequent, grow prevalent, be spread abroad
percurro	to run, run along, run all the way, run through, hasten through, traverse, run over, pass over
perdo	to make away with, destroy, ruin, squander, dissipate, throw away, waste, lose
perdoleo	to pain deeply, grieve greatly
perdolesco	to feel great pain, be deeply grieved
perduco	to lead through, lead, bring, conduct, guide
perducto	
pereo	to pass away, come to nothing, vanish, disappear, be lost
perequito	to ride through, ride hither and thither, ride about
perexiguus	very small, petty, insignificant
perfectus	finished, complete, perfect, excellent, accomplished, exquisite
perfero	to bear through, bring home
perficio	to achieve, execute, carry out, accomplish, perform, despatch, bring about, bring to an end, finish, complete
perficus	
perfidia	faithlessness, treachery, perfidy
perfringo	to break through, break in pieces, shiver, shatter
perfuga	a deserter
perfugio	to flee for refuge
pergratus	very agreeable, extremely pleasant
periclitor	to try, prove, test, make trial of, put to the test
periculosus	dangerous, hazardous, perilous
periculum	a trial, experiment, attempt, test, proof, essay
peridoneus	very suitable, well adapted
perisson	
peritissimus	
peritus	experienced, practised, trained, skilled, skilful, expert
perlego	to view all over, examine thoroughly, scan, survey
permaneo	to stay, hold out, last, continue, abide, be permanent, endure, remain, persist, persevere
permano	to flow to, penetrate, reach
permisceo	to mix together, mix thoroughly, commingle, intermingle
permitto	to let pass, let go, let loose
permoveo	to move deeply, rouse, excite, agitate, influence, lead, induce, prevail on
permultus	very much, very many
pernicies	destruction, death, ruin, overthrow, disaster, calamity, mischief
perniciosa	
perniciosus	destructive, ruinous, baleful, pernicious
pernicitas	nimbleness, briskness, agility, swiftness
perpaucus	
perpes	
perpetior	to bear steadfastly, suffer firmly, stand out, abide, endure, be patient
perpetuo	
perpetuum	
perpetuus	continuous, unbroken, uninterrupted, constant, entire, whole, perpetual
perrumpo	to break through, force a way through, get across
perscribo	to write in full, write at length, write out
persequor	to follow perseveringly, follow after, follow up, pursue
persero	
perseverantia	steadfastness, perseverance
persevero	to abide, adhere strictly, continue steadfastly, persist, persevere
perspectus	clearly perceived, evident, well known
perspicio	to look through, look into, look at, see through
persuadeo	to convince, persuade
persuasus	fixed, settled
perterreo	to frighten thoroughly, terrify
perterrito	
pertinacia	perseverance, persistence, stubbornness, obstinacy, pertinacity
pertineo	to stretch out, reach, extend
perturbata	
perturbatio	confusion, disorder, disturbance
perturbo	to confuse, disturb, confound, throw into disorder
perveho	to bear through, convey through
pervenio	to come up, arrive
pervulgo	
pes	a foot
pestilens	pestilential, infected, unhealthy, unwholesome
pestilentia	an infectious disease, plague, pest, pestilence
pestribus	
petitio	a blow, thrust, pass, attack, aim
peto	to strive for, seek, aim at, repair to, make for, travel to
petra	a rock, crag
petraeus	
phalangae	wooden rollers
phalanx	a compact body of heavy armed men in battle array, battalion, phalanx
phoenice	
phoenix	the phoenix, a fabulous bird
picus	a woodpecker
pignus	a pledge, gage, pawn, security, guaranty
pila	a ball, playing-ball
pilo	
pilum	a heavy javelin, pilum
pilus	
piscatorius	of fishermen, fishing-
piso	
pisum	
placentia	
placeo	to please, give pleasure, be approved, be pleasing, be agreeable, be acceptable, suit, satisfy
placo	to quiet, soothe, assuage, allay, appease
plancus	
planitiem	
planities	
planum	
planus	
platalea	a waterfowl, spoonbill
platea	a broad way, street, avenue
plautus	
plebs	the common people, commons, commonalty, plebeians, folk
plenum	
plenus	full, filled
pleo	
pleraque	
plerus	
plurimus	most, very much, very many
pluteum	
pluteus	a penthouse, shed, mantlet
poena	indemnification, compensation, recompense, retribution, satisfaction, expiation, punishment, penalty, price
polleo	to be strong, be powerful, flourish, thrive, be able, prevail, avail
polliceo	
polliceor	to hold forth, offer, promise
pollicitatio	a promising, promise
pollicitum	a promise, pledge
pondo	by weight, in weight
pondus	a weight
pono	to put down, set down, put, place, set, fix, lay, deposit
pons	a bridge
pontem	
pontes	
pontibus	
pontifex	a high-priest, pontiff, pontifex
ponto	a large flat boat
pontus	the sea
populo	to lay waste, ravage, plunder, pillage, spoil
populus	
porta	a city-gate, gate
portarius	
porticus	a covered walk between columns, colonnade, piazza, arcade, gallery, porch, portico
porto	to bear, carry, convey, take
portus	a harbor, haven, port
positus	
possessio	a taking possession of, seizing, occupying, taking
possum	to be able, have power, can
post	
postea	after this, after that, hereafter, thereafter, afterwards, later
posteritas	the future, future time, futurity, after-ages
postero	
posterus	m
postquam	after that, after, as soon as, when
postremo	at last, finally, last of all
postridie	on the day after, the next day
postulata	
postulatum	a demand, request, claim
postulatus	a claim, suit, complaint
postulo	to ask, demand, claim, require, request, desire
postumum	
postumus	last, latest-born, late-born
potens	able, mighty, strong, powerful, potent
potentia	might, force, power
potestas	ability, power, capacity, force
potio	a drinking
potior	to become master of, take possession of, get, obtain, acquire, receive
potis	able, capable
potissimus	
potitus	
praeacuo	
praebeo	to hold forth, reach out, proffer, offer, tender
praeceps	
praecepto	
praeceptor	a teacher, instructor, preceptor
praeceptum	a maxim, rule, precept, order, direction, command, injunction
praecipio	to take beforehand, get in advance
praecipito	to throw headlong, cast down, hurl down, precipitate
praecipuum	
praecipuus	taken before others, particular, peculiar, especial
praecludo	to shut off, shut, close
praeclusus	
praecurro	to run before, hasten on before, precede
prae-curro	
praeda	property taken in war, booty, spoil, plunder, pillage
praedico	
praedo	one that makes booty, a plunderer, robber
praeduco	to draw out before, construct in front
praefectura	the office of an overseer, overseership, superintendence
praefectus	an overseer
praefero	to bear before, carry in front, hold forth
praeficio	to set over, place in authority over, place at the head, appoint to command
praefigo	to fasten before, set up in front, affix
praefringo	to break off before, break to pieces, shiver
praegredior	to go before, go in advance, precede
praemissa	
praemitto	to send forward, despatch in advance
praemium	an advantage, prerogative, favor, license, privilege
prae-munio	
praemunio	to fortify in front
praeoccupo	to seize upon beforehand, preoccupy
praeparo	to make ready beforehand, prepare, equip, make preparations
praependeo	to hang before, hang down in front
praepono	to place in front, put upon, affix
praepositus	
praeripio	to snatch away, carry off
praerumpo	to break off before, tear away in front
praerupta	
praeruptus	broken off, steep, abrupt, rugged
praescribo	to write before, prefix in writing
praescriptio	a prefix in writing, title, inscription, preface, introduction
praescriptum	a previous direction, precept, limitation, proviso, regulation
praescriptus	
praeseco	to cut off before, cut away, cut off, cut out
praesens	at hand, in sight, present, in person
praesentia	a being at hand, presence
praesentio	to feel beforehand, perceive in advance, have a presentiment of, presage, divine
praesento	
praesepit	
praesepserat	
praesertim	especially, chiefly, principally, particularly
praesideo	to guard, watch, protect, defend
praesidium	defence, protection, guardianship, help, aid, assistance
praesto	
praestolor	to stand ready for, wait for, expect
praestus	
praesum	to be before, be set over, preside over, rule, have charge of, command, superintend
praeter	
praeterea	in addition, beyond this, further, besides, moreover
praetereo	to go by, go past, pass by, pass
praeterita	
praetermitto	to permit to go by, let pass, let go
praetero	
praetervehor	to be borne past, drive by
praetor	a leader, head, chief, president, chief magistrate, chief executive, commander
praetorium	the general's tent
praetorius	of the praetor, of praetors, praetorian
praetorqueo	
praetura	the office of a praetor, praetorship
praejudicium	
preco	
prehendo	to lay hold of, grasp, snatch, seize, catch, take
premo	to press
pressio	a prop, support
prex	a prayer, request, entreaty
pridem	long ago, long since, a long time ago
pridie	on the day before, the previous day
prima	
primo	at first, at the beginning, first, in the first place
primores	
primus	the first, first
princeps	first in order, foremost
principatus	a beginning, origin
principes	
principor	
prior	former, previous, prior, first
priores	
pristinum	
pristinus	former, early, original, primitive, pristine
privatim	apart from State affairs, as an individual, in private, privately, in a private capacity
privatus	apart from the State, peculiar, personal, individual, private
privo	to bereave, deprive, rob, strip
pro	
probata	
probation	
probo	to make good, esteem good, approve, esteem, commend
procedo	to go before, go forward, advance, proceed, march on, move forward, go forth
proclive	
proclivis	sloping, steep, going downward, downhill
proclivus	
procul	in the distance, at a distance, away, apart, far, afar off, from afar
procumbo	to fall forwards, sink down, fall prostrate
procuratio	a caring for, charge, superintendence, administration, management, procuration
procurator	a manager, overseer, superintendent, agent, administrator, deputy, procurator, keeper
procuro	to take care of, attend to, look after
procurro	to run forth, rush forward, charge
pro-curro	
prodeo	to go forth, come forth, come forward
proditio	a betrayal, treason, treachery
proditus	
prodo	to put forth, exhibit, reveal
produco	to lead forth, lead forward, bring out
producta	
producto	to throw before, interpose
proeliaris	
proelio	
proelior	to join battle, engage in battle, fight
proelium	a battle, combat
pro-eo	
profectio	a going away, setting out, departure
profecto	actually, indeed, really, truly, assuredly, certainly
profectus	advance, effect, increase, profit, success
profero	to carry out, bring forth, produce
proficio	to make headway, advance, make progress, have success, profit, succeed, effect, accomplish
proficisco	
proficiscor	to set forward, set out, start, go, march, depart
profiteor	to declare publicly, own freely, acknowledge, avow, confess openly, profess
profligo	to strike to the ground, cast down utterly, overthrow, overcome, conquer
profugio	to flee, run away, escape
profundo	to pour out, pour forth, shed copiously, cause to flow
progredio	
progredior	to come forth, go forth, go forward, go on, advance
progressus	a going forward, advance, progress
prohibeo	to hold before, hold back, keep away, check, restrain, hinder, prevent, avert, keep off, debar
proicio	to throw forth, cast before, throw out, throw down, throw
proinde	hence, therefore, accordingly, then
prolatio	a bringing forward, adducing, mentioning
proluo	to wash forth, throw out, cast out
promoveo	to move forward, cause to advance, push onward, advance
promptus	
promulgo	to bring forward publicly, propose openly, publish, promulgate
promunturium	a projecting part of a mountain, spur
promutuum	
promutuus	paid beforehand, advanced, lent in advance
pronuntiatio	a public declaration, publication, proclamation
pronuntio	to make publicly known, publish, proclaim, announce
prope	near, nigh
propello	to drive forward, drive forth, drive away, drive out
propero	to make haste, hasten, be quick, be in haste, go quickly
propinqua	
propinquitas	nearness, vicinity, proximity, propinquity
propinquo	to draw near, come nigh, approach
propinquum	
propinquus	near, nigh, neighboring
propiore	
propius	
propono	to put forth, set forth, lay out, place before, expose to view, display
propositum	that which is proposed, a plan, intention, design, resolution, purpose
proprius	not common with others, own special, several, individual, peculiar, particular, proper
propter	
propterea	therefore, for that cause, on that account
propugnator	one who fights in defence, a defender, soldier
propugno	to go forth to fight, sally, make sorties
proripio	to drag forth
proruo	to rush forth, make an onset, sally
prosequium	
prosequor	to follow, accompany, attend, follow after, escort
prospica	
prospicio	to look forward, look into the distance, have a view, look out, look, see
protectum	
protego	to cover before, hide in front, cover over, cover, protect, shelter
protero	to tread under foot, trample down, wear away, crush, bruise
protinus	right onward, forward, farther on, onward
prout	according as, in proportion, accordingly, proportionately as, just as, as
proveho	to carry forward, move along, convey
provenio	to come forth, appear, arise, be produced
proventus	a coming forth, growth, produce, yield
provideo	to see in advance, discern, descry
provincia	an office, duty, pursuit, charge, business, province
provisus	a looking forward, distant view
provoco	to call forth, call out, summon
proxime	nearest, very near, next
proximi	
proximo	very lately, shortly
proximum	
proximus	the nearest, next
pro-jacio	
projectum	
projectus	
puberes	
pubes	
publica	
publicanus	of the public revenue
publico	to make public, adjudge to public use, confiscate
publicum	
publicus	of the people, of the state, done for the state, public, common
pudeo	to be ashamed, feel shame
pudor	a shrinking from blame, desire of approval, shame, shamefastness, modesty, decency, propriety
puer	a male child, boy, lad, young man
puera	
pugna	a hand-to-hand fight, fight at close quarters, battle, combat, action, engagement
pugnantia	contradictions, inconsistencies, things irreconcilable
pugno	to fight, combat, give battle, engage, contend
pugnus	a fist
puleium	fleabane, fleawort, pennyroyal
pulso	to push against, strike upon, beat, hammer, keep hitting, batter
pulsus	a pushing, beating, striking, stamping, push, blow, impulse, stroke
pulvero	
pulvis	dust, powder
punctum	a prick, puncture
pungo	to prick, puncture
purgo	to free from what is superfluous, make clean, make pure, clean, cleanse, purify
puteus	a well
puto	to clean, cleanse, trim, prune
P	
Paeligno	
Paelignus	
Palaeste	
Partheni	
Parthi	
Parthicus	
Parthini	
Parthinus	
Parthus	
Pedius	
Peligni	
Pelusium	
Pelusius	
Pergama	the citadel of Troy, Troy
Pergamum	
Petra	
Petraeus	
Petreius	
Petreus	
Pharus	
Philippus	a king of Macedonia, father of Alexander the Great
Phoenices	the Phoenicians
Phoenix	
Picenum	
Picenus	
Pisaurius	
Pisaurum	
Piso	
Placentia	
Plancus	
Plautius	
Pompeum	
Pompejani	
Pompejanum	
Pompejanus	
Pompeji	
Pompejus	
Pomponianam	
Pomponius	
Pontus	
Postumus	
Pothinus	
Ptolomaeus	
Ptolomaide	
Pupius	
Puteoli	
Pyrenaeum	
Pyrenaeus	of Pyrene, Pyrenaean
qua	on which side, at which place, in what direction, where, by what way
quadriremis	with four banks of oars, quadrireme
quadro	to make square, put in order, arrange, complete
quaero	to seek, look for
quaeso	to beg, pray, beseech, entreat
quaestor	a quaestor
quaestus	a gaining, acquiring, gain, acquisition, profit, advantage
qualis	how constituted, of what sort, of what nature, what kind of a
qualum	
qualus	a wicker basket, work-basket
quam	Relat., in what manner, to what degree, how greatly, how, how much
quanto	by how much, by as much as, according as
quantum	as much as, so much as, to as great an extent
quantus	Relat
quaque	
quare	
quarta	
quartum	for the fourth time
quartus	the fourth
quasi	as if, just as if, as though
quaterni	four each, by fours, four at a time
quattuor	four
quattuorviri	a commission of four members
que	and
quemadmodum	
queo	to be able, can
querimonia	a complaining, lamentation, lament
queror	to express grief, complain, lament, bewail
questus	a complaining, complaint, plaint
qui	
quia	because
quicumque	rel., whoever, whatever, whosoever, whatsoever, every one who, everything that, all that
quidam	a certain, a kind of, as one might say
quidem	assuredly, certainly, in fact, indeed
quies	a lying still, rest, repose, inaction, freedom from exertion
quiesco	to rest, repose, keep quiet, be inactive, be at peace
quieti	
quietum	
quin	why not? wherefore not?
quingenti	
quini	five each
quinqueremis	with five banks of oars
quis	plur
quisnam	who then? who in the world? which, I insist? what, pray?
quisquam	indef
quisque	whoever it be, whatever, each, each one, every, everybody, every one, everything
quisquis	rel
quivis	whoever it be, whom you please, any one, any whatever, anything
quo	loci
quoad	as far as
quodam	
quodsi	
quominus	
quonam	whither pray?
quoniam	since now, since then, since, seeing that, as, because, whereas
quoquoversus	in every direction, every way
quotiens	how often? how many times?
quotienscumque	how often soever, as often soever as
Q	
Quintilius	
radico	
radix	a root
rapiditas	swiftness, rush, velocity
rapidus	tearing away, seizing, fierce
raptim	snatchingly, hastily, suddenly, speedily, hurriedly
rarus	of loose texture, thin, rare, not thick
ratio	a reckoning, numbering, casting up, account, calculation, computation
ratis	a raft, float
recedo	to go back, fall back, give ground, retire, withdraw, recede
recens	
receptaculum	a place of deposit, reservoir, magazine, receptacle
recepto	to take back, wrest away
receptum	an engagement, obligation, guaranty
receptus	a taking back, retraction, recantation
recingo	to ungird, loosen, undo
recipero	
recipio	To take back, bring back, carry back, retake, get back, regain, recover
recito	to read out, read aloud, recite, declaim, rehearse
reconcilio	to procure again, regain, recover, restore, re-establish
recondita	
reconditum	
recondo	to put up again, put back, lay up, put away, hoard, shut up, close, hide, conceal, bury
recordor	to think over, bethink oneself of, be mindful of, call to mind, remember, recollect
recreo	to make anew, renew, restore, revive, refresh, recruit, invigorate
rectum	good, uprightness, rectitude, virtue
recuperabimus	
recurro	to run back, hasten back, return
recusatio	a declining, refusal
recuso	to make an objection against, decline, reject, refuse, be reluctant to do
reddo	To give back, return, restore
re-demo	
redeo	to go back, turn back, return, turn around
redigo	to drive back, force back, lead back, bring back
reditus	a going back, returning, return
reduco	imper
reducto	
re-emo	
re-eximo	
refectus	
refercio	to fill up, stuff, cram
refero	to bear back, bring back, drive back, carry back
reficio	to make again, make anew, reconstruct, remake, restore, renew, rebuild, repair, refit, recruit
reformido	to fear greatly, dread, stand in awe, shrink, shudder, be afraid
refuga	
refugio	to flee back, flee for safety, run from, run away, flee, escape, take refuge, avoid, shun
regero	to carry back, bring back, throw back, throw again
regia	a royal palace, castle, fortress, residence, court
regio	a direction, line
regius	of a king, kingly, royal, regal
regno	to have royal power, be king, rule, reign
regnum	kingly government, royal authority, kingship, royalty
rego	to keep straight, lead aright, guide, conduct, direct, control
regredior	to go back, turn back, return
regula	a straight stick, bar, staff
regulo	
reicio	to throw back, fling back, hurl back
relictus	
religio	conscientiousness, sense of right, moral obligation, duty
religo	to bind back, fasten up, bind fast
relinquo	to leave behind, not take along, not stay with, leave, move away from
reliqua	
reliquiae	what is left, a remainder, leavings, remains, relics, remnant, rest
reliquum	
reliquus	left, left over, remaining
remaneo	to stay behind, be left, remain
remano	
remedio	
remedior	
remedium	that which restores health, a cure, remedy, antidote, medicine
remex	a rower, oarsman
remigo	to ply the oar, row
remissa	
remitto	to let go back, send back, despatch back, drive back, cause to return
removeo	to move back, take away, set aside, put off, drive away, withdraw, remove
remulcum	a tow-rope
remus	an oar
renovo	to renew, restore
renumero	to pay back, repay
renuntio	to bring back word, carry tidings back, report, give notice, declare, announce
reor	to reckon, calculate, believe, think, suppose, imagine, judge, deem
repello	to drive back, thrust back, drive away, reject, repulse, repel
repens	predic., suddenly, unexpectedly
repentinus	sudden, hasty, unlooked for, unexpected, impetuous
reperio	to find again, find, meet with, find out, discover
repetitus	
repeto	to fall upon again, attack anew, strike again
repo	to creep, crawl
repono	to put back, set back, replace, restore
reporto	to bear back, bring again, carry back
reprehendo	to hold back, hold fast, take hold of, seize, catch
reprehenso	to check continually
reprimo	to press back, keep back, check, curb, restrain, hem in
repudiata	
repudiatus	
repudio	to cast off, put away, reject
repugno	to fight back, oppose, make resistance, resist, struggle, defend oneself
repulsa	a rejection, denial, refusal, repulse
requiesco	to rest, take rest, repose
requiro	to seek again, look after, search for
res	a thing, object, matter, affair, business, event, fact, circumstance, occurrence, deed, condition, case
rescribo	to write back, write in return, reply in writing
reservo	to keep back, save up, reserve
resisto	to stand back, remain standing, stand still, halt, stop, stay, stay behind, remain, continue
respicio	to look back, look behind, look about, see behind, look back upon, gaze at, look for
respondeo	to answer, reply, respond, make answer
responso	to return, answer, re-echo
responsum	an answer, reply, response
responsus	
restagno	to run over, overflow
restituo	to set up again, replace, restore, reconstruct, rebuild, revive, renew, reform, rearrange
resto	to withstand, resist, oppose, stand firm, hold out, not yield
retendo	to release from tension, unbend, slacken, relax
retento	to hold back firmly, keep back, hold fast
retentus	
retineo	to hold back, keep back, keep, detain, retain, restrain
retorqueo	to twist back, turn back, throw back
retraho	to draw back, withdraw, call back
reus	concerned in a thing, party to an action
revoco	to call again, call back, recall
revorto	
rex	an arbitrary ruler, absolute monarch, king
ripa	a bank, margin
rivus	a small stream, brook
robur	hard-wood, oak-wood, oak
rogatio	a question, interrogation
rogito	to ask eagerly, inquire persistently, keep asking
roro	to drop dew, scatter dew
rostrum	a beak, bill, snout, muzzle, mouth
rufius	
rufus	red, reddish
ruina	a rushing down, tumbling, falling down, fall
rumor	a rustle, murmur, vague sound
rupes	a rock, cliff
rursus	turned back, back, backwards
rus	the country, lands, fields, a country-seat, farm, estate
rutilus	red, golden red, reddish yellow
Ravenna	
Rebilus	
Rhascypolis	
Rhodanus	
Rhodii	
Rhodius	
Rhodos	
Roma	Rome, the mother city
Romanus	of Rome, Roman
Roscius	
Roucilli	
Roucillus	
Rubrius	
Rufus	
Ruteni	
Rutilius	
saburra	sand, ballast
saburro	
sacerdos	a priest, priestess
sacerdotium	the priesthood, office of a priest, sacerdotal office
sacramentum	a sum deposited by a party in a civil process, as security for a future judgment, forfeit money, guaranty
saepe	often, oft, oftentimes, many times, frequently
saepes	a hedge, fence
saepis	
saga	a wisewoman, fortune-teller, sooth-sayer, witch
sagio	to perceive keenly, discern acutely
sagitta	an arrow, shaft, bolt
sagittarii	
sagittarius	an archer, bowman
sagitto	to discharge arrows, shoot with arrows
sagum	a coarse woollen blanket, rough mantle
sagus	
salinae	salt-works, salt-pits
salinum	a vessel for salt, salt-cellar
salio	to leap, spring, bound, jump, hop
salo	
saltus	
saluberrimis	
salum	the open sea, high sea, main, deep
salus	soundness, health, good health, vigor
salutare	
salutaris	of wellbeing, healthful, health-giving, wholesome, salutary
saluto	to greet, wish health, pay respects, salute, hail
salvo	
salvus	
sancio	to make sacred, render inviolable, fix unalterably, establish, appoint, decree, ordain, confirm, ratify, enact
sanguis	blood
sano	to make sound, heal, cure, restore to health
sarcina	a package, bundle, burden, load, pack
sarcinarius	of burdens, for baggage
sarcio	to patch, botch, mend, repair, restore, make good
sata	standing corn, crops
satisfacere	
satum	
saucius	wounded, hurt
saxum	a large stone, rough stone, broken rock, bowlder, rock
scaeva	
scaevus	
scala	
scalae	a flight of steps, stairs, staircase, ladder, scaling-ladder
scapha	a light boat, ship's boat, skiff
scaphe	
scelerus	
scelus	a wicked deed, heinous act, crime, sin, enormity, wickedness
scienter	knowingly, understandingly, intelligently, skilfully
scientia	a knowing, knowledge, intelligence, science
scio	to know, understand, perceive, have knowledge of, be skilled in
scipio	a staff, walkingstick
scius	
scopulus	a projecting point of rock, rock, cliff, crag, shelf, ledge
scribo	to scratch, grave, engrave, draw
scriptum	something drawn, a space enclosed by lines
scutatus	armed with a long shield
scutula	a diamond-shaped figure, lozenge, rhombus
scutulum	a small shield
scutum	a shield, Roman shield, infantry shield, buckler
secerno	to put apart, sunder, sever, part, divide, separate
secessio	a going aside, withdrawal, retirement
secludo	to shut off, shut apart, shut up, seclude, part
secretum	a hidden thing, mystery, secret
secunda	
secundae	
secundo	
secundum	following, by, along, beside
secundus	following, next, second
sed	but, on the contrary, but also, but even, but in fact
seditio	a going aside, going apart, insurrectionary separation, dissension, civil discord, insurrection, mutiny, sedition
sedo	to bring to rest, lay
segnis	slow, tardy, slack, dilatory, lingering, sluggish, inactive, lazy
sella	a seat, settle, chair, stool
semel	once, a single time
semenstri	
semoveo	to move apart, put aside, remove, separate
semper	ever, always, at all times, continually, perpetually, forever
senator	a member of the Senate
senatorius	of a senator, senatorial
senatus	the council of the elders, council of state, Senate, body of senators
senex	old, aged, advanced in years
seni	six each
senium	old age, senility, decline
sententia	a way of thinking, opinion, judgment, sentiment, thought, notion, purpose, determination, decision, will, desire
sentina	bilge-water
sentio	to discern by sense, feel, hear, see, perceive, be sensible of
separatim	asunder, apart, separately, severally
septimus	the seventh
sequor	to follow, come after, follow after, attend, accompany
serapion	
serius	grave, earnest, serious
sermo	continued speech, talk, conversation, discourse
sero	late, at a late hour
serpo	to creep, crawl
serus	long hence
serva	a female slave, hand-woman, maid
servilis	of a slave, slavish, servile
servio	to be a servant, be enslaved, serve, be in service
servo	to make safe, save, keep unharmed, preserve, guard, keep, protect, deliver, rescue
servus	
se-sequor	
setius	less, in a less degree
seuquid	
severus	serious, sober, grave, strict, austere, stern, severe
sex	six
sexcenarius	of six hundred
sexennis	of six years, six years old
sexennium	a period of six years, six years
sextus	the sixth
si	if, when, inasmuch as, since
sic	thus, in this way, as I do, as you see
sicilio	
sicut	so as, just as, as
sicuti	
signifer	sign-bearing, bearing the constellations, starry
significatio	a pointing out, indicating, expression, indication, mark, sign, token
significo	to make signs, show by signs, show, point out, express, publish, make known, indicate, intimate, notify, signify
signo	to set a mark upon, mark, mark out, designate
signum	a mark, token, sign, indication, proof
silentium	a being still, keeping silence, noiselessness, stillness, silence
silva	a wood, forest, woodland
similis	like, resembling, similar
similitudo	likeness, resemblance, similitude
simul	at the same time, together, at once, simultaneously
simulacrum	a likeness, image, figure, portrait, effigy, statue
simulatio	an assumption, false show, feigning, shamming, pretence, feint, insincerity, deceit, hypocrisy, simulation
simulo	to make like, imitate, copy, represent
simultas	a hostile encounter, dissension, enmity, rivalry, jealousy, grudge, hatred, animosity
simus	flat-nosed, snub-nosed
sin	if however, if on the contrary, but if
sine	without
singularis	one by one, one at a time, alone, single, solitary, singular
singularius	
singulus	
sinister	left, on the left, on the left hand, at the left side
sinistra	
sinistrum	
sino	to let down, set, fix
sinum	a large vessel of earthenware, pot, jar
sinus	a bent surface, curve, fold, hollow, coil
siquando	
siquis	
sive	or if
societas	fellowship, association, union, community, society
socius	
sol	the sun
solacium	a soothing, assuaging, comfort, relief, consolation, solace
soleo	to use, be wont, be accustomed
sollertia	skill, shrewdness, ingenuity, dexterity, adroitness, expertness
sollicito	to disturb, stir, agitate, move, shake
sollicitudo	uneasiness of mind, care, disquiet, apprehension, anxiety, solicitude
sollicitus	thoroughly moved, agitated, disturbed
solo	
solum	
solus	alone, only, single, sole
solutio	a loosing, relaxation, weakening
solutum	
solvo	to loosen, unbind, unfasten, unfetter, untie, release
somnus	sleep
sono	to make a noise, sound, resound
sonus	a noise, sound
soror	a sister
sors	a lot
spatior	to spread abroad, spread out, expand
spatium	a space, room, extent
species	a sight, look, view, appearance, aspect, mien
specto	to look on, look at, behold, gaze at, watch, observe, inspect, attend
speculator	a looker-out, spy, scout, explorer
specus	a natural cavity, cave, cavern, grot, den, chasm, channel, pit
spero	to hope, look for, trust, expect, promise oneself
spes	hope
spiritus	a breathing, breath
spolio	to strip, uncover, bare, unclothe
spolium	the skin, hide, fell
sponte	
statim	steadily, regularly
statio	a standing, standing firm
stativa	
stativae	
stativus	set, stationary, fixed
statua	an image, statue, monumental figure, representation in metal
statumino	
statuo	to cause to stand, set up, set, station, fix upright, erect, plant
status	
stipendior	
stipendium	a paying of tax, tax, impost, tribute, contribution
stipes	a log, stock, post, trunk, stake
sto	to stand, stand still, remain standing, be upright, be erect
storea	a plaited covering, straw mat, rush mat, rope mat
storia	
stringo	to draw tight, bind tight, compress, press together
structura	a building, mode of building, construction
structus	
struo	to place together, heap up, pile, arrange
studeo	to give attention, be eager, be zealous, take pains, be diligent, be busy with, be devoted, strive after, apply oneself, pursue, desire, wish
studium	application, assiduity, zeal, eagerness, fondness, inclination, desire, exertion, endeavor, study
stultus	foolish, simple, silly, fatuous, stupid, dull
stuppa	coarse flax, tow, oakum
sua	
sub	under, below, beneath, underneath, behind
subduco	to draw away, take away, lead away, carry off, wrest, withdraw, remove
subeo	to come under, go under, enter
subfragabatur	
subicio	to throw under, place under, cast below
subitum	
sublevo	to lift from beneath, raise up, hold up, support
sublica	a stake, pile, palisade
subluo	to wash underneath, flow below, wash at the foot
sub-mergo	
sub-moveo	
subnubilus	somewhat cloudy, overcast, obscure
sub-peto	
sub-porto	
sub-reicio	
subsequor	to follow after, follow up, succeed, ensue
subsequus	
subsidiarius	of a reserve, reserved, subsidiary
subsidium	the troops in reserve, line of reserve, third line of battle, triarii
subsisto	to take a stand, take position, stand still, remain standing, stop, halt
substiterant	
substitisse	
substructio	a foundation, substructure
subsum	to be under, be behind
subtero	
subvenio	to come to help, aid, assist, reinforce, relieve, succor
sub-jacio	
subjecto	
subjectum	
subjectus	
succedo	to go below, come under, enter
succurro	to run under, run to help, hasten to the aid of, help, aid, assist, succor
sudis	a stake, pile
sudo	to sweat, perspire
suffero	to take up, submit to, undergo, bear, endure, suffer
sui	Reflex
sum	to be, exist, live
summa	the top, summit
summas	
summissa	
summitto	
summotor	
summum	at the utmost, at farthest, at most
summus	uppermost, highest, topmost
sumo	to take, take up, take in hand, lay hold of, assume
sumptus	outlay, expense, cost, charge
suo	to sew, stitch, sew up, sew together
super	
superius	
supero	to go over, rise above, overtop, surmount, transcend
supersum	to be over and above, be left, remain
superus	that is above, upper, higher
supo	
suppeto	to be at hand, be in store, be present, be available
supplementum	that which fills out, supplies, reinforcements
supplex	kneeling in entreaty, begging, entreating, humble, submissive, beseeching, suppliant, supplicant
suppliciter	like a petitioner, humbly, submissively, suppliantly
supplicium	a kneeling, bowing down, humble entreaty, petition, supplication
supplico	to kneel down, humble oneself, pray humbly, beseech, beg, implore, supplicate
supporto	to convey, bring up, bring forward, conduct
supprimo	to sink, send to the bottom
supra	
surruo	
sus	a swine, hog, pig, boar, sow
suscenseo	to be angry, be indignant, be enraged, be provoked
suscepto	
susceptum	an undertaking
suscipio	to take, catch, take up, lift up, receive
suspendo	to hang up, hang, suspend
suspicio	
suspicor	to mistrust, suspect
sustento	to hold up, hold upright, uphold, support, prop, sustain
sustineo	to hold up, hold upright, uphold, bear up, keep up, support, sustain
suum	
suus	of oneself, belonging to oneself, his own, her own, his, her, its, their
syron	
syrus	
Sabini	
Sabinum	
Sabinus	of the Sabini, Sabine
Saburra	
Sacrativirum	
Sadala	
Sallyas	
Salo	
Salona	
Salonae	
Sardinia	
Saso	
Saturninus	
Saxa	
Scaeva	
Scipio	
Scribonius	
Secundus	
Senticam	
Septimius	
Ser	
Sertorius	
Servilius	
Sicilia	
Sicoris	
Spinther	
Spintherque	
Staberius	
Statius	
Sulla	a family name in the Cornelian gens
Sulmonenses	
Sulmonensis	
Sulpicianus	
Sulpicius	
Syri	
Syria	
Syriacus	Syrian, of Syria
Syrie	
Syrius	
Syros	
Syrus	
tabella	a small board
tabernaculum	a tent
tabula	a board, plank
tabulatio	a planking, flooring, floor
tabulatum	a board-work, flooring, floor, story
tabulatus	
taeda	a resinous pine-tree, pitch-pine
taeter	offensive, repulsive, foul, noisome, shocking, loathsome
taetro	
taetrum	
talis	such, of such a kind, such like, the like
talus	an ankle, ankle-bone, pasternbone, knuckle-bone
tam	quam
tamdiu	
tamen	notwithstanding, nevertheless, for all that, however, yet, still
tametsi	notwithstanding that, although, though
tandem	at length, at last, in the end, finally
tanti	
tanto	
tantummodo	
tantundemque	
tantus	of such size, of such a measure, so great, such
tarditas	slowness, tardiness, sluggishness
tardo	to make slow, hinder, delay, retard, impede, check, stay, prevent
tardus	slow, not swift, sluggish, tardy
tectum	a covered structure, roofed enclosure, shelter, house, dwelling, abode, roof
tegimentum	
tego	to cover, cover over
tela	a web
telis	
telum	a missile weapon, missile, dart, spear, shaft, javelin
temere	by chance, by accident, at random, without design, casually, fortuitously, rashly, heedlessly, thoughtlessly, inconsiderately, indiscreetly
tempestas	a portion of time, point of time, time, season, period
templum	an open place for observation, place marked off by the augur's staff
tempus	
tendo	to stretch, make tense, stretch out, spread out, distend, extend
teneo	to hold, keep, have, grasp, hold fast
tener	soft, delicate, tender, yielding
teneri	
tento	
tenue	
tenuis	drawn out, meagre, slim, thin, lank, slender
tergeo	to rub off, wipe off, wipe dry, wipe clean, cleanse
tergum	the back
terni	three each
terra	the earth
terreo	to frighten, affright, put in fear, cause to dread, alarm, terrify, scare, dismay
terrestria	
terrestris	of the earth, on land, earth-, land-, terrestrial
terror	great fear, affright, dread, alarm, terror, panic
tertiae	
tertio	for the third time
tertius	the third
testamentum	a last will, testament, will
testimonium	witness, evidence, attestation, testimony
testis	
testudo	a tortoise
tetrarches	a ruler of the fourth part of the land, tetrarch, petty prince, regent
theatrum	a play-house, theatre
tignum	building-materials, a piece of timber, trunk of a tree, log, stick, post, beam
timeo	to fear, be afraid, be fearful, be apprehensive, be afraid of, dread, apprehend
timidus	fearful, afraid, faint-hearted, cowardly, timid
timor	fear, dread, apprehension, timidity, alarm, anxiety
tionem	
tiro	a newly levied soldier, young soldier, recruit
tolero	to bear, endure, support, sustain, suffer
toleror	
tollo	to lift, take up, raise, elevate, exalt
tormentum	an engine for hurling
torquatus	adorned with a necklace, collared
tot	so many, such a number of
totidem	just so many, just as many, the same number of
totus	all, all the, all at once, the whole, entire, total
trabs	a beam, timber, rafter
tracto	to draw violently, drag, tug, haul, pull
tractus	
traditor	a betrayer, traitor
traditus	
trado	to give up, hand over, deliver, transmit, surrender, consign
traduco	
traductor	a conveyer, transferrer
traductus	
tragula	a javelin thrown by a strap, hand-dart
traho	to draw, drag, haul, train along, draw off, pull forth, drag away
traicio	to throw across, cause to cross, cause to go across, put over, transfer, throw over, shoot across
trano	to swim over, swim across, swim through
trans	across, over, to the farther side of
transcendo	to climb over, pass over, cross, overstep, surmount
transcurro	to run over, run across, go by, pass
transduco	
transeo	perf
transfero	to bear across, bring through, carry over, convey over, transport, transfer
transgredior	to step across, step over, climb over, pass over, cross
transgressus	a passing over, passage, crossing
transmarinus	beyond sea, from over the sea, transmarine
transporto	to carry over, take across, carry, convey, remove, transport
transveho	to carry across, convey over, bear to the other side, transport
transversum	
transverto	
trans-jacio	
traversaria	
trajectus	
trepido	to hurry with alarm, be in confusion, be agitated, be disturbed
tres	three
tribunal	a raised platform for the seats of magistrates, judgment-seat, tribunal
tribunicius	of a tribune, tribunitial
tribunus	the head of a tribe
tribuo	to assign, impart, allot, bestow, confer, yield, give
tribus	a third part of the people
tributum	a stated payment, contribution, tribute
tributus	formed into tribes, marshalled by tribes
trichila	a summer-house, pavilion, bower
triduum	three days' time, three days
triplex	threefold, triple
triplico	
triremis	with three banks of oars
triticum	wheat
tu	thou, you
tuba	a trumpet, war-trumpet
tueor	to look at, gaze upon, behold, watch, view, regard, consider, examine
tulo	
tum	then, at that time, in those times
tumultus	an uproar, bustle, commotion, disturbance, disorder, tumult, panic
tumulus	a heap of earth, mound, hill, hillock
tunc	then, at that time, just then, on that occasion
tunica	an under-garment, shirt, tunic
tunico	
turba	a turmoil, hubbub, uproar, disorder, tumult, commotion, disturbance
turbidus	full of confusion, wild, confused, disordered
turbo	
turbulentus	full of commotion, disturbed, boisterous, stormy, tempestuous
turma	a troop, crowd, throng, band, body, company
turmatim	by troops, in squadrons
turpe	
turpis	ugly, unsightly, unseemly, repulsive, foul, filthy
turpiter	in an unsightly manner, repulsively
turpo	to make unsightly, soil, defile, pollute, disfigure, deform
turris	a tower
tute	safely, securely, in safety, without danger
tuto	safely, securely, in safety, without danger
tutor	
tutum	
tympanum	a drum, timbrel, tambour, tambourine
tyranna	
tyrannis	the sway of a tyrant, arbitrary power, despotic rule, tyranny
tyrannus	a monarch, sovereign, king, absolute ruler, personal governor, despot, prince
T	
Tarcondarius	
Tarracina	
Tarraco	
Tarraconensis	
Tauroenta	
Tertius	
Thebae	
Thebe	
Theophane	
Theophanes	
Thermus	
Thessali	
Thessalia	
Thessalius	
Thessalus	
Thracia	
Thracibus	
Thracius	
Thurii	
Thurini	
Thurinus	
Tiburtius	
Tillius	
Titus	
Torquatus	
Tralles	
Transpadani	
Transpadanus	beyond the Po
Trebonius	
Triarius	
Tubero	
Tullus	
Tuticanus	
uber	
ubi	Relat., in which place, in what place, where
ubique	
ullus	negation
ulter	
ulteriore	
ulteriorem	
ulteriores	
ulterioris	
ultima	
ultimi	
ultimum	finally, for the last time
ultra	
ultro	to the farther side, beyond, on the other side
umeo	to be moist, be damp, be wet
umerus	the upper arm, shoulder
umidum	
umidus	moist, humid, damp, dank, wet
umquam	at any time, ever
unde	Relat., from which place, whence
undique	from all parts, from every quarter, on all sides, all around, on every part, everywhere
universi	
universum	
universus	all together, all in one, whole, entire, collective
uno	
unus	One, a single
unusquisque	
urbanus	of the city, of the town, in the city, in Rome
urbs	a walled town, city
usura	a using, use, enjoyment
usus	use, practice, employment, exercise, enjoyment
ut	
uter	
uti	
utilitas	use, usefulness, utility, serviceableness, service, expediency, benefit, profit, advantage, welfare
uto	
utor	to use, make use of, employ, profit by, take advantage of, enjoy, serve oneself with
utribus	
utrimque	on both sides, on either hand, from each side, on the one side and on the other
utroque	to both places, on both sides, in each direction
utrum	ne
uxor	a wife, spouse, consort
Ubius	
Utica	
Uticenses	
Uticensis	
v	
vaco	to be empty, be void, be vacant, be without, not to contain
vacuo	
vacuum	
vacuus	empty, void, unoccupied, vacant, free, clear, devoid of, without
vado	to go, walk, go hastily, proceed rapidly, rush
vadosus	full of shallows, shallow, shoal
vadum	a shallow place, shallow, shoal, ford
vago	
vagor	to stroll about, go to and fro, ramble, wander, roam, range, rove
valeo	to be strong, be vigorous, have strength, be able
valetudo	habit, state of body, state of health, health
valles	a valley, vale
vallo	to fortify with a rampart, surround with palisades, intrench, circumvallate
vallum	a line of palisades, palisaded rampart, intrenchment, circumvallation
vallus	a stake, palisade
valva	
valvae	a pair of doorleaves
varia	
vario	to diversify, variegate, change
varius	variegated, party-colored, mottled, diverse, various
varo	
varus	bent, turned awry, crooked
vasum	
vectigal	a payment to the state, revenue, toll, tax, impost, excise, duty, tribute
vectigalis	of imposts, of taxes
vectis	a strong pole, bar, lever
vectura	a bearing, carriage, conveyance, transportation
vehemens	eager, violent, furious, impetuous, ardent, vehement
vehementer	eagerly, impetuously, ardently, violently, earnestly, vehemently
veho	to bear, carry, convey, draw
vel	
vello	to pluck, pull, tear away, pull out
venio	to come
vento	
ventus	wind
verbum	a word
vereor	to reverence, revere, respect, stand in awe
vergo	to bend, turn, be inclined, lie, be situated
vernacula	
vernaculus	of home-born slaves
vero	in truth, in fact, certainly, truly, to be sure, surely, assuredly
verro	to sweep, brush, scour, sweep out, sweep together
verso	to turn often, keep turning, handle, whirl about, turn over
versor	
versus	
verto	to turn, turn up, turn back, direct
verum	
verus	true, real, actual, genuine
vesperus	
vespillo	
vester	your, yours, of you
vestigium	the bottom of the foot, sole
vestis	collect., a covering for the body, clothes, clothing, attire, vesture
vetera	
veteranus	old, veteran
veteres	
vetero	
veto	not to suffer, not to permit, to oppose, forbid, prohibit
vetus	old, aged, advanced in years
vetustas	old age, age, long existence
vexillum	a military ensign, standard, banner, flag
via	a way, highway, road, path, street
vibo	
vicis	change, interchange, alternation, succession, vicissitude
victor	a conqueror, vanquisher, victor
victoria	victory
victus	that which sustains life, means of living, sustenance, nourishment, provisions, victuals
vicus	a row of houses, street, quarter, ward
video	to see, discern, perceive
vigil	awake, on the watch, alert
vigilia	a watching, wakefulness, sleeplessness, lying awake
vii	
viii	
viiii	
vimen	a pliant twig, switch, withe, osier
vimineus	made of osiers, of wicker-work
vincio	to bind, bind about, fetter, tie, fasten, surround, encircle
vinco	to conquer, overcome, get the better of, defeat, subdue, vanquish, be victorious
vindico	to assert a claim to, demand formally, ask judgment for
vinea	a plantation of vines, vine-garden, vineyard
vineus	
vio	
violatus	
violo	to treat with violence, injure, dishonor, outrage, violate
vir	a male person, adult male, man
vira	
vireo	to be green, be verdant
virgo	a maid, maiden, virgin
virtus	manliness, manhood, strength, vigor, bravery, courage, excellence
virus	a potent juice, medicinal liquid, poison, venom, virus
vis	strength, force, vigor, power, energy, virtue
visium	
viso	to look at attentively, view, behold, survey
visum	a thing seen, sight, appearance, vision
visus	a looking, look, act of seeing, power of sight, vision
vita	life
vitio	to make faulty, injure, spoil, mar, taint, corrupt, infect, vitiate, defile
vitis	a vine, grape-vine
vitium	a fault, defect, blemish, imperfection, vice
vito	to shun, seek to escape, avoid, evade
vivo	to live, be alive, have life
vivum	
vivus	alive, living, having life
vix	with difficulty, with much ado, hardly, scarcely, barely
vocabulum	an appellation, designation, name
vocatus	a calling, call, summons, invocation
voco	to call, summon, invoke, call together, convoke
volo	a volunteer
voluntarii	
voluntarius	willing, of freewill, voluntary, self-constituted
voluntas	will, free-will, wish, choice, desire, inclination
voluptas	satisfaction, enjoyment, pleasure, delight
volvo	to cause to revolve, roll, turn about, turn round
votum	a promise to a god, solemn pledge, religious engagement, vow
voveo	to vow, promise solemnly, engage religiously, pledge, devote, dedicate, consecrate
vox	a voice, sound, tone, utterance, cry, call
vulgo	
vulgus	
vulnerarius	
vulnero	
vulnus	
vultus	
vus	
V	
Valerius	
Varius	
Varro	
Varus	
Vatinius	
Vectones	
Vibius	
Vibo	
Vibullius	
Volcacius	
Volcae	
Volusenus	
x	
xii	
xiii	
xiiii	
xis	
xl	
xlv	
xv	
xvi	
xvii	
xviii	
xx	
xxii	
xxiiii	
xxiv	
xxvii	
xxx	
xxxii	
xxxiii	
xxxv	
jaceo	
jacio	
jacto	
jactura	
jactus	
jam	
juba	
jubeo	
jucundus	
judex	
judicium	
judico	
jugerum	
jugis	
jugo	
jugum	
jugus	
jumentum	
junctus	
jungo	
jurandum	
jurejuro	
juro	
juror	
jus	
jussum	
jussus	
justa	
justitia	
justitium	
justum	
justus	
juventus	
juvo	
juxta	
Jacetani	
Januarius	
Juba	
Julius	
