a	from, away from, out of
ab	
ab-do	
abdomen	the belly, abdomen
ab-duco	
abduco	to lead away, take away, carry off, remove, lead aside
abeo	to go from, go away, go off, go forth, go, depart
abhinc	ago, since, before now
abhorreo	to shrink back from, have an aversion for, shudder at, abhor
abidum	
abiga	
abigo	to drive away, drive off
abiicienda	
abitio	a departure
abito	
abitus	a departure, removal
ablego	to send off, send out of the way, banish, send into exile
ab-ligurio	
aborior	
abortum	
abortus	an untimely birth
abrado	to scrape away, shave off
abripio	to take forcibly away, snatch away, tear from, force off
abscedo	to give way, go off, move away, retire, withdraw, depart
absento	
absolvo	to set free, release, discharge
abstergeo	to wipe off, cleanse by wiping
absterreo	to frighten off, drive away
abstineo	to keep back, keep off, hold back
abstraho	
abstulo	
absum	to be away from, be absent
absumo	to take away, diminish, use up, consume, exhaust
absumsit	
absurdus	out of tune, discordant, harsh
abundo	to overflow, stream over
abundus	
abusus	an abusing, using up
abutor	
accedo	sync
accepta	
accepto	to take, receive
acceptum	the receipt
accido	
accingo	to gird to, gird on, bind on, put on with a girdle, gird round
accipio	to take without effort, receive, get, accept
accipitri	
accresco	to grow progressively, increase, become greater
accubo	to lie at, lie beside
accumbo	to lay oneself down, lie beside
accuro	to give close attention to, be careful
accurro	to run to, hasten to
accuso	to call to account, make complaint against, reproach, blame, accuse
acer	
acerbo	to aggravate, make worse
acerbum	
acerbus	harsh, bitter, unripe
aciutaret	
acleo	
acquum	
acta	the sea-shore, sea-beach
acte	
actor	a driver
actum	a deed, transaction, proposition, decree, law
actus	a driving, impulse, setting in motion
actutum	immediately, forthwith
acuo	to sharpen, whet, point, make sharp
ad	to, toward
adaucto	
adaugeo	to increase by adding, augment
adbibo	to take in by drinking
ad-curro	
addo	to put to, place upon, lay on, join, attach
adduco	to lead to, bring to, bring along
adduxti	
ad-emo	
a-demo	
ademtam	
adeo	
ad-eximo	
adhibeo	to hold toward, turn to, apply, add to
adhortor	to encourage, exhort, stimulate, rouse, urge
adhuc	
adicio	to throw to, cast to, fling at, put, put to, set near
adigo	to drive, urge, bring by force, take
adimo	to take away, take from, deprive of
adipiscar	
adipiscier	
adito	
adiurit	
administro	to manage, control, guide, superintend, execute, regulate, rule, direct
admiror	to regard with wonder, admire
admisceo	
admissum	a voluntary fault, trespass, crime
admitto	to send to, let go, let loose, let come, admit, give access
admodum	to the proper limit, to full measure
admoneo	to bring to mind, remind, suggest, put in mind of
admoveo	
adnato	to swim up
adolescents	
adolesco	to burn, blaze up, flame
adopto	to take by choice, select, choose, adopt
ador	a grain, spelt
adorio	
adorior	to approach as an enemy, fall upon, assail, assault, attack
adorno	to provide, furnish, fit out, equip, make ready
ad-posco	
adscendit	
ad-simulo	
ad-specio	
ad-specto	
adsum	to be at, be present, be at hand
ad-teneo	
ad-tineo	
adulescens	growing, near maturity, young, youthful
adulescentia	youth
adulescentula	a young maiden, little girl
adulescentulus	a very young man
aduncus	bent inwards, hooked
aduro	to set on fire, kindle, scorch, parch, burn, singe
adusta	
advecto	to keep bringing, import continually
advectus	a bringing hither
adveho	
advena	a stranger, foreigner, immigrant
advenio	to come to, reach, arrive at
adventus	a coming, approach, arrival
adverro	
adversa	
adversaria	
adversaries	
adversarius	opposite, hostile, contrary
adversatrix	an opponent
ad-verso	
adverso	
adversor	to resist, withstand, oppose
adversum	misfortune, calamity, disaster
adversus	an enemy, opponent
adverto	to turn to, turn towards, direct
ad-verto	
advesperascit	it approaches evening, is twilight
advigilo	to watch, be watchful
advocatus	one called to aid
advoco	to call, summon, invite
adjicio	
adjumentum	
adjungo	
adjuro	
adjuto	
adjutor	
adjutrix	
adjuvo	
aedes	
aedicula	a small temple, chapel, niche
aedilis	a commissioner of buildings, aedile, magistrate for public works
aedium	
aeger	unwell, ill, sick, diseased, suffering, feeble
aegreo	
aegritudo	sickness, grief, affliction, melancholy
aegrotus	sick, diseased
aegrum	
aemulo	
aemulor	to rival, vie with, emulate, strive to excel
aemulus	striving earnestly after, emulating, rivalling, vying with, emulous
a-eo	
aequalis	equal, like, even, on a par
aequanimitas	good-will, kindness
aeque	equally, in like manner, just as, in an equal degree, to the same extent
aequo	to make equal, equalize
aequum	a plain, level
aequus	even, plain, level, flat
aer	the air, atmosphere, sky
aero	
aerumna	toil, hardship, distress, trouble, tribulation
aetas	the life of man, age, lifetime, years
aeternus	of an age, lasting, enduring, permanent, endless
affabilis	
affecto	
affectus	
affero	
afficio	
affinis	
affinitas	
afflicto	
affor	
again	
agedum	
agellus	a small estate, little field
ager	productive land, a field, farm, estate, arable land, pasture
aggravesco	to increase in weight, grow violent
aggredio	
aggredior	to approach
agito	to set in violent motion, drive onward, move, impel, urge
agmen	that which is driven
ago	to put in motion, move, lead, drive, tend, conduct
agrestis	
agrius	
ah	ah! alas!
ai	alas
ainant	
ainbobus	
aio	to say yes, assent, affirm
ala	a wing
alacer	lively, brisk, quick, eager, excited, glad, happy
alia	
alias	at another time, some other time, at other times
alibi	elsewhere, somewhere else, at another place
alicubi	at any place, somewhere, anywhere
alicunde	from somewhere, from any place
alieno	to make strange, make another's, transfer, make over, part with
alienum	the property of a stranger, another's possessions
alienus	
alimentum	nourishment, nutriment, aliment
alio	to another place, to another, elsewhere
aliorsum	in another direction, in another manner, in a different sense
aliqua	by any way, in any direction, any whither
aliquantisper	for a moderate period, a while, for a time, for some time
aliquantulus	
aliquantum	
aliquantus	some, considerable, moderate
aliqui	some, any
aliquis	any end
aliquo	to some place, somewhere, anywhither
aliquot	some, several, a few, not many, a number
aliter	in another manner, otherwise, in any other way, differently
aliunde	from another, from another source, from elsewhere
alius	another, other, different
allegati	
allegatus	
allego	
alligo	
allium	
alloquium	
alloquor	
alludo	
alo	to feed, nourish, support, sustain, maintain
alserit	
alter	one, another, the one, the other
alterco	to wrangle
altercor	to alternate in discussion, dispute, wrangle
alto	
amarus	bitter, pungent
amator	a lover, friend
ambages	a going around, roundabout way
ambago	
amb-eo	
ambigo	to go about, go around, avoid
ambiguum	
ambiguus	going two ways, wavering, uncertain
ambo	both
ambobus	
ambulo	to walk, walk about, take a walk
amens	out of one's senses, mad, frantic, distracted
amentia	want of reason, madness, senselessness
ames	a fork for spreading nets
amica	a female friend
amice	in a friendly manner
amicitia	friendship
amico	
amicus	
amisti	
amitto	to send away, dismiss, part with
amo	to love
amolior	to remove, move away
amor	love, affection, strong friendly feeling
amoveo	to move away, take away, remove
amplector	to twine around, encircle, encompass, embrace
amplexor	to embrace
amplio	to widen, extend, increase, enlarge, amplify
amplus	of large extent, great, ample, spacious, roomy
amrbarum	
an	or
ancilla	a maid-servant, handmaid
ancillula	a young female slave, handmaid
angiportum	
angiportus	
ango	to draw close, press tight, squeeze, compress, throttle, choke
anguis	a serpent, snake
angulus	an angle, corner
angustum	a narrow place
angustus	narrow, strait, contracted
anhelo	to breathe with difficulty, gasp, pant, puff
anicula	a little old woman, granny
anima	air, a current of air, breeze, breath, wind
animadverto	to direct the mind, give attention to, attend to, consider, regard, observe
animo	
animuin	
animus	the rational soul
anne	
anno	
annona	the year's produce
annumero	
annuo	
annus	a year
annuum	
annuus	of a year, lasting a year
ante	before, in front, forwards
antea	before, earlier, formerly, aforetime, previously
antecedo	to go before, get the start, precede
anteco	
antehac	of time, before this time, before now, formerly, hitherto
antehae	
antevenio	to come before, get the start of, anticipate
anteverto	to take a place before, go before, precede
antiqui	
antiquo	to reject, not to pass
antiquum	
antiquus	ancient, former, of old times
anuis	
anulus	a ring, finger-ring, seal-ring, signet-ring
anus	
apage^	
apage	away with thee! begone! away! off with!
aperio	to uncover, lay bare
apertus	without covering, uncovered
apo	
appareo	to appear, come in sight, make an appearance
appario	
appellassis	
appello	
applicasse	
applico	to join, connect, attach, add
applumbo	
appono	to put at, place by, lay beside, set near
apporto	to carry, convey, bring along
apprehendo	to seize, take hold of
apprime	first of all, in the highest degree, chiefly
apprimo	to press close
apprimus	
approbo	to assent to, favor, approve
appropero	to hasten, accelerate
aptus	fastened, joined, fitted, bound, attached
apud	
aqua	water
aquila	an eagle
aquilus	
ara	a structure for sacrifice, altar
arbiter	a spectator, beholder, hearer, eye-witness, witness
arbitrarius	
arbitrium	a judgment, decision of an arbitrator
arbitror	to testify on information and belief, depose to one's best knowledge
arceo	to shut up, enclose
arcessitus	a calling for, summons
arcesso	to cause to come, call, send for, invite, summon, fetch
ardeo	to be on fire, burn, blaze, be burned
argentaria	
argentarius	of money
argentum	silver
argenturm	
argumentum	an argument, evidence, ground, support, proof
aridum	
aridus	dry, arid, parched
aris	
arma	implements, outfit, instruments, tools
armus	the shoulder
aro	to plough, till
aron	
arrepo	
arrhabo	
arrideo	
arripio	
ars	practical skill
articulo	
articulus	a joint, knuckle
artifex	a master of an art, professional man, artist, artificer
artio	
artius	
arto	to contract, straiten
artum	
artus	
arx	a castle, citadel, fortress, stronghold
ascendo	to mount, climb, ascend, scale, go up
asia	
asinus	an ass
asper	without hope, adverse, calamitous, troublesome, cruel, perilous
aspernor	to disdain, reject, despise
asperum	
aspicio	to look at, look upon, behold, look
asporto	to carry away, carry off, transport, remove
assentor	
assequor	
assero	
asservo	
assideo	
assiduus	
assimulo	
assisto	
assitus	
asso	
assoleo	
assolo	
asto	to stand at, take place near
astringo	to bind on, tie fast, fasten to, bind up
astus	adroitness, craft, cunning
astutia	adroitness, shrewdness, craft, cunning
astutus	wary, shrewd, sagacious, expert
asymbolus	
at	but, but on the other hand, but meanwhile
atat	
atavus	a grandfather's grandfather
ater	black, coal-black, gloomy, dark
atque	and, as well as, together with
atqui	but somehow, but in any wise, but yet, however, and yet, and nevertheless
atrox	savage, fierce, wild, cruel, harsh, severe
atrurn	
attamen	but nevertheless
attemperate	opportunely, in the nick of time
attempero	
attendo	to stretch toward, direct
attigo	
attineo	to hold fast, detain, delay
attingo	to touch, come in contact with
attollo	to lift up, raise up, raise, elevate
attulo	
au	Oh!
aucto	to increase much, prosper
auctor	a promoter, producer, father, progenitor
auctoritas	origination, production
auctoro	to bind, oblige
auctus	
aucupium	bird-catching, fowling
audacia	daring, courage, valor, bravery, boldness, intrepidity
audacter	boldly, courageously
audax	daring, bold, courageously, spirited
audeo	to venture, dare, be bold, dare to do, risk
audio	to hear
auditus	the hearing, sense of hearing
aufero	to take away, bear off, carry off, withdraw, remove
aufugio	to flee away, run away, escape
augeo	to increase, augment, enlarge, spread, extend
augesco	to grow, increase
aureus	of gold, golden
auris	the ear
auro	
aurum	gold
auscultanldi	
ausculto	to hear with attention, listen to, give ear to
auspico	
auspicor	to take the auspices
ausum	a bold deed, reckless act
ausus	
aut	or
autem	but, on the other hand, on the contrary, however
auteni	
autor	
autumo	to say aye, assert, aver, affirm, say
auxilia	
auxilio	
auxilior	to give help, aid, assist, succor
auxilitum	
auxilium	help, aid, assistance, support, succor
avaritia	inordinate desire, greed, avarice, covetousness
avarus	eagerly desirous, grasping
aveho	to carry off, take away
avello	to tear away, rend off, pluck, snatch away
avidus	longing eagerly, desirous, eager, greedy
avus	a grandfather
Aba	
Abii	
Acte	
Actor	
Adduxtin	
Adelphi	The Brothers
Ademtum	
Adesdum	
ADELPHI	
Aequi	
Aeschines	
Aeschino	
Aeschinus	
Aesculapius	
Aethiopia	
AED	
AEDILIB	
AEMILII	
AESCHINUS	
AFRICANUS	
Alii	
Alius	
Allia	
ALBINO	
Amisum	
Amisus	
AMBIVIUS	
Andria	
Andrius	
Andros	
Annius	
Antiphila	
Antipho	
Antiphone	
Antiphonem	
Antiphoni	
Antiphonine	
ANDRIA	
ANICIO	
ANTIPHILA	
ANTIPHO	
Apollo	Apollo
APOLLODORU	
Aquila	
Archidemidem	
Archonidi	
Archylis	
Arrige	
Asia	
Asius	
Athenae	Athens
Attamen	
Attica	
Attice	
Attici	
Atticus	Athenian, Attic
ATILIUS	
ATTILIUS	
balnea	
balneae	
balneum	
beatus	happy, prosperous, blessed, fortunate
bellum	war
bellus	pretty, handsome, neat, pleasant, fine, agreeable
belua	a beast, wild beast, monster
beluus	
bene	
benedico	
benedictum	
benedictus	
beneficium	a favor, benefit, service, kindness
beneficus	generous, liberal, serviceable, beneficent, bountiful
benevolens	friendly, kind
benevolentia	good-will, benevolence, kindness, favor, friendship
benevolus	well-wishing, kind, bountiful, friendly
benignitas	kindness, friendliness, courtesy, benevolence, benignity
benignus	kind, good, friendly, pleasing, favorable, benignant
benus	
beo	to make happy, gladden, bless
bibo	to drink
biduus	
biennis	
biennium	a period of two years, two years
bini	two by two, two to each, two each, two at a time
bis	twice, at two times, on two occasions
blandio	
blandior	to fawn, soothe, caress, fondle, coax
blanditia	a caressing, fondness, flattering, flattery
blandus	of smooth tongue, flattering, fawning, caressing
bolus	a throw
bonae	
bone	
bonitas	goodness, excellence
bonum	
bonus	good
breve	
brevi	in a little while, in a short time, soon
brevis	short
bruma	the shortest day
Babylo	a Babylonian
Baccha	a Bacchante
Bacchis	
Bacchus	the son of Jupiter and Semele, the god of wine, of intoxication and inspiration
BACCHIS	
BUS	
By	
Byrrhia	
Byrrhiam	
BYRRHIA	
ca	
cadaverosus	like a corpse, ghastly, cadaverous
cado	to fall, fall down, descend
caecimus	
caedo	to cut, hew, cut down, fell, cut off, cut to pieces
caelum	the sky, heaven, heavens, vault of heaven
caenum	dirt, filth, mud, mire
caesius	cutting, sharp
caesum	
caesus	
caeterus	
calamitas	loss, injury, damage, mischief, harm, misfortune, calamity, disaster
calamites	
calceo	to furnish with shoes, put on shoes, shoe
calcis	
calco	to tread, tread upon, trample
calesco	to grow warm, be heated
calidum	
calidus	warm, hot
calleo	to be callous
calliditas	shrewdness, skill, readiness, aptness
callidus	practised, shrewd, expert, experienced, adroit, skilful, ingenious, prudent, dexterous
camus	a curb
caneo	to be gray, be hoary
cani	
canis	a dog
cano	to utter melodious notes, make music, sing, sound, play
cantilena	a hackneyed song, old song
cantito	to sing often
canto	to produce melodious sounds, sound, sing, play
canus	white, hoary
capero	
capillum	
capillus	collect., the hair of the head, hair
capio	to take in hand, take hold of, lay hold of, take, seize, grasp
capitalis	of the head, chief, foremost, pre - eminent, distinguished
capitium	
capitulum	a little head, darling, pet
capitum	
caprificus	the wild figtree
capto	to strive to seize, lay hold of, catch at, snatch, chase, hunt, capture
captus	
capus	
caput	the head
carbo	a coal, charcoal
career	
careo	P. praes. gen. plur
careum	
carnifex	an executioner, hangman
carnufex	
caro	flesh
caros	
carpo	to pick, pluck, pluck off, cull, crop, gather
carus	dear, precious, valued, esteemed, beloved
casa	a small house, cottage, hut, cabin, shed
castigo	to set right, correct, chastise, punish, blame, reprove, chide, censure, find fault with
catus	clear - sighted, intelligent, sagacious, wise
caudex	a trunk of a tree, stock, stem
causa	a cause, reason, motive, inducement, occasion, opportunity
cautim	cautiously, warily
cautio	wariness, precaution, caution, heedfulness, circumspection
cavebo	
caveo	to be on one's guard, take care, take heed, beware, guard against, avoid
cavo	to make hollow, hollow out, excavate
cavum	
cavus	hollow, excavated, concave
ce	here, there
cecses	
cedo	
celata	
celatum	
celere	
cella	a place of concealment, store-room, cell, granary
cellula	a small store-room
celo	to hide from, keep ignorant of, conceal from
censeo	to tax, assess, rate, estimate
censum	
census	a registering of citizens and property by the censors, census, appraisement
centiens	a hundred times
centurio	
cerebrum	the brain
cerno	to separate, part, sift
cero	
certatio	a competition, contest, strife, rivalry
certioro	
certo	
certor	
certus	determined, resolved, fixed, settled, purposed, certain
cerva	a hind
cervix	a head-joint, neck, nape
cesso	to be remiss, delay, loiter, cease from, stop, give over
cetarius	of sea - fish
ceter	
ceterum	for the rest, in other respects, else, otherwise
ceterus	the other, remainder, rest
chordus	
chrysos	
cibus	food, victuals, nutriment, fodder
cicatrix	a scar, cicatrice
cicenda	
cichorium	
cieo	to cause to go, move, stir, drive
circos	
circuitio	
circum	around, round about, all around
circumcurso	to run around, run about
circumeo	to go around, travel around, march around
circumspecto	to look about with attention, search around, look after
circumspexti	
circumspicio	to look about, cast a look around, observe, see
circumvallo	to surround with a wall, circumvallate, blockade, invest, encompass
circumvenio	to come around, be around, encircle, encompass, surround
circus	a circular line, circle
cistella	a small chest, box
citharistria	a female player on the cithara
cito	to put in quick motion, rouse, excite
civis	a citizen
civitas	the condition of a citizen, citizenship, freedom of the city, membership in the community
clam	secretly, privately, covertly, in secret
clamito	to cry aloud, bawl, vociferate
clamo	to call, cry out, shout aloud, complain aloud
clamor	a loud call, shout, cry
clanas	
clanculum	secretly, privately
clareo	to be bright, shine
claro	to make bright, exhibit
clarus	clear, bright, shining, brilliant
clatum	
claudo	to limp
clemens	mild, calm, gentle
clementia	moderation, mildness, forbearance, benignity, clemency, mercy
cliens	a personal dependant, client
clientela	clientship, patronage, protection, the relation of a client to his patron
clivus	a declivity, slope, ascent, hill, eminence
clomi	
coacto	
coactum	
coactus	compulsion, constraint
coemo	
coena	
coenae	
coenam	
coenon	
coeo	
coepio	to begin, commence
coepto	to begin eagerly, begin, undertake, attempt
cogitata	
cogitatum	a thought, reflection, notion, idea
cogitatus	deliberate
cogito	to consider thoroughly, ponder, weigh, reflect upon, think
cognata	a female relation, kinswoman
cognatus	
cognitio	a becoming acquainted with, acquiring knowledge, knowledge, acquaintance
cognosco	to become acquainted with, acquire knowledge of, ascertain, learn, perceive, understand ; perf., to know
cogo	to drive together, collect, crowd, bring together, summon, congregate, convene
cohaereo	to cling together, be united, cohere
cohibeo	to hold together, hold, contain, confine, embrace, comprise
coitio	a coming together, meeting
colaphus	a blow with the fist, cuff, box on the ear
collacrumabat	
collaudo	
collibet	
colligo	
colloco	
colloquium	
colloquor	
colo	to till, tend, care for, cultivate
color	color, hue, tint
columen	a pillar, column
co-medeor	
comes	a compan
comis	courteous, affable, kind, obliging, friendly, loving
comissator	a reveller, rioter
comiter	courteously, affably, kindly
comito	to accompany, attend, follow
comitor	to join as an attendant, accompany, attend, follow
commeat	
commemoratio	a reminding, commemorating, remembrance, mentioning
commemoro	to recall to memory, call to mind, be mindful of, keep in mind, remember
commendo	to commit for protection, intrust, confide, deposit with
commento	
commentum	an invention, fabrication, pretence, fiction, falsehood
commentus	devised, invented, feigned, fictitious
commeo	to go and come, pass to and fro, move back and forth, go about
commereo	to merit fully, deserve, incur, earn
commeto	to visit habitually
commigro	to remove, migrate, enter
comminiscar	
comminiscentur	
comminiscere	
commiseresco	
commissum	an undertaking, enterprise
commitigo	to make soft, mellow
committo	
commode	duly, properly, completely, rightly, well, skilfully, neatly
commoditas	fitness, convenience, a fit occasion, advantage, benefit
commodo	to serve with, accommodate, grant, supply, lend
commodum	
commodus	with due measure, full, complete, of full weight
commoneo	to remind, put in mind, impress upon, bring to recollection
commonstro	
commorior	
commoro	
commoror	to tarry, linger, abide, sojourn, remain, stay
commotus	moved, excited, aroused
commoveo	To put in violent motion, move, shake, stir
commuissurum	
commune	that which is common
communicatus	
communico	to divide with, communicate, impart, share
communio	a community, mutual participation, fellowship
communis	common, general, universal, public
commuto	to alter wholly, change entirely
como	to comb, arrange, braid, dress
comoedia	a comedy
comparatus	
compareo	to be evident, appear, be plain, be visible
comparo	
comparsit	
compedes	
comperio	to obtain knowledge of, find out, ascertain, learn
complector	to clasp, embrace, grasp
complura	
complures	more than one, not a few, several, a number, many
complusculos	
compono	to bring together, place together, collect, unite, join, connect, aggregate
compos	master of, powerful over, possessing, participating in
compositum	an agreement, compact
compositus	well - ordered, orderly, regular
compotrix	a drinking-companion
comprecor	to pray to, supplicate, implore
comprehendo	to bind together, unite
compresso	
compressus	a compression
comprimo	to press together, bring together, compress, close
comprobo	to approve, assent to, sanction, acknowledge
conatus	an attempt, effort, undertaking, enterprise, endeavor
concaleo	
concalesco	to grow hot, glow
concedo	to go away, pass, give way, depart, retire, withdraw, remove
concerto	to contend warmly
concertor	
concieo	
concilio	to bring together, unite, reconcile, make friendly, win over, conciliate
concivis	
conclamo	to cry out together, shout, make acclaim
conclave	a room, chamber, suite, apartment
concludo	to shut up, close, imprison, enclose, confine
conclusus	
concordo	to agree, be united, be of one mind, harmonize
concrepo	
concubo	
concumbo	to lie together, lie with, cohabit
concurro	to run together, assemble, flock together
concutio	to strike together
condecoro	to grace, applaud, honor
condicio	an agreement, stipulation, condition, compact, proposition, terms, demand
conditio	a preserving
condono	to give, present, deliver, surrender, abandon
conduco	to draw together, assemble, collect, gather, unite
conductus	hirelings
conduplico	to double
confabulatus	
confabulor	to converse, have a talk
confacio	
confero	To bring together, collect, gather, unite, join
conficio	to make ready, make, prepare, bring about, complete, accomplish, execute, consummate, fulfil
confictus	
confidenter	boldly, daringly, with intrepidity
confidentiam	
confido	to trust, confide, rely upon, believe, be assured
confingo	to fashion, fabricate, invent, devise, feign, pretend
confiteor	to acknowledge, confess, own, avow, concede, allow, grant
conflator	
conflicto	to come in conflict, collide
conflo	to blow up, kindle, light
confuga	
confugio	to flee, take refuge, run for succor
confuto	to check, repress, dampen, suppress, diminish
congero	to bring together, collect, heap up, throw together
conglutino	to join together, unite, cement
congredior	to come together, meet, have an interview
congruo	to coincide, agree
conicio	To throw together, unite, collect
coniicere	
coniicerm	
coniicias	
coniicio	
coniicito	
con-locupleto	
con-loquor	
con-memini	
conor	to undertake, endeavor, attempt, try, venture, seek, aim, make an effort, begin, make trial of
con-placeo	
con-placito	
conplures	
conqueror	to complain, bewail, lament, deplore
con-rado	
conscidit	
conscio	to be conscious, feel guilty
conscissa	
conscius	knowing in common, conscious with, privy, participant, accessory, witnessing
consector	to follow eagerly, attend continually, go after
consequor	to follow, follow up, press upon, go after, attend, accompany, pursue
con-sequor	
consequus	
conserva	a (female) fellow slave
conservo	to retain, keep safe, maintain, preserve, spare
conservus	a fellow-slave
considero	to look at closely, regard attentively, inspect, examine, survey
consido	to sit down, take seats, be seated, settle
consilior	to take counsel, consult
consilium	a council, body of counsellors, deliberative assembly
consimilia	
consimilis	entirely similar, very like
consimilo	
consisto	to stand still, stand, halt, stop, take a stand, post oneself
consobrinus	a mother's sister's son, cousin-german, first cousin
consolo	
consolor	to encourage, animate, console, cheer, comfort
conspectus	
conspicio	to look at attentively, get sight of, descry, perceive, observe, fix eyes upon
conspicor	to get sight of, descry, see, perceive
constabilio	to confirm, establish, make firm
constituo	to put, place, set, station
constitutum	an agreement, appointment, compact
consto	to agree, accord, be consistent, correspond, fit
constringo	to bind, fetter, shackle, chain
consuefacio	to accustom, inure, habituate
con-suesco	
consuesset	
consuetudo	a custom, habit, use, usage, way, practice, familiarity, experience, tradition, precedent
consul	a consul
consulo	to meet and consider, reflect, deliberate, take counsel, consult, take care, have regard, look out, be mindful
consultatio	a mature deliberation, consideration, consultation
consultum	deliberation, consideration
consultus	well considered, weighed, deliberated upon, maturely pondered
consum	
consumo	to use up, eat, devour
consumunmt	
consusurro	to whisper together
contamino	to bring into contact, mingle, blend, unite
contego	to cover, roof, bury
contemno	
contemplatus	a consideration, contemplation
contemplo	
contemplor	to gaze at, view attentively, survey, behold, observe, contemplate
contemptor	he who disregards, a contemner, despiser
contemptus	
contemserim	
contemsisse	
contendo	to stretch, bend, draw tight, strain
contero	to grind, bruise, pound, wear out
contexo	to weave, entwine, join, bind
continentia	a restraint, abstemiousness, continence, temperance, moderation
contineo	to hold together, bound, limit, comprise, enclose, surround, environ
contingo	to touch, reach, take hold of, seize
continuo	
continuus	joining, connecting, uninterrupted, continuous, unbroken
contortor	a wrester, perverter
contra	in opposition, opposite, face to face, in front, on the other side
controversia	a contention, quarrel, question, dispute, controversy, debate
contumelia	insult, abuse, affront, reproach, invective, contumely
contumeliosus	full of abuse, reproachful, abusive, insulting
contunielias	
conturbo	to confuse, disturb, derange, disorder, confound
convaso	to pack together, pack up
convena	
convenae	assembled strangers, refugees, vagabonds
convenio	to come together, meet, assemble, gather, come in a body
conventus	a meeting, assembly, throng
converto	to turn round, cause to turn, turn back, reverse, direct
convicium	a loud noise, cry, clamor, outcry
convinco	to overcome, convict, refute, expose
conviva	a table companion, guest
convivium	a meal in company, social feast, entertainment, banquet
convivo	
convivor	to banquet, revel, carouse together
convolo	to fly together, come hastily together, run together
conjecto	
conjectura	
conjectus	
conjugium	
conjuratio	
copia	an abundance, ample supply, plenty
copis	a short, curved sword, yataghan
coquo	to cook, prepare by cooking, bake, boil, roast, parch, steep, melt, heat
coquus	a cook
cor	the heart
cora	
coram	in the presence, before the eyes, in the face, openly, face to face
cornu	a horn, antler
cornus	a cornel cherry-tree
corpus	a body
corrado	to scrape together, rake up
corrector	an amender, improver, reformer
corrigo	to make straight, set right, bring into order
corripio	to seize, snatch up, grasp, collect, take hold of, arrest
corrumpo	to destroy, ruin, waste
corrupta	
corruptela	a corrupting, corruption, seduction, bribery
corruptus	spoiled, marred, corrupted, bad
cottidianus	of every day, daily
cram	
cras	to-morrow
crassus	solid, thick, fat, gross, stout
creber	thick, close, pressed together, frequent, numerous, repeated
crebro	in quick succession, repeatedly, often, frequently, many times
credibilis	to be believed, worthy of belief, likely, credible
credito	
credits	
creditum	a loan
credo	to give as a loan, lend, make a loan
creo	to bring forth, produce, make, create, beget, give origin to
crepo	To rattle, crack, creak, rustle, clatter, tinkle, jingle, chink
cresco	to come into being, spring up
crimen	a judgment, charge, accusation, reproach
crimino	
criminor	to accuse of crime, complain of, impeach, calumniate
crispus	having curled hair, curly-headed
cruciatus	torture, torment, a torturing, execution
crucio	to put to the rack
crux	a gallows, frame, tree
csse	
cubiculum	a room for reclining, sleeping - chamber, bedchamber
cubo	to lie down, recline
cudo	to strike, beat, pound, knock
cuia	
cuipiam	
culpa	a fault, error, blame, guilt, failure, defect
culpo	to reproach, blame, censure, reprove, disapprove, condemn
cum	
cummaxime	
cumque	whenever, always
cuni	
cupa	a cask, tun, barrel
cupediarii	
cupiditas	a longing, desire, passion, eagerness
cupidus	longing, desiring, desirous, eager, zealous, wishing, loving, fond
cupio	to long for, desire, wish
cur	why? wherefore? for what reason?
cura	trouble, care, attention, pains, industry, diligence, exertion
curatura	care, treatment
curiosus	bestowing care, painstaking, careful, diligent, thoughtful, devoted, attentive
curo	to care for, take pains with, be solicitous for, look to, attend to, regard
curriculum	a small car, chariot, racing car
curro	to run, move quickly, hasten
cursito	to run about, run hither and thither
curso	to run hither and thither, run constantly
cursus	a running, course, way, march, passage, voyage, journey
curulis	of a chariot
custos	a guard, watch, preserver, keeper, overseer, protector, defender, attendant
cujus	
cyathus	a cup, drinking-cup, glass
cyprus	
C	
Caecilius	
Callidemides	
Canthara	
Capitium	
Caria	
CAESARE	
CANTHARA	
Cedodum	
Censco	
Ceres	the daughter of Saturn, goddess of agriculture
Cetarius	
Chaerea	
Chaereas	
Charine	
Charini	
Charinum	
Chreme	
Chremem	
Chremes	
Chremetem	
Chremeti	
Chremetis	
Chremi	
Chrene	
Chrysa	
Chrysas	
Chryse	
Chryses	
Chrysis	
CHAEREA	
CHARINUS	
CHIREMES	
CHREMES	
Cilicia	
Cilicius	
Clemens	
Clinia	
Clinias	
Clitipho	
Clitiphonis	
CLAUDII	
CLINIA	
CLINTA	
CLITIPHO	
CN	
Coenam	
Colax	
Commissatum	
Commodius	
Commodus	
Congrum	
Corinthia	
Corinthius	of Corinth, Corinthian
Corinthus	Corinth
Cos	
CORNELIO	
CORNELIUS	
COSS	
Crasredi	
Cratinus	
Crito	
CRATINUS	
CRITO	
Ctesipho	
Ctesiphonem	
Ctesiphoni	
CTESIPHO	
CURULIB	
Cyprus	
da	
damno	to adjudge guilty, condemn, convict
damnosus	injurious, destructive, pernicious
damnum	hurt, harm, damage, injury, loss
data	
datume	
datus	
de	from, away from, down from, out of
dea	a goddess
deambulatio	a walking abroad, promenading
deambulo	to walk abroad, take a walk, promenade
deamo	to be in love with
debacchor	to rave, revel wildly
debeo	to withhold, keep back
debilis	lame, disabled, crippled, infirm, debilitated, feeble, frail, weak
decedo	to go away, depart, withdraw, retire
decem	ten
deceptus	
deceris	
decerno	to decide, determine, pronounce a decision, judge, decree, resolve, vote
decet	
decido	
decies	
decimus	the tenth
decipio	to catch, ensnare, entrap, beguile, elude, deceive, cheat
declaro	to disclose, make evident, reveal
declino	to bend aside, turn away
decrepitus	very old, decrepit
decretum	a decree, decision, ordinance, vote, resolution
decumbo	to lie down, recline
dedecor	
dedecoro	to disgrace, dishonor, bring to shame
dedecorus	dishonoring, disgraceful
dedecus	disgrace, dishonor, infamy, shame
dedo	to give away, give up, surrender, deliver, consign, yield, abandon, render
deduco	to lead away, draw out, turn aside, divert, bring out, remove, drive off, draw down
deductor	
deductus	lowered, unambitious, modest
deeo	
de_-fateor	
defatigo	to weary out, tire, fatigue, exhaust
defendo	to ward off, repel, avert, keep off
defensor	an averter, protector against
defero	to bring away, carry off, take down, carry, take, remove
defervesco	to cease raging, cool down, be allayed, be assuaged
defetiscar	
deficio	to withdraw, revolt, desert, fall off
defio	
defrudans	
defrudat	
defugio	to run off, flee away, make an escape
defunctus	
defungor	to have done with, acquit oneself of, discharge, perform, finish
degero	
dego	to spend, pass
dehinc	from this time, henceforth, hereafter, for the future
dehortor	to advise to the contrary, dissuade
deinde	then, next, thereafter, thence
delectamentum	a delight, amusement, sport
delectatio	a delighting, delight, pleasure, amusement, satisfaction
delecto	to allure, attract, delight, charm, please, entertain, interest
deleo	to erase, efface, obliterate, blot out
delibero	to weigh well, consider maturely, deliberate, ponder, meditate, take counsel, consult, advise upon
delibuo	
delictum	a fault, offence, trespass, crime, transgression, wrong, defect
delinquo	to fail, be wanting, fall short, trespass, err, commit a fault, do wrong, transgress, offend
deliro	to be crazy, be deranged, be silly, dote, rave
delirus	silly, doting, crazy
deludo	to play false, mock, deceive, make sport of, delude
demens	out of one's senses, insane, demented, mad, raving, foolish, distracted
demensum	an allowance, ration
demensus	
dementia	insanity, madness, distraction, folly
dementio	
demetior	to measure off, measure out
demiror	to wonder, be amazed
demissus	lowered, sunken, low-lying, low
demitto	to send down, let down, drop, lower, put down, let fall, sink
demo	to take away, take off, subtract, remove, withdraw
demonstro	to point out, indicate, designate, show
demos	
demoveo	to move away, put away, remove, expel, drive out
demseris	
demulceo	to stroke down, stroke caressingly
demum	at length, at last, not till then, just, precisely, only
denarro	to tell, relate, narrate
denego	to reject, refuse, deny
denique	and thenceforward, and thereafter, at last, at length, finally, lastly, only, not until
dens	a tooth
denuo	once more, a second time, anew, afresh, again
deorsum	downwards, down
depeciscor	
depereo	to go to ruin, perish, die, be lost, be undone
depexum	
depingo	to depict, portray, paint, draw
deporto	to carry down, carry off, take away
depravo	to distort, disfigure
deputo	to cut off, prune
derepente	suddenly, on a sudden
derepo	to crawl down, sneak down
derideo	to laugh at, laugh to scorn, scoff at, deride, mock
derisus	mockery, scorn, derision
derivo	to lead off, turn away
de_-sedeo	
desero	to leave, forsake, abandon, desert, give up
deserta	
desertum	
desertus	deserted, desert, solitary, lonely, waste
deservio	to serve zealously, be devoted, be subject, be of service
desideo	to sit long, sit idle, remain inactive
desiderium	a longing, ardent desire, wish, want, grief, regret
desidero	to long for, ask, demand, call for, wish for, desire, require, expect
desido	to sink, settle down, fall
designo	to mark out, point out, trace, designate, define
desino	to leave off, give over, cease, desist, forbear
de_-sisto	
desisto	to leave off, cease, give over, desist from
despica	
despicatus	
despicor	
despolio	to rob, plunder, despoil
despondeo	to promise to give, promise, pledge
desponderim	
despondi	
despondisti	
despondit	
desponsam	
de_-sto	
desum	to be away, be absent, fail, be wanting, be missing
deterior	lower, worse, poorer, meaner
deterioro	
deterreo	to frighten off, deter, discourage, prevent, hinder
detineo	to hold off, keep back, detain, check
detondeo	to shear off, cut off, clip, shear
detraho	to draw off, take down, pull down, take away, remove, withdraw, drag, bring
detrimentum	that which is worn away
deus	a god, deity
devenio	to come, arrive, reach
deverbero	to thrash, cudgel soundly
deverto	to turn away, turn aside, turn in, put up, betake oneself, go to lodge
devincio	to bind fast, tie up, fetter, clamp
devinco	to conquer completely, overcome, subdue
devinctus	devoted, strongly attached
devito	to avoid, shun
dexter	to the right, on the right side, right
dextera	the right hand
dejero	
dica	a lawsuit, judicial process, action
dicaam	
dicererm	
dico	
dictio	a saying, speaking, uttering, delivery
dictito	to say often, declare, maintain, assert, insist
dicto	to dictate, suggest, remind
dictum	something said, a saying, word, assertion, remark
diecula	a little while, respite
dies	a day, civil day
differo	to carry apart, spread abroad, scatter, disperse, separate
difficilis	hard, difficult, troublesome, impracticable, laborious, perilous
difficillimum	
difficultas	difficulty, trouble, distress, poverty, want, embarrassment
diffluo	to flow in different directions, flow away
digitulus	a little finger
digitus	a finger
dignitas	worth, merit, desert, character
digno	to deem worthy
dignus	worthy, deserving, meritorious, deserved, suitable, fitting, becoming, proper
digresses	
dilapido	to throw away, squander, consume
diligens	industrious, careful, assiduous, attentive, diligent, accurate, scrupulous, faithful
diligenter	industriously, attentively, diligently, assiduously
diligentia	attentiveness, earnestness, diligence, industry, assiduity, care, faithfulness
diligo	to single out, value, esteem, prize, love
dilucidus	clear, distinct, evident
dimidium	the half
dimidius	half, one half
diminuo	
dimitto	to send different ways, send out, send forth, send about, scatter, distribute
dinumero	to count, reckon, enumerate, compute
diruo	to tear asunder, overthrow, demolish, destroy
discedo	to go apart, part asunder, divide, separate, disperse, scatter
discessio	a separation, division
discidium	a parting, separation, disagreement, dissension, discord
discido	
discindo	to tear asunder, cut apart, cleave, divide, rend, tear
disciplina	instruction, tuition, teaching, training, education
discipulus	a learner, scholar, pupil, disciple, student, follower
disco	to learn, learn to know, acquire, become acquainted with
discolorius	
discordia	disunion, disagreement, dissension, variance, discord
discordo	to be at variance, differ, quarrel
discribo	to distribute, divide, apportion, assign
discrucio	to rack to pieces, torture
discus	a quoit
dispendium	expense, cost, loss
dispereo	to go to ruin, be undone, perish
dispergo	to scatter, spread abroad, disperse
dispicio	to descry, discern, perceive, make out, distinguish, detect
displiceo	to displease, be unsatisfactory
dispudet	it shames, is shameful
disputo	to weigh, examine, investigate, treat, discuss, explain
disrumpo	
dissero	
dissimilis	unlike, dissimilar, different
dissimulo	to make unlike, disguise
dissolvo	to take apart, disunite, part, destroy
dis-taedet	
distorqueo	to turn awry, twist, distort
distraho	to pull asunder, tear in pieces, part, divide
distribuo	to divide, distribute, apportion, spread
disturbo	to drive asunder, separate by violence, throw into disorder, disturb
disjungo	
ditis	
dito	to enrich
diu	by day, all day
dius	godlike, divine, worshipful, adorable
diutinus	of long duration, lasting, long
diverticulum	
dives	rich, wealthy, opulent
divido	to divide, force asunder, part
dividuus	divisible
divina	
divino	to foresee, divine, foretell, predict, prophesy, expect, dread, conjecture
divinus	of a god, of a deity, divine
divisor	one who distributes
divitia	
divitiae	riches, wealth
divitioribus	
divorto	
divus	
dixti	
dijudico	
do	to hand over, deliver, give up, render, furnish, pay, surrender
doceo	to cause to know, make aware, teach, instruct, inform, show, prove, convince, tell
docti	
dolabella	
doleo	to feel pain, suffer, be in pain, ache
dolium	a large, wide - mouthed, globular jar
dolo	
dolor	pain, smart, ache, suffering, anguish
dolus	a device, artifice, contrivance
domina	a mistress, dame, lady, she who rules
dominium	a feast, banquet
dominus	a master, possessor, ruler, lord, proprietor, owner
domo	to domesticate, tame, break, subdue, master
domus	a house, dwelling-house, building, mansion, palace
donax	
donec	as long as, while
donli	
dono	To give as a present, present, bestow, grant, vouchsafe, confer
donum	a gift, present
dormio	to sleep
doron	
dos	a marriage portion, dowry
doto	to endow, portion
drachmarum	
drachmis	
dromo	
dromos	
dubiant	
dubito	to waver in opinion, be uncertain, be in doubt, be perplexed, doubt, question
dubium	
dubius	moving two ways, fluctuating
duco	to lead, conduct, guide, direct, draw, bring, fetch, escort
ducto	to lead, draw, conduct
dudum	a short time ago, little while ago, not long since, but now
due	
duiut	
dulce	agreeably, charmingly, delightfully
dulcis	sweet
dum	
duo	two
duplex	twofold, double
dura	
duriter	roughly, coarsely
duritia	hardness
durius	
duro	to make hard, harden, solidify
durum	
durus	hard
dux	a leader, conductor, guide
Danae	
Danaus	
Dareus	
Darius	
Davus	
DAVTS	
DAVUS	
Deceml	
Demea	
Demipho	
Demnea	
Demsi	
Despondi	
Despondit	
Desponsam	
DEMEA	
DEMIEA	
DEMIPHO	
Diana	the goddess of light and of the moon
Dicdum	
Dionysia	the festival of Bacchus, the Bacchanalia
Dionysius	
Diphilus	
Dis	deity
Discus	
Dixti	
Dixtin	
Dixtine	
Dolo	
Domni	
Dorcium	
Dores	
Dorias	
Dorio	
Dorium	
Dorius	
Dorus	
DORIAS	
DORIO	
DORUS	
Dromo	
Dromos	
Dubis	
Ducturuml	
Dunique	
eadem	by the same way
ear	
ebibo	to drink up, drain
ebrio	
ebrius	full, sated
ecastor	by Castor
ecca	
ecce	demonstr
eccere	look! lo! there!
ecculm	
eccuni	
ecqui	Is there any? Any?
ecquis	Is there any one? any? any one? anybody? anything?
edax	greedy, voracious, gluttonous, rapacious
edepol	by Pollux
edico	to declare, publish, make known, proclaim, order, establish, decree, ordain
edictuin	
editor	
editum	Heights, elevations
edo	
edoceo	to teach thoroughly, instruct, inform, apprise
edornmiscam	
educo	to bring up, rear, train, educate
eductor	
effectum	an effect
effectus	an effecting, execution, accomplishment, performance
effero	
efferus	very wild, fierce, savage
efficio	to make out, work out, bring to pass, bring about, effect, cause, produce, make, form, execute, finish, complete, accomplish
effluo	to flow out, flow forth, run out
effodio	to dig out, dig up, mine, excavate
effor	to speak out, say out, utter, tell
effringo	to break off, break open
effugio	to flee away, get away, escape
effugo	
effundo	to pour out, pour forth, shed, spread abroad
effutio	to blab, babble, prate, chatter
egeo	to be needy, be in want, be poor, need, want, lack, have need
egero	to carry out, bring out, take away, remove, discharge
egestas	indigence, penury, necessity, want
ego	I, me, we, us
egredior	to go out, come forth, march out, go away
egregiee	
egregium	
egregius	select, extraordinary, distinguished, surpassing, excellent, eminent
egressus	a going out, going away, egress, departure
ehem	ha! what!
eheu	ah! alas!
eho	look here! look you! holla! soho!
ehodum	
ei	
eicio	to cast out, thrust out, drive away, put out, eject, expel
eiiciam	
eiiciat	
eiicitur	
eiusmodi	
elabor	to slip away, glide off, fall out, get off, escape
elegantia	taste, propriety, finement, grace, elegance
elego	
elephas	
ellum	
eloquens	eloquent
eloquentia	eloquence
eloquium	expression, utterance, speech
eloquor	to speak out, speak plainly, utter, pronounce, declare, state, express
eludo	to stop playing, cease to sport
emendo	to free from faults, correct, improve, amend
emeo	
emergo	to bring forth, bring to light, raise up
emineo	to stand out, project, reach upward
emitto	to send out, send forth
emno	
emo	to buy, purchase
emorior	to die off, die, decease
emta	
emtam	
emtas	
emtum	
emungo	to wipe the nose, blow the nose
en	lo! behold! see! there!
enarro	to explain fully, recount, describe, interpret
eneco	to kill off, exhaust, wear out, destroy, torment, plague
enim	for, for instance, namely, that is to say, I mean, in fact
enimvero	yes indeed, yes truly, assuredly, of a truth, to be sure, indeed
eniteo	to shine forth, shine out, gleam, brighten
enitor	to force a way out, struggle upwards, mount, climb, ascend
enumero	to reckon up, count over, count out
eo	
eodem	loci, in the same place
eon	
ephebus	a youth
epistula	a writ ten communication, letter, epistle
equidem	verily, truly, indeed, at all events
equus	a horse, steed, charger
era	the mistress of a house, mistress, lady
eradico	to root out, extirpate, annihilate
erga	towards, in respect of, in relation to
ergo	in consequence of, on account of, because of, for the sake of
erilis	of the head of a family, the master's, mistress's
eripio	to tear out, snatch away, wrest, pluck, tear, take away
erratio	a wandering, roving about
erro	
error	a wandering, straying, strolling
erubesco	to grow red, redden
erumpo	to cause to break forth, emit, throw out
erus	the master of a house, head of a family
ess	
et	also, too, besides, moreover, likewise, as well, even: Ph
etenim	for, for truly, and indeed, because, since
etiam	now too, yet, as yet, even yet, still, even now
etiamdum	
etiamsi	
etsi	though
eu	bravo! well! well done!
euge	
eum	
eunucho	
eunuchus	a eunuch
eurus	the southeast wind
evado	to go out, come out, go forth
evanesco	to vanish, pass away, die away, disappear
evenio	to come out, come forth
everro	to sweep out
eversor	a subverter, destroyer
eversus	
everto	to overturn, upturn, turn upside down
evocatus	called out.— Plur. m
evoco	to call out, call forth, summon, evoke
evolvo	to roll out, roll. forth, unroll, unfold
evomo	to spew out, vomit forth
ex	out of, from
exactus	precise, accurate, exact
exadversum	
exanimo	to put out of breath, tire fatigue, weaken, exhaust
exaugeo	to increase greatly, confirm
excarnifico	to tear to pieces, butcher
excedo	to go out, go forth, depart, retire, withdraw
excello	to be eminent, be superior, surpass, excel
excelsi	
excelsum	
excerpo	to pick out, extract
excido	
excito	to call out, summon forth, bring out, wake, rouse
exclamo	to call out, cry aloud, exclaim
excludo	to shut out, exclude, cut off, remove, separate
exclusio	a shutting out, exclusion
exclusti	
excoquo	to boil out, melt out, dry up
excrucio	to torment, torture, rack, plague
excurro	to run out, run forth, hasten forwards
excurso	
excutio	to shake out, shake off, cast out, drive out, send forth
exedo	to eat up, consume, devour
ex-emo	
exemplo	
exemplum	a sample, specimen
exeo	to go out, go forth, go away, depart, withdraw, retire
exerceo	to drive, keep busy, keep at work, oversee, work, agitate
exercio	
exercito	
exercitus	
ex-eximo	
ex-figo	
exigo	to drive out, push forth, thrust out, take out, expel
exigue	shortly, slightly, scantily, sparingly, exactingly, barely, meagrely
exiguum	
exiguus	strict, exact, scanty, small, little, petty, short, poor, mean, inadequate, inconsiderable, paltry
exilis	strict, narrow, thin, slender, lank, small, meagre, poor
eximius	taken out, excepted, exempt
eximo	to take out, take away, remove
existimatio	a judging, judgment, opinion, supposition, decision, estimate, verdict
existimo	to value, estimate, reckon
exitio	
exitium	destruction, ruin, hurt, mischief
exitus	a going out, going forth, egress, departure
ex-loquor	
ex-morior	
exonero	to free, disburden, unload, empty
exopto	to wish earnestly, desire greatly, long for
exorator	one who obtains by entreaty
exordior	to begin a web, lay the warp, prepare to weave
exorior	to come out, come forth, spring up, rise, appear
exorno	to fit out, equip, furnish, supply, provide
exoro	to move, prevail upon, persuade by entreaty, induce, appease
exosso	to deprive of bones, bone
expcrgiscere	
expectabam	
expectabo	
expectatio	
ex-pecto	
expedio	to extricate, disengage, let loose, set free, liberate
expello	to drive out, drive away, thrust out, eject, expel
experibere	
experior	to try, prove, test, experience, endure
expers	having no part in, not sharing in, not privy to
expeto	to seek after, strive for aim at, demand, ask
expiscor	to fish out, search out, find out
explano	to make plain, make clear, explain
expleo	to fill up, fill full, fill, stuff
exploro	to cause to flow forth, bring out, search out, examine, investigate, explore
expolio	to smooth, polish, finish, adorn, embellish, refine, elaborate
expono	to put out, set forth, expose, exhibit
exposita	
expostulo	to demand pressingly, insist on
expressus	clearly exhibited, distinct, manifest, clear, plain, express
exprimo	to press out, force out, squeeze forth
exprobratio	a reproaching, upbraiding
expromo	to show forth, discover, exert, practise, exhibit, display
ex-prompto	
expugno	to take by assault, storm, capture, reduce, subdue
expurgo	to purge, cleanse, purify
exquiro	to search out, seek diligently, inquire into, scrutinize, inquire, ask
exsculpo	to dig out, cut out, chisel out, carve
exsequiae	a funeral procession, funeral obsequies
exsequior	
exsequor	to follow to the grave
exsilio	to spring out, spring forth, leap up, start up, bound
exsilium	banishment, exile
exsolvo	to loose, unloose, set loose, release, deliver, free
exspecto	to look out for, await, wait for
exspuo	to spit out, spit
exstillo	to trickle away, melt
exsupero	to mount up, tower
ex-surio	
extemplo	immediately, straightway, forthwith, without delay
extimesco	to be greatly afraid, fear greatly, await with fear, dread
extinguere	
extinguerem	
extinguerent	
extorqueo	to twist out, wrench out, wrest away
extortor	an extorter
extra	on the outside, without
extraho	to draw out, draw forth, pull out, drag
extrarius	outward, external, extrinsic
extremum	at last, finally
extremus	outermost, utmost, extreme, farthest, last
extro	
extrudo	to thrust out, push forth, drive out, drive away
exulo	
ejectus	
Eatur	
Ehenm	
Ehodum	
Eiet	
Eiiciat	
Eiicienda	
Ellam	
Ellum	
Emtae	
Enimvero	
Ennius	
Eos	
Epidicazomenos	
EPIDICAZOMENOS	
Exporge	
faba	a bean, horse-bean
fabrica	a joiner's shop, smith's shop, workshop
fabrico	to make, build, construct, erect
fabula	a narration, narrative
fabulor	to speak, converse, talk, gossip, chat
facesso	to despatch, perform, execute, accomplish, fulfil
facetus	fine, courteous, polite, gentle
faciane	
facies	appearance, form, figure, shape, build
facilis	easy to do, easy, without difficulty
facilitas	easiness, ease, facility, readiness
facinus	a deed, act, action, achievement
facio	to make, construct, fashion, frame, build, erect, produce, compose
facitodum	
factito	to do frequently, do habitually, practise, make persistently
factnm	
factum	a deed, act, exploit, achievement
factura	
factus	elaborate, finished, artistic
facultas	capability, possibility, power, means, opportunity, skill, ability
facundia	eloquence, fluency, command of language
faenus	the profit of capital, interest, usury
falla	
fallacia	deceit, trick, artifice, stratagem, craft, intrigue
fallo	to trip, cause to fall
falso	untruly, unfaithfully, deceitfully, falsely, erroneously
falsum	an untruth, falsehood, fraud, deceit
falsus	deceptive, feigned, spurious, deceitful, false, pretended, delusive, unfounded
fama	a report, rumor, saying, talk, tradition
famelicus	suffering from hunger, famished, starved
fames	hunger
familia	the slaves in a household, a household establishment, family servants, domestics
familiar	
familiaris	of a house, of a household, belonging to a family, household, domestic, private
familiaritas	familiarity, intimacy, familiar intercourse, friendship, intimate acquaintance
familiariter	intimately, on friendly terms
fartor	a fattener of fowls, poulterer
fas	the dictates of religion, divine law
fateor	to confess, own, grant, acknowledge
fator	
fatue	
fatuus	speaking by inspiration
fauces	the upper part of the throat, pharynx, throat, gullet
faustus	of favorable omen, wellomened, fortunate, favorable, auspicious, lucky
fautrix	a patroness, protectress
faveo	to be favorable, be well disposed, be inclined towards, favor, promote, befriend, countenance, protect
favilla	cinders, hot ashes, glowing ashes, embers
fax	a torch, firebrand, flambeau, link
febrio	
febris	a fever
feeit	
felicitas	fertility, happiness, felicity, good-fortune, luck
felix	fruitful, productive
femina	a female, woman
fenestra	an opening for light, window
fera	a wild beast, wild animal
fere	closely, quite, entirely, fully, altogether, just
ferio	to strike, smite, beat, knock, cut, thrust, hit
ferior	
ferme	closely, quite, entirely, fully, altogether, just
fero	to bear, carry, support, lift, hold, take up
ferox	wild, bold, courageous, warlike, spirited, brave, gallant, fierce
ferrum	iron
fertum	
fertus	
ferus	wild, untamed, uncultivated
fervo	to boil, be hot, glow, rage, blaze
festino	to hasten, make haste, be in haste, hurry, be quick
festinus	hasty, hastening, in haste, quick, speedy
festivitas	good-fellowship, generosity
festivum	
festivus	agreeable, pleasing, pretty
festus	of holidays, festive, festal, solemn, joyful, merry
fict	
fictum	a deception, falsehood, fiction
fidelis	trusty, trustworthy, faithful, sincere, true
fides	
fidicina	a female lute-player, lyrist, harpist
fidicino	
fidicinus	
fido	to trust, confide, put confidence in, rely upon
fiducia	trust, confidence, reliance, assurance
fiducio	
fidus	trusty, trustworthy, faithful, sure, credible
figura	a form, shape, figure
figuro	to form, fashion, shape
filia	a daughter
filius	a son
filix	fern
filum	a thread, string
fingo	to touch, handle
finis	that which divides, a boundary, limit, border
fio	
firmo	to make firm, strengthen, fortify, sustain
firmus	strong, steadfast, stable, enduring, powerful
flabellum	a small fan, flyflap
flaccus	flabby, flap-eared
flagitium	a shameful act, passionate deed, outrage, burning shame, disgraceful thing
flamma	a blazing fire, blaze, flame
flammo	to kindle, inflame, blaze, burn
flecto	to bend, bow, curve, turn, turn round
fleo	to weep, cry, shed tears, lament, wail
flo	to blow
floccifecerim	
floccus	a lock, flock
focus	a fire-place, hearth
fodio	to dig, dig up
foedus	
foeneraret	
for	to speak, say
foras	out through the doors, out of doors, forth, out
fores	
fori	
forio	
foris	
forma	a form, contour, figure, shape, appearance, looks
formidulosus	producing fear, dreadful, terrible, terrific
formo	to shape, fashion, form, build
formosus	finely formed, beautiful, handsome
formus	
foro	
fors	chance, hap, luck, hazard, accident
forsan	perhaps, perchance, peradventure
forsitan	perhaps, peradventure, it may be that
fortasse	perhaps, peradventure, probably, possibly
fortis	strong, powerful, mighty
fortiter	strongly, powerfully, vigorously
fortitudo	strength, force
fortuna	chance, hap, luck, fate, fortune
fortuno	to make prosperous, make happy, speed, further, prosper, bless
forum	an open space, public place, court, market-place
forus	a gangway
foster	
frango	to break in pieces, dash to pieces, shiver, shatter, fracture
frater	a brother
fraternus	of a brother, brotherly, fraternal
fraudo	to cheat, beguile, defraud, rob
fraus	a cheating, deceit, imposition, fraud
frequens	often, regular, constant, repeated, assiduous
fretum	a strait, sound, channel
fretus	leaning, supported, relying, depending, trusting, daring, confident
frigeo	to be cold, be chilly, freeze
frigo	to roast, parch, fry
frons	
fructus	an enjoying, enjoyment, delight, satisfaction
frugalis	thrifty, temperate, frugal, provident, worthy
frugis	
fruit	
fruor	to derive enjoyment from, enjoy, delight in
frustra	in deception, in error
frustro	
frustror	to deceive, dis appoint, trick, elude, frustrate
fucus	
fuga	a fleeing, flight, running away
fugio	to flee, fly, take flight, run away, make off
fugitivus	fleeing away, fugitive
fugito	to flee eagerly, flee in haste, avoid, shun
fugo	to cause to flee, put to flight, drive off, chase away, rout, discomfit
funambulus	a ropedancer
funda	a sling
funditus	from the bottom, from the foundation
fundo	
fundus	the bottom, lowest part
funebria	
funebris	of a funeral, funeral-, funereal
fungor	to busy oneself, be engaged, perform, execute, administer, discharge, observe, do
funis	a rope, sheet, line, cord
funus	a funeral procession, funeral rites, burial, funeral
fur	a thief
furcifer	a yoke-bearer, gallows rogue, hang-dog, rascal
furcifero	
furtum	theft, robbery
futtilis	that easily pours out, that cannot contain
futurus	going to be, yet to be, to come, future
Fatuus	
FABIUS	
FANNIO	
Flam	
Flos	
FLACCO	
Foeneratum	
Fortuna	
Frugi	
FULVIO	
gallina	a hen, domestic hen
ganeo	a glutton, debauchee
ganeum	an eating-house
gannio	to bark, snarl, growl
garrio	to chatter, prate, prattle, chat
garrulus	chattering, prattling, prating, talkative, garrulous
gaudeo	to rejoice, be glad, be joyful, take pleasure, be pleased, delight
gaudium	inward joy, joy, gladness, delight
gemino	to double
geminus	born together, twin-born, twin-
gemitus	a sighing, sigh, groan, lamentation, complaint
gemo	to sigh, groan, lament
gener	a daughter's husband, son-in-law
genero	to beget, procreate, engender, produce, create
genius	a tutelar deity, genius
gens	a race, clan, house
genu	a knee
genus	
germanus	full, own
gero	to bear about, bear, carry, wear, have, hold, sustain
gerro	a trifler
gesta	deeds, acts, achievements
gestio	
gesto	to bear, carry, have, wear, wield
gestus	bearing, carriage, posture, attitude, motion, gesture, movement, action, sign
gladiator	a swordsman, gladiator, fighter
gladiatorium	
gladiatorius	of gladiators, gladiatorial
gladium	
gladius	a sword
gloria	glory, fame, renown, praise, honor
glorior	to boast, vaunt, glory, brag, pride oneself
gloriosus	full of glory, glorious, famous, renowned
gnata	
gnatae	
gnatam	
gracilus	
gradus	a step, pace, gait, walk
grandio	
grandis	full-grown, large, great, full, abundant
grandiusculus	
gratia	favor, esteem, regard, liking, love, friendship, partiality
gratulor	to manifest joy, be glad, congratulate, rejoice
gratus	beloved, dear, acceptable, pleasing, agreeable
gravida	
gravido	to load, impregnate
gravidus	laden, filled, full, swollen
gravis	heavy, weighty, ponderous, burdensome, loaded, laden, burdened
graviter	weightily, heavily, ponderously
gravo	to make heavy, load, burden, weigh down, weight, oppress
grego	
gremium	a lap, bosom
grex	a flock, herd, drove, swarm
gubernatrix	a conductress, directress
guberno	to steer, pilot
gynaeceum	the women's apartments, inner rooms
Gallina	
Geta	
Getes	
GETA	
Glycerium	
GLABRIONE	
GLYCERIUM	
Gnatae	
Gnatam	
Gnatho	the name of a parasite
Gnathonici	
GNATHO	
Graece	in the Greek language, in Greek
Graeci	
Graecum	
Graecus	of the Greeks, Greek, Grecian
Gratia	
Gratius	
GRAECA	
ha	
habeo	to have, hold, support, carry, wear
habito	to dwell, abide, reside, live
habitudo	condition, appearance
habitus	
hace	
haece	
haereo	to hang, stick, cleave, cling, adhere, hold fast, be fixed, sit fast, remain close
haesito	to stick fast, remain fixed
hariolor	to foretell, prophesy, divine
hariolus	a soothsayer, prophet
haruspex	a soothsayer, diviner, inspector of the entrails of victims
haud	not, not at all, by no means
haudquaquam	by no means whatever, not at all
he	
hei	ah! woe! oh dear!
heia	ha! good! see!
helvus	
hem	oho! indeed! well! well, to be sure! hah!
hens	
hereditas	heirship, inheritance
heredito	
heres	an heir, heiress
heri	yesterday
heros	a demi-god, hero
hesternus	of yesterday, yesterday's
heu	
heus	
hic	
hicine	
hilaris	cheerful, of good cheer, lively, gay, blithe, merry, jocund, joyful
hilaro	to make cheerful, cheer, gladden, exhilarate
hilaruni	
hilarus	cheerful, gay, merry, blithe, jocund, joyful
hinc	from this place, hence
hince	
hisco	to open, gape, yawn
hocce	
hodie	to-day
hoe	
hoeine	
holmo	
homo	a human being, man, person
homuncio	a little man, dwarf, manikin
honesto	to honor, dignify, decorate, adorn, grace, embellish
honestum	honesty, integrity, virtue
honestus	regarded with honor, respected, honored, of high birth, distinguished, honorable, respectable, noble
honinem	
honor	
honorus	conferring honor, honorable
hora	an hour
horreo	to stand on end, stand erect, bristle, be rough
horresco	to rise on end, stand erect, bristle up, grow rough
horreum	a storehouse, barn, granary, magazine, cellar
horridus	standing on end, rough, shaggy, bristly, prickly
horsum	hitherwards, hither, this way
horto	
hortor	to urge, press, incite, instigate, encourage, cheer, exhort
hortus	a garden, pleasure-garden
hoscine	
hospes	an entertainer, host
hospita	she who entertains, a hostess
hospitus	hospitable, friendly
hostio	
hostis	a stranger, foreigner
hostus	
huc	to this place, hither
hui	hah! ho! oh!
huiusmodi	
humana	
humani	
humanitus	humanly, after the manner of men
humano	
humanum	
humanus	of man, human
humilis	low, lowly, small, slight
humo	to cover with earth, inter, bury
humus	the earth, ground, soil
Hacine	
Heautontimorumenos	
Hecyra	
Hegio	
Hegionem	
Hegioni	
Heius	
Hera	
Hercules	a son of Jupiter and Alcmena, and god of strength
Here	
Hero	
Heus	
HEAUTONTIMORUMENOS	
HECYRA	
HEGIO	
Hice	
Hilarus	
Hlymenaeum	
Horus	
Huiusmodi	
Huncine	
Hymenaeus	the god of marriage, god of weddings, Hymen
iamluddum	
ibi	in that place, there
ibidem	in the same place, in that very place, just there, on the spot
idcirco	on that account, for that reason, therefore
idem	the same
ideo	for that reason, on that account, therefore
idoneus	fit, meet, proper, becoming, suitable, apt, capable, convenient, sufficient
igitur	then, therefore, thereupon, accordingly, consequently
ignarus	ignorant, not knowing, unacquainted with, unskilled in, inexperienced, unaware
ignavus	inactive, lazy, slothful, idle, sluggish, listless, without spirit, cowardly, dastardly
ignis	fire
ignobilis	unknown, unrenowned, undistinguished, obscure
ignoro	not to know, to be unacquainted, be ignorant, mistake
ignosco	to pardon, forgive, excuse, overlook, allow, indulge, make allowance
ignotum	
ignotus	unknown, strange, unrecognized, unfamiliar
ilia	the abdomen below the ribs, groin, flanks
ilicet	let us go, have done
ilico	in that very place, on the spot, there
ilignus	of holm-oak, oaken
ilium	
ill	
illa	in that way, in that direction, there
ille	dem
illex	
illiberalis	
illiberaliter	
illic	
illicio	
illinc	from that place, thence, from yonder
illium	
illiusmodi	
illlam	
illudo	
illuvies	
imagis	
imbirem	
immemor	unmindful, not thinking, forgetful, regardless, negligent, heedless
immeo	
immerens	undeserving, innocent
immerito	undeservedly, unjustly, without cause
immeritus	undeserving, guiltless, innocent, without fault
immisericorditer	unmercifully
immodestus	unrestrained, excessive, shameless
immortales	
immortalis	undying, immortal
immortalitas	exemption from death, immortality, endless life
immundo	
immundus	unclean, impure, dirty, fllthy, foul
immutatus	unchanged, unaltered
immuto	to change, alter, transform
imparatus	not ready, unprepared, unprovided, unfurnished
impedimentum	a hinderance, impediment
impedio	to entangle, ensnare, shackle, hamper, hinder, hold fast
impello	To strike against, push, drive, smite, strike, reach
impendeo	to hang over, overhang
impendium	money laid out, outlay, cost, charge, expense
impendo	to weigh out, lay out, expend
impense	exceedingly, greatly, very much, earnestly, eagerly, zealously
impensus	ample, considerate, great
imperator	a commander-in-chief, general
imperatorer	
imperito	to command, govern, rule, be supreme
imperitus	inexperienced, unversed, unfamiliar, not knowing, unacquainted with, unskilled, ignorant
imperium	a command, order, direction, injunction
impero	to command, order, enjoin, bid, give an order: Pa
impertio	to share with, give a part, communicate, bestow, impart
impertior	to take as a partner, make a sharer in
impetro	to gain one's end, achieve, bring to pass, effect, get, obtain, procure
impia	
impii	
impingo	to dash against, throw on, thrust at, fasten upon
impius	irreverent, ungodly, undutiful, unpatriotic, abandoned, wicked, impious
imploro	to invoke with tears
impluvium	a small court open to the sky
impono	to place upon, set on, impose, establish, introduce, set, place
importunitas	unsuitableness, unfitness
importunus	unfit, unsuitable, inconvenient
impotens	powerless, impotent, weak, feeble, helpless
impotentia	helplessness, weakness
improbo	to disapprove, blame, condemn, reject
improbus	not good, bad, wicked, reprobate, abandoned, vile, base, impious, bold, shameless, wanton
improvide	recklessly, improvidently
improviso	on a sudden, unexpectedly
improvisum	
improvisus	not foreseen, unforeseen, unexpected
imprudens	not foreseeing, not expecting, without knowing, unaware, unsuspecting, ignorant, inconsiderate, heedless, inadvertent
imprudentia	want of foresight, inconsiderateness, imprudence, ignorance, inadvertence
impudens	without shame, shameless, impudent
impudenter	shamelessly, impudently
impudentia	shamelessness, impudence
impulsor	one who incites, an inciter, instigator
impulsus	a striking against, push, pressure, shock, impulse
impune	without punishment, unpunished, with impunity
impunis	unpunished
impurus	unclean, filthy, foul
imus	the lowest, deepest, last
in	unequal
inagna	
inanis	empty, void
incedo	to advance, march, proceed, stride, move, stalk, strut
incendo	to set fire to, kindle, burn
incense	
incensus	
inceptio	a beginning, undertaking
incepto	to begin, attempt
inceptor	a beginner
inceptum	a beginning
inceptus	a beginning, undertaking
incerto	
incertum	
incertus	not fixed, unsettled, undetermined
incesso	to fall upon, assault, assail, attack
incido	
incipio	to take hold, take in hand, begin
inclemens	unmerciful, rigorous, harsh, rough, severe
incogito	to contrive, design
incolumis	unimpaired, uninjured, unharmed, safe, sound, entire, whole
incommoditas	inconvenience, unsuitableness, disadvantage, damage, injury
incommodo	to occasion inconvenience, be inconvenient, trouble, annoy
incommodum	inconvenience, trouble, disadvantage, detriment, injury, misfortune, loss
incommodus	inconvenient, unsuitable, unfit, unseasonable, troublesome, disagreeable
incredibilis	not to be believed, incredible, beyond belief, extraordinary, unparalleled
incudo	to forge with the hammer
incurvus	bent, bowed, crooked, curved
incuso	to accuse, complain of, find fault with, blame
incusus	
inde	from that place, thence
indicens	that does not say
indicium	a notice, information, discovery, disclosure, charge, evidence
indico	
indictus	not said, unsaid
indigeo	to need, want, stand in need of, demand, require
indignus	unworthy, undeserving, unfit
indiligenter	carelessly, heedlessly, negligently
in-diligo	
indo	to put into, insert
indotatus	unportioned, portionless
induco	to lead in, bring in, introduce, conduct, lead up, bring forward
indulgeo	to be complaisant, be kind, be tender, exercise forbearance, incline, yield, indulge, concede, grant, allow
induo	to put on, assume, dress in
industria	diligence, activity, assiduity, industry, zeal
industrius	active, diligent, assiduous, industrious
indutiae	a suspension of hostitities, truce, armistice
indutus	a putting on
induxti	
inediocris	
ineo	to go into, enter
ineptia	silliness, folly, absurdity
ineptiae	
ineptio	to be absurd, trifle, play the fool
ineptus	absurd, awkward, silly, inept, impertinent
iners	without skill, unskilful, incompetent
inesco	to allure with bait, entice
inexorabilis	not to be moved by entreaty, unyielding, inexorable
infamia	ill fame, ill report, bad repute, dishonor, disgrace, infamy
infamis	of ill repute, disreputable, notorious, infamous
infamo	to bring into ill repute, disgrace, dishonor, defame
infandus	unspeakable, unutterable, unheard of, unnatural, shocking, abominable
infectus	not done, unwrought, unmade, undone, unaccomplished, unfinished
infelicitas	ill-luck, misfortune
infeliciter	unhappily, unfortunately
infelicito	
infelix	unfruitful, not fertile, barren
infensus	hostile, inimical, enraged
infer	
inferi	
inferius	lower, further down
inferus	below, beneath, underneath, lower
inficio	to stain, tinge, dye, color
infimos	
infirma	
infirmitas	want of strength, weakness, feebleness
infirmo	to weaken, invalidate, disprove, refute, impair, annul
infirmus	not strong, weak, feeble, infirm
infitiae	denial
infitior	not to confess, to contradict, deny, disown
infortunatus	unfortunate, ill-starred
infortunium	a misfortune, calamity
infra	
infringo	to break off, break, bruise
ingeniosus	full of intellect, superior in mind, able, intellectual, clever, ingenious
ingenium	innate quality, nature, temperament, constitution
ingens	not natural, immoderate, vast, huge, prodigious, enormous, great, remarkable
ingenua	
ingenuus	native, indigenous
ingero	to throw in, pour in, heap upon
ingratia	
ingratus	unpleasant, disagreeable, unacceptable
ingredior	to advance, go forward, march, proceed
ingressus	an advancing, walking, gait
inhonestus	dishonorable, disgraceful, shameful
inhumano	
inhumanus	rude, savage, barbarous, brutal, inhuman
inigenium	
inihi	
iniicere	
inimica	
inimicitia	enmity, hostility
inimicus	unfriendly, hostile, inimical
iniquo	
iniquus	uneven, slanting, steep
iniseriam	
initio	to begin, initiate, consecrate, admit
initium	a going in, entrance
initus	an entrance
iniuries	
in-luo	
innascor	to be born in, grow upon, spring up in
innato	to swim in, float upon
innatus	native, inborn, innate, inherent, natural
inno	to swim in, float upon
innocens	harmless, inoffensive, innoxious
innuo	to nod, give a sign, intimate, hint
inopia	want, lack, scarcity
inops	without resources, helpless, weak
in-puro	
inquam	to say
inquies	restless, unquiet
insania	unsoundness of mind, madness, frenzy, folly, senselessness
insanio	to be of unsound mind, be senseless, be without reason, be mad, rave
insanus	of unsound mind, mad, insane
insciens	unknowing, without knowledge, unaware
inscitia	ignorance, inexperience, unskilfulness, awkwardness
inscitus	ignorant, foolish, blundering
inscribo	to write upon, inscribe
insero	
inservio	to be serviceable, be devoted, be submissive, serve
insidiae	a snare, trap
insidior	to lie in ambush, lie in wait for
insigne	a mark, indication, proof, sign, token, signal
insignis	distinguished by a mark, remarkable, noted, eminent, distinguished, prominent, extraordinary
insigno	
insimulo	to make suspected, charge, accuse, blame, impeach
insisto	to set foot, take a stand, stand on, step on, tread on
insolens	unaccustomed, unusual, not used, contrary to custom
insoleo	
insomnia	sleeplessness, want of sleep, watching
insomnis	sleepless, wakeful
insomnium	
insperatus	unhoped for, unlooked for, unexpected, unforeseen
in-spero	
inspicio	to look into, look upon, inspect, consider, contemplate, examine, survey
inspico	to cut in the form of an ear of corn, sharpen
instigo	to goad on, urge, stimulate, stir, set on, incite, instigate
instituo	to put in place, plant, fix, set
insto	to stand upon, take a position
instrenuus	sluggish, spiritless
instruo	to build in, insert
insula	an island, isle
insulsus	unsalted, without taste, coarse
insulto	to spring at, leap upon, leap, bound, jump, spring
insum	to be in, be upon
in-suo	
insuper	above, on the top, overhead
integer	untouched
integrasco	to begin anew, break out afresh
integratio	a renewing, restoring
integro	to make whole
intellegentia	discernment, understanding, intelligence
intellego	to come to know, see into, perceive, understand, discern, comprehend, gather
intellexti	
intellextin	
intendo	to stretch out, reach forth, extend
inter	between, betwixt
intercedo	to come between, intervene, be between
intercipio	to seize in passing, intercept
interdico	to interpose by speaking, forbid, prohibit, interdict
interdiu	during the day, in the daytime, by day
interdum	sometimes, occasionally, now and then
interea	meanwhile, in the meantime, in the interim
interemtam	
intereo	to go among, be lost
interfacio	
interficio	to put out of the way, destroy, bring to naught
interim	meanwhile, in the meantime
interior	inner, interior, middle
interloquor	to interrupt in speaking
interminatus	unbounded, endless
intermino	
interminor	to threaten, forbid with threats
intermitto	to leave off, intermit, omit, suspend, interrupt, neglect
internuntium	
internuntius	a mediator, messenger, gobetween
intero	to rub in, crumble in
interrogo	to ask, question, inquire, interrogate
intersum	to be between, lie between
intertrimentum	loss by attrition, waste
interturbo	to make disturbance
intervenio	to come between, come upon, come in, intervene, interrupt
interventus	a coming in, intervention
intimus	inmost, innermost, deepest, profound
intro	
introduco	to lead in, bring in, introduce, conduct within, admit
introeo	to go in, enter
introeuntem	
introisse	
intromitto	to send in, let in, admit
introrumpo	to break in, enter by force
intueor	to look upon, look closely at, gaze at
intumum	
intuo	
intus	on the inside, within
inultus	without satisfaction, unavenged, unrevenged, not vindicated
inus	
invado	to go into, enter
invenio	to come upon, find, meet with, light upon
inventor	a contriver, author, discoverer, inventor
inventum	an acquisition:
inventus	
invenustus	without charm, ungraceful, unattractive
inverto	to turn upside down, turn about, upset, invert, reverse
investigo	to track, trace out, search after
inveterasco	to grow old, become fixed, be established, continue long
invideo	to look askance at, cast an evil eye upon
invidia	envy, grudge, jealousy, ill-will, prejudice
invidus	envious, envying
inviso	to look after, go to see, visit
invisus	
invitatus	an inviting, invitation
invito	to invite, treat, feast, entertain
invitus	against the will, unwilling, reluctant, perforce, on compulsion
invocatus	uncalled, without a summons
invoco	to call upon, invoke, appeal to
involo	to fly at, rush upon
in-jacio	
injecto	
injuria	
injurius	
injurus	
injussus	
injustitia	
injustum	
injustus	
iocumque	
ipse	Self, in person
ira	anger, wrath, rage, ire, passion, indig nation
iracundia	a proneness to anger, hasty temper, irascibility
iracundus	irascible, irritable, passionate, choleric, angry, ireful, easily provoked
irasco	
irascor	to be angry, be in a rage
irrideo	
irrido	
irrimus	
irrisas	
irritatus	
irrito	
irritum	
irritus	
irruo	
is	he, she, it, the one mentioned
istac	there, that way
iste	this, that, he, she
istic	
istinc	from there, thence, from where you are
istiusmodi	
isto	thither, to you, to where you are
istoc	thither, that way, yonder
istorsum	thitherwards
istuc	thither, to you, to where you are, in that direction
ita	in this manner, in this wise, in such a way, so, thus, accordingly, as has been said
item	likewise, besides, also, further, moreover, too, as well
iter	a going, walk, way
iterum	again, a second time, once more, anew
itidem	in like manner, so, just, in the same way
itio	a going, walking, travelling
itis	
ito	to go
iuriiurando	
iusiurandum	
Iabere	
IIem	
III	
Ilii	
Ilios	
Iliscine	
Ilium	Ilium, Troy
Ilius	
Illancine	
Imbros	
IMPARIBUS	
Indicum	
Indicus	of India, Indian
Indus	
Intellexti	
INTRODUCTION	
Iris	the goddess of the rainbow, messenger of the gods
Irus	
Istocine	
Istucine	
Istue	
Istune	
Italus	
Itur	
Iupiter	
Iuppiter	Jupiter, Jove, son of Saturn, brother and husband of Juno, chief of the gods, god of the sky
IUL	
IUVENTIO	
IV	
la	
labasco	to waver, yield
labefacio	to cause to totter, shake, loosen, make ready to fall
labefacto	to cause to totter, shake, overthrow
labia	
labium	a lip
labor	
labored	
laboriosus	full of labor, laborious, toilsome, wearisome, difficult, troublesome
laboro	to labor, take pains, endeavor, exert oneself, strive
labos	
labrum	
lacero	to tear to pieces, mangle, rend, mutilate, lacerate
lacesso	to excite, provoke, challenge, exasperate, irritate
lacio	
lacrima	a tear
lacrimo	to shed tears, weep
lacrimor	
lacrimula	a little tear, tearlet
lacta	
lacto	
lacus	an opening, hollow, lake, pond, pool
laedo	to hurt, wound, injure, damage
laerimet	
laeta	
laetitia	joy, exultation, rejoicing
laeto	
laetor	to rejoice, feel joy, be joyful, be glad
laetus	joyful, cheerful, glad, gay, joyous, rejoicing, happy, pleased, delighted, full of joy
lamentarius	
lamento	
lamentor	to wail, moan, weep, lament
lampada	
lana	wool
languor	faintness, feebleness, weariness, sluggishness, languor, lassitude
lanipendius	
lanius	a butcher
lapido	to stone, throw stones
lapio	
lapis	a stone
largior	to give bountifully, lavish, bestow, dispense, distribute, impart
largitas	abundance, bounty, liberality
largitor	a liberal giver, bestower, granter, dispenser, distributor
largitus	
largus	abundant, copious, plentiful, large, much
lascivia	sportiveness, playfulness, frolicsomeness, jollity
lassus	faint, languid, weary, tired, exhausted
lateo	to lurk, lie hid, be concealed, escape notice, skulk
later	a brick, tile
latino	
latus	
laudo	to praise, laud, commend, honor, extol, eulogize, approve
laus	praise, commendation, glory, fame, renown, esteem
lavatum	
lavo	to wash, bathe, lave
lecto	to be punished, suffer punishment, be beaten
lectulus	a small couch, bed
lectum	
lectus	
leditor	
lego	
lena	a bawd, procuress
lenio	to soften, mollify, moderate, assuage, soothe, calm
lenis	soft, smooth, mild, gentle, easy, calm
lenitas	softness, smoothness, gentleness, mildness
leno	a pimp, pander, procurer
lenonius	
lepidus	pleasant, agreeable, charming, fine, elegant, neat
lepis	
lepus	a hare
leutiqetuam	
levatus	
levis	
levo	
lex	a formal proposition for a law, motion, bill
liabet	
lianc	
libelrum	
libens	willing, with readiness, with good will, with pleasure, glad
libenter	willingly, cheerfully, gladly, with pleasure
liber	free, unrestricted, unrestrained, unimpeded, unembarrassed, unshackled
liberalis	of freedom, relating to freedom
liberalitas	a characteristic of a freeman, ingenuousness, frankness, affability
liberaliter	like a freeman, nobly, ingenuously, liberally, courteously, graciously
liberi	free persons
libero	to set free, free, liberate, manumit
libertas	freedom, liberty, absence of restraint, permission
libertus	a freedman, emancipated person
libet	it pleases, is pleasing, is agreeable
libido	pleasure, desire, eagerness, longing, fancy, inclination
libita	pleasure, liking
libo	to take out as a sample, take a little of
libortum	
licentia	freedom, liberty, license, leave
liceo	to be for sale, be priced, be valued
liceor	to bid, make a bid
licet	It is lawful, is allowed, is permitted
licita	
lignum	gathered wood, firewood
ligurio	
lima	a file
limen	a cross-piece, threshold, head-piece, lintel, sill
limis	
limus	slime, mud, mire
linea	a linen thread, string, line, plumb-line
lineus	of flax, of lint, flaxen, linen-
lingua	the tongue
liqueo	to be fluid
liquid	
liquidum	
liquidus	flowing, fluid, liquid
liquo	to make liquid, melt, dissolve, liquefy
litigo	to dispute, quarrel, strive
litium	
lito	to make an acceptable sacrifice, obtain favorable omens
littera	a letter, alphabetical sign, written sign of a sound
litus	the sea-shore, sea-side, beach, strand
locito	to let, hire out
loco	to place, put, lay, set, dispose, arrange
locum	
locus	a place, spot
locutus	
logium	
logos	a word.—Plur., mere words, empty talk
longinquitas	distance, remoteness
longitudo	length
longulus	rather long
longus	long, extended
loquitor	
loquor	to speak, talk, say, tell, mention, utter
lora	
lorum	a thong, strap, strip of leather
lorus	
lubet	
lubitum	
lucidus	full of light, clear, bright, shining, brilliant
lucinus	
lucrius	
lucrum	gain, profit, advantage
luctat	
luctus	sorrow, mourning, grief, affliction, distress, lamentation
luculentus	full of light, bright, splendid
lucus	
ludibrium	a mockery, derision, wantonness
ludificatus	
ludifico	to make game of, delude, cozen, deceive
ludificor	to mock, make game of, make sport of, turn into ridicule, delude, deceive
ludo	to play, play at a game
ludus	a play, game, diversion
lugeo	to mourn, lament, bewail, deplore
lugubris	of mourning, mourning-
luo	to loose, free, pay off
lupus	a wolf
luto	
lutum	
lutus	
lux	light, brightness
luxuria	
luxurio	to be rank, be luxuriant, abound to excess
luxurior	to wanton, revel
luxus	excess, indulgence, luxury, debauchery
L	
Lache	
Laches	
Latinae	the festival of the Latins, Latin holidays
Latini	
Latinius	
Latinum	
Latinus	of Latium, Latin
LACHES	
Lecton	
Lelmnum	
Lemnius	of Lemnos, Lemnian
Lemnos	
Lesbia	
Lesbium	
Lesbius	of Lesbos, Lesbian
LENTULO	
LESBIA	
Liberalis	
Lucina	she that brings to light, goddess of childbirth
Luciscit	
Lupus	
macellum	a butcher's stall, shambles, meat-market, provision-market
macellus	
maceo	
maceria	a wall of soft clay, enclosure, wall
macero	to make soft, make tender, soften, soak, steep, macerate
maco	
mactatus	
macto	to magnify, extol, honor, glorify, elevate
macula	a spot, mark, stain
maeror	a mourning, sadness, grief, sorrow, lamentation
maestus	full of sadness, sad, sorrowful, dejected, melancholy, gloomy, despondent
magis	
magister	a master, chief, head, superior, director, president, leader, commander, conductor
magistra	a mistress, directress
magistratus	the office of master, magisterial office, civil office, magistracy
magistro	
magnificentia	loftiness, grandeur, nobleness, high-mindedness
magnifico	to make much of, set a high value on
magnificus	great, elevated, noble, distinguished, eminent, august
magnus	
magus	
mala	the cheek-bone, jaw
maledico	to speak ill of, abuse, revile, slander, asperse
maledictum	a foul saying, abusive word
maledictus	
malefacio	
malefactum	an evil deed, injury
maleficium	an evil deed, misdeed, wickedness, offence, crime
malevolus	ill-disposed, disaffected, spiteful, malevolent
maligno	
malignus	ill-disposed, wicked, malicious, spiteful, envious, malignant, malign
malitia	ill-will, spite, malice
mallon	
mallus	
malo	to choose rather, prefer
maloiubeas	
malum	
malus	an upright pole, beam, mast
mamma	a breast, pap
mancipium	a taking by hand, formal acceptance, taking possession, seisin, legal purchase
mandatum	a charge, commission, injunction, command, order
mandatus	a command, mandate
mando	
maneo	to stay, remain, abide, tarry
manes	a departed spirit, ghost, shade
manipulus	a handful, bundle
mano	to flow, run, trickle, drop, drip
manon	
manos	
mansio	a staying, remaining, stay, continuance
manus	a hand
mare	the sea
marum	
mastigia	a scoundrel, rascal, rogue
mater	a mother
materfamilias	
maternus	of a mother, maternal
matrimonium	wedlock, marriage, matrimony
matrona	a married woman, wife, matron
maturo	to make ripe, ripen, bring to maturity
maturus	ripe, mature
maxime	in the highest degree, most particularly, especially, exceedingly, altogether, very
maximni	
maximopere	
maximus	large, great, big, high, tall, long, broad, extensive, spacious
majores	
majus	
majusculus	
meapte	
mecastor	so help me Castor, by Castor
medeor	to heal, cure, remedy, be good for
medica	Median clover, Burgundy-clover, lucern
medico	to imbue with healing power, medicate, drug
medicor	to heal, cure
medicus	
medio	
mediocris	of middling size, medium, middling, moderate, ordinary
mediocriter	moderately, tolerably, ordinarily, not very, not remarkably, slightly, somewhat
medion	
meditata	
meditatus	
meditor	to reflect, muse, consider, meditate, give attention
medium	the middle, midst, centre, interval, intervening space
medius	in the middle, in the midst, mid, mean, middle
mei	
meio	to make water
meliores	
melioro	
melius	
meliusculus	somewhat better, rather better
membro	
membrum	a limb, member
memento	
memini	I remember, recollect, think of, am mindful of, bear in mind
memor	mindful, remembering, heedful
memorabile	
memorabilis	that may be told, heard of, credible
memoria	memory, remembrance
memorial	
memoriter	from memory, by personal recollection
memoro	to bring to remembrance, mention, recount, relate, speak of, say, tell
mendicus	beggarly, needy, in want, indigent
mens	the mind, disposition, feeling, character, heart, soul
mensa	a table
mensis	a month
mensus	
mentio	a calling to mind, making mention, mentioning, naming, mention
mentior	to invent, assert falsely, lie, cheat, deceive, pretend
mentitus	imitated, counterfeit, feigned
meo	to go, pass
mercator	a trader, merchant, wholesale dealer
mercatus	trade, traffic, bargaining, buying and selling
mercenarius	
merces	price, hire, pay wages, salary, fee, reward
mercor	to trade, traffic, deal in, buy, purchase
mereo	to deserve, merit, be entitled to, be worthy of
mereor	to deserve, merit, be entitled to
meretricium	
meretricius	of harlots, of prostitutes, meretricious
meretrix	a prostitute, courtesan
meridies	mid-day, noon
merito	
meritum	a merit, service, kindness, benefit, favor
merula	a blackbird, ousel, merle
merus	pure, unmixed, unadulterated
metior	to measure, mete
metuo	to fear, be afraid, stand in fear, be apprehensive
metus	fear, dread, apprehension, anxiety
meum	
meumr	
meus	of me, my, mine, belonging to me, my own
migro	to remove, depart, flit, migrate
miihi	
miles	a soldier
milhi	
militia	military service, warfare, war
milito	to be a soldier, perform military service, serve as a soldier
milium	millet
mille	a thousand, ten hundred
millies	
miluus	a bird of prey, kite, glede
mina	a silver mina
minae	projecting points, pinnacles
minime	least of all, in the smallest degree, least, very little
minimus	least, smallest, very small, minute, trifling, insignificant
minito	
minitor	to threaten, menace
mino	
minor	
minoro	
minuo	to make small, lessen, diminish, divide into small pieces
mira	
mirabile	
mirabilis	wonderful, marvellous, extraordinary, amazing, admirable, strange, singular
mirandus	wonderful, strange, singular
mirificus	wonderful, admirable, marvellous, extraordinary, strange
miro	
miror	to wonder, marvel, be astonished, be amazed, admire
mirus	wonderful, marvellous, astonishing, extraordinary, amazing
misceo	to mix, mingle, intermingle, blend
miser	wretched, unfortunate, miserable, pitiable, lamentable, in distress
misereo	
misereor	to feel pity, have compassion, pity, compassionate, commiserate
miseresco	to feel pity, have compassion
miseria	wretchedness, unhappiness, misfortune, misery, woe, suffering, affliction, distress
misericordia	tenderheartedness, pity, compassion, sympathy, mercy
misero	
miserum	
missa	
missum	
missus	a sending away, sending, despatching
mitis	mild, mellow, mature, ripe
mitto	to cause to go, let go, send, send off, despatch
mius	
mnatre	
modero	
moderor	to set a measure, set bounds, put restraint upon, moderate, mitigate, restrain, allay, temper, qualify
modestia	moderation
modestus	keeping due measure, moderate, modest, gentle, forbearing, temperate, sober, discreet
modo	by a measure, with a limit
modus	a measure, extent, quantity
moechus	a fornicator, adulterer
mola	a millstone, grindstone
molestia	trouble, irksomeness, uneasiness, annoyance, molestation, vexation, distress
molesto	
molestus	troublesome, irksome, grievous, annoying, unmanageable
molio	
molior	to make exertion, exert oneself, endeavor, struggle, strive, toil
mollio	to make soft, make supple, soften
mollis	yielding, pliant, flexible, supple, soft, tender, delicate, gentle, mild, pleasant
molliter	softly, gently, agreeably
mollities	
molo	to grind
momentum	a movement, motion
moneo	to remind, put in mind of, admonish, advise, warn, instruct, teach
moneris	a vessel with a single bank of oars, galley
monito	
monitor	one who reminds, a monitor, suggester
mons	a mountain, mount, range of mountains
monstratio	a showing, direction, guidance
monstro	to point out, exhibit, make known, indicate, inform, advise, teach, instruct, tell
monstrum	a divine omen, supernatural appearance, wonder, miracle, portent
monumentum	that which brings to mind, a remembrancer, memorial, monument
mora	
moratus	
morbus	a sickness, disease, disorder, distemper, ailment, illness, malady
mordeo	to bite, bite into
morigeror	to comply with, gratify, humor, yield
morigerus	compliant, yielding, accommodating, obliging
morion	
morior	to die, expire
moror	to delay, tarry, stay, wait, remain, linger, loiter
mors	death
mortuus	dead
morum	a mulberry
morus	a mulberry-tree
mos	a will, way, habit, manner, fashion, caprice, humor
motus	a moving, motion
moveo	to move, stir, set in motion, shake, disturb, remove
mox	soon, anon, directly, presently, by and by
mraxime	
mulco	to beat, cudgel, maltreat, handle roughly, injure
muliebris	of a woman, womanly, feminine
mulier	a woman, female
muliercula	a little woman
muliero	
mulieros	
multa	much, very, exceedingly, greatly, earnestly
multi	
multimodis	in many ways, variously
multimodus	
multo	by much, much, a great deal, far, by far
multus	adjec
mundus	
munero	
muneror	to give, bestow, present, honor, reward
munus	a service, office, post, employment, function, duty
musica	the art of music, music
musice	
musicus	of music, musical
mussito	to mutter, grumble
mustelinus	of a weasel, weasel-
mutatio	a changing, change, alteration, mutation
mutilo	to cut off, lop off, cut short, clip, crop, maim, mutilate
muto	
muttire	
mutum	
mutuo	mutually, in return
mutus	dumb, mute, speechless, without speech
mutuum	
mutuus	borrowed, lent
M	
Magnus	
Mancre	
Manedum	
Mansuetique	
Matrae	
Matura	
MANLIO	
MARCELLO	
MARCIO	
Melius	
Memor	
Menander	
Menandri	
Menedemus	
MEGALENSIB	
MEGALENSIBUS	
MENANDRU	
MENEDEMITS	
MENEDEMUS	
Mhagis	
Micio	
Midas	
Mide	
Milesius	
Miletus	
Minerva	the goddess of wisdom, sense, and reflection, of the arts and sciences, of poetry, and of spinning and weaving, identified with the Grecian Athene
Missus	
MICIO	
MIenedeme	
MIENEDEMUS	
Mli	
Myconii	
Myconius	
Myrrhina	
Myrrhinam	
Mysi	
Mysus	
MYRRHINA	
MYSIS	
naevius	
naevus	a birth-mark, mole, wart
nam	for
nanciscor	to get, obtain, receive, meet with, stumble on, light on, find
naritus	
narratio	a relating, narrating, narration, narrative
narratum	that which has been told
narratus	a narration, narrative
narro	to make known, tell, relate, narrate, report, recount, set forth
nasco	
nascor	to be born, begin life, be produced, proceed, be begotten
nasus	the nose
nata	a daughter
natale	
natales	
natalis	of birth, birth-, natal
natis	the rump, buttocks
nato	to swim, float
natura	birth
natus	birth, age, years
nauta	a sailor, seaman, mariner, boatman
nautilus	
navigo	to sail, cruise
navis	a ship
naviter	diligently, actively, zealously
navo	to do zealously, perform diligently, accomplish, effect, prosecute
navus	busy, diligent, assiduous, active
ne	no
nebulo	a paltry fellow, idler, scamp
necessarius	unavoidable, inevitable, indispensable, pressing, needful, requisite, necessary, compulsory
necesse	unavoidable, inevitable, indispensable, necessary
necessitas	unavoidableness, inevitableness, necessity, compulsion, force, exigency
necessus	a necessity
necne	or not
neco	to kill, slay, put to death, destroy
nedum	by no means, much less, still less, not to speak of
neglectus	
neglegenter	heedlessly, carelessly, negligently
neglego	to disregard, not heed, not trouble oneself about, not attend to, slight, neglect, be regardless of, be indifferent to
negligenter	
negligentiam	
nego	to say no, deny, refuse
negotior	to carry on business, do wholesale business, act as banker
negotium	a business, employment, occupation, affair
nemen	
nemo	no man, no one, nobody
nempe	certainly, without doubt, assuredly, of course, as everybody knows
neo	to spin
nepos	a grandson, child's son
neque	
nequeo	not to be able, to be unable, cannot
nequicquam	
nequid	
nequior	
nequitia	bad quality, worthlessness, inefficiency, vileness, wickedness
nervus	a sinew, tendon, muscle
nescio	not to know, to be ignorant
nescium	
nescius	unknowing, ignorant, unaware
neseis	
neu	
neum	
neuter	neither the one nor the other, neither
neutiquam	by no means, in no wise, not at all
neve	and not, nor, and that not, and lest
nex	death, violent death, murder, slaughter
ni	not
nihil	
nihilum	
nimio	by far, excessively
nimirum	without doubt, doubtless, indisputably, certainly, surely, truly
nimis	beyond measure, too much, overmuch, excessively, too
nimium	too much, too
nimius	beyond measure, excessive, too great, too much
nisi	if not, unless
nitor	
nlullan	
no	to swim, float
nobilis	that is known, well-known, famous, noted, celebrated, renowned
nobilitas	celebrity, fame, renown
nobilito	to make known, render famous, make renowned
nobiseum	
nodus	a knot
nola	
nolo	to wish . . . not, will . . . not, not to wish, to be unwilling
nome	
nomen	a means of knowing, name, appellation
nomino	to call by name, name, give a name to
non	not, by no means, not at all
nondum	not yet
nonne	interrog
nonnihil	
nonnullus	some, several
nonnumquam	sometimes, a few times
nonnus	
noram	
norat	
norimus	
nos	
nosco	to get knowledge of, become acquainted with, come to know, learn, discern
noster	our, our own, ours, of us
notion	
notitia	a being known, celebrity, note, fame
notius	
notus	known
novi	
novo	to make new, renew, renovate
novum	
novus	new, not old, young, fresh, recent
nox	night
noxa	hurt, harm, injury
noxia	hurt, harm, damage, injury
noxius	hurtful, harmful, injurious, noxious
nubo	to veil oneself, be married, marry, wed
nudus	naked, bare, unclothed, stripped, uncovered, exposed
nugae	jests, idle speeches, trifles
nullus	not any, none, no
num	now
numero	to count, enumerate, reckon, number, take account of
numerus	a number
nummus	a piece of money, coin, money
numnam	
numquam	at no time, never
numquid	interrog
numquidnam	
numquillnam	
numquis	
nunc	now, at present, at this time
nuncia	
nuncin	
nuncubi	
nuntia	a female messenger, she that brings tidings
nuntio	to announce, declare, report, relate, narrate, make known, inform, give intelligence of
nuntium	
nuntius	that announces, making known, informing
nuper	newly, lately, recently, freshly, not long ago, just
nuperus	
nupta	a bride, wife
nuptiae	a marriage, wedding, nuptials
nupto	
nuptus	
nurus	a daughter-in-law
nus	
nusquam	nowhere, in no place
nutricium	
nutricius	a bringer-up, tutor
nutrico	
nutrix	a wet-nurse, nurse
Naevius	
Nalm	
Natural	
Nausistrata	
NAUSISTRATA	
Nee	
Neptunius	of Neptune, Neptunian
Neptunus	Neptune, god of the sea, son of Saturn and brother of Jupiter
Niceratum	
Nion	
Nisus	
Nonnihil	
Nonnunquam	
Noram	
Norat	
Nostius	
Nostos	
Nostrapte	
Novitiae	
Novius	
Numnquid	
Numqui	
Numquidnam	
Numquis	
o	O! oh!
ob	towards, to
ob-capio	
obdo	to put against, shut, close, fasten
obeo	to go, go to meet, go in opposition
obiicerem	
obiici	
obitus	an approach, visit
oblecto	to delight, divert, entertain, amuse, interest
obliviscor	to forget
obmutesco	to become dumb, lose one's speech, be silent
obnitor	to bear upon, press against, struggle with, strain at
obnixus	strenuous, firm, resolute
obnoxius	liable, addicted, guilty
obnuntio	to tell, report, announce
obolus	a small Greek coin, a sixth of a drachma
oborior	to arise, appear, spring up
obsaturo	to sate, cloy
obscurus	dark, darksome, dusky, shady, obscure
obsecro	to beseech, entreat, implore, supplicate, conjure
obsecundo	to comply, humor, yield, be accommodating
obsequium	compliance, yieldingness, complaisance, indulgence
obsequor	to comply, yield, gratify, humor, submit, be accommodating
obsero	
observo	to watch, note, heed, observe, take notice of, attend to
obsido	to beset, invest, besiege, blockade
obsonatus	
obsonium	a relish, sauce, side-dish
obsono	to buy provisions, cater, purvey
obsonor	
obstetrico	
obstetrix	a midwife
obstinatus	resolved, determined, resolute, steadfast, inflexible, stubborn, obstinate
obstino	to resolve, determine, be firmly resolved, persist
obstipesco	
obsto	to stand before, be opposite
obstupefacio	to astonish, amaze, astound, stupefy, benumb
obsum	to be against, be prejudicial to, hinder, hurt, injure: Pa
obtelnperaturos	
obtempero	to comply, attend, conform, submit, obey
obtestor	to call as a witness, protest, make appeal to
obticeo	to be silent
obticesco	to be struck silent
obtineo	to hold fast, have, occupy, possess, preserve, keep, maintain
obtingo	to fall to the lot of, befall, occur
obtrudo	to thrust upon
obtundo	to blunt, weaken, exhaust, make dull
obturbo	to make turbid, disorder, confuse, trouble, disturb
obviam	in the way, towards, against, to meet, in face of
obvius	in the way, so as to meet, meeting, to meet
objecta	
objectus	
objurgo	
occaedes	
occasio	an opportunity, fit time, occasion, convenient season, favorable moment
occepto	
occidium	
occido	
occipio	to begin, commence
occludo	to shut up, close
occoepi	
occulo	to cover, cover over
occulta	
occulto	to hide, conceal, secrete
occultum	
occupatus	taken up, engrossed, absorbed, occupied, employed, busy, engaged
occupo	to take into possession, seize, occupy, master, win
ocior	swifter, fleeter
oculus	an eye
odi	to hate
odiosus	hateful, odious, vexatious, offensive, unpleasant
odium	hatred, grudge, ill-will, animosity, enmity, aversion
offendo	to hit
offertor	
officio	to come in the way of, hinder, oppose, thwart, obstruct
officium	a service, kindness, favor, courtesy
offirmo	to hold fast, persevere
oggannio	
oh	oh! O! ah!
ohe	oh! enough! stop!
oho	
oi	
oleo	to emit a smell, smell of, smell
olfecissem	
olim	at that time, some time ago, once upon a time, once, formerly, of old
omen	a foreboding, prognostic, harbinger, sign, token, omen
omines	
omitto	to let go, let loose, let fall
omlnes	
omne	
omnemi	
omnes	
omnia	
omnino	altogether, wholly, entirely, utterly, at all
omnis	all, every
omniurn	
onero	to load, burden, fill, freight
onmem	
onus	a load, burden
opera	service, pains, exertion, effort, work, labor
operio	to cover, cover over
opero	
opinio	opinion, supposition, conjecture, fancy, belief, expectation
opinor	to be of opinion, suppose, imagine, conjecture, deem, believe, think, judge
opitulo	
opitulor	to bring aid, help, aid, assist, succor
oportet	it is necessary, is proper, is becoming, behooves
opos	
opperibere	
opperibor	
opperior	to wait, attend
oppertus	
oppido	very, very much, completely, exceedingly, exactly, precisely
oppidum	a town, city, collection of dwellings
oppiduni	
oppignero	to give as a pledge, pledge, pawn
oppleo	to fill completely, fill up, fill
oppono	to set against, set before, place opposite, oppose
opportunus	fit, meet, adapted, convenient, suitable, seasonable, opportune
oppositus	
oppressio	a pressing down, suppression, overthrow
opprimo	to press against, press together, press down, close
ops	aid, help, support, assistance, succor
optatum	
optimas	of the best, of the noblest, aristocratic
optime	well, better, best
optimum	
opto	to choose, select, prefer
optume	
opus	work, labor, toil
ora	
oratio	a speaking, speech, discourse, language, faculty of speech, use of language
orator	a speaker, orator
oratum	an entreaty, supplication
orba	
orbo	to deprive, strip, spoil, rob, make destitute
orbus	deprived, bereft, destitute, devoid
ordo	a row, line, series, order, rank
orior	to arise, rise, stir, get up
ornamentum	apparatus, accoutrement, equipment, furniture, trappings
ornatus	
orno	to fit out, furnish, provide, supply, equip, get ready, prepare
oro	to speak
ortus	
os	
oscito	
oscitor	
osculo	
osculor	to kiss
ostendo	to stretch out, spread before, expose to view, show, point out, exhibit, display
ostento	to present to view, show, exhibit
ostentum	a prodigy, wonder, portent
ostium	a door
otes	
otior	to be at leisure, keep holiday
otiosus	at leisure, unoccupied, disengaged, unemployed, idle
otium	leisure, vacant time, freedom from business
otus	
ovis	a sheep
ovo	to exult, rejoice
OCTAVIO	
Oedipus	a king of Thebes, who solved the riddle of the Sphinx
Olera	
Omlnes	
Omphale	
Ora	
Orcus	the Lower World, prison of the dead, Orcus
paciscor	to agree together, bargain, contract, agree, covenant, stipulate, transact
pactum	an agreement, covenant, contract, stipulation, compact, pact
pactus	agreed, settled, determined, covenanted, stipulated
paedagogus	a governor, preceptor, pedagogue
paene	nearly, almost, as I may say
pala	a spade
palaestra	a wrestling school, wrestling-place, place of exercise, gymnasium, palaestra
palam	
pale	
pallium	a cover, coverlet
palma	the palm, flat hand
palmaris	of the palm, superior, excellent
palmarium	
palmarius	of the palm, deserving the prize, excellent
panis	bread, a loaf
pannum	
pannus	a piece of cloth, garment of cloth
papa	
papae	wonderful! strange!
par	equal
pararius	
parasitaster	a sorry parasite
parasitus	a toad-eater, sponge, tuft-hunter, parasite
paratus	
parco	to act sparingly, be sparing, spare, refrain from, use moderately
parcus	sparing, frugal, thrifty, economical, niggardly, stingy, penurious, parsimonious
parens	
parento	to offer a solemn sacrifice in honor of dead kindred
pareo	to appear, be visible, be at hand
pario	to bring forth, bear, give birth, drop, lay, spawn, produce
pariter	equally, in an equal degree, in like manner, as well, as much, alike
parito	
paro	
pars	a part, piece, portion, share, division, section
parsi	
parsimonia	frugality, thrift, parsimony
parta	
particeps	sharing, partaking, participant
participo	to make partaker
partio	to share, part, distribute, apportion, divide
partior	to share, part, distribute, apportion, divide
parturio	to desire to bring forth, be in travail, labor
partus	
parum	too little, not enough, insufficiently
parumper	for a little while, for a short time, a while, a moment
parus	
parvulus	
parvus	little, small, petty, puny, inconsiderable
pasco	to cause to eat, feed, supply with food
pascor	
passum	
passus	
patefacio	to lay open, open, throw open
patefit	
pateo	to stand open, lie open, be open
pater	a father, sire
paternus	of a father, fatherly, paternal
patina	a broad, shallow dish, pan, stewpan
patior	to bear, support, undergo, suffer, endure
patria	a fatherland, native land, own country, native place
patrisso	to take after a father, act the father
patrium	
patrius	
patro	to bring to pass, execute, perform, achieve, accomplish, bring about, effect, finish, conclude
patrocinor	to be a patron, afford protection, defend, support
patrona	a protectress, patroness
patronus	a protector, defender, patron
patruus	
pauca	
pauci	
pauculus	very few, very little
paucus	few, little
paulatim	by little and little, by degrees, gradually
paulisper	for a little while, for a short time
paululum	a little, a very little, somewhat
paululus	very little, very small
paulum	a little, somewhat
paulus	little, small
pauper	poor, not wealthy, of small means
pauperculus	poor, poor little
pauperies	poverty, limited means
paupero	to impoverish, rob, deprive
paupertas	poverty, small means, moderate circumstances
pauxillulum	
pauxillulus	very little
paveo	to be struck with fear, be in terror, tremble, quake with fear, be afraid, be terrified
pavito	to tremble, quake, be fearful
pax	a compact, agreement, treaty, peace, treaty of peace, reconciliation
peccatum	a fault, error, mistake, transgression, sin
peccatus	a failing, fault, trespass
pecco	to miss, mistake, do amiss, transgress, commit a fault, offend, sin
peceatum	
pectus	a breast, breast-bone
pecunia	property, riches, wealth
pedetemptim	step by step, slowly
pedis	
pedisequa	a female attendant, waiting-woman, handmaid
pedisequus	a follower on foot, footman, servant, page, lackey
pedo	to break wind
pedum	a shepherd's crook, sheephook
pellicio	to allure, entice, inveigle, decoy, coax, wheedle
pellitus	covered with skins, clad in skins
pello	to beat, strike, knock, push, drive, hurl, impel, propel
pendeo	to hang, hang down, be suspended
pendo	to suspend, weigh, weigh out
peniculus	a sponge
penis	a tail
penum	
penuria	want, need, scarcity, destitution
per	through, across, through the midst of, from side to side of, traversing
perago	to thrust through, pierce through, transfix
perbenigne	very kindly
percarus	very dear, much beloved
percello	to beat down, throw down, overturn, upset
percio	
percipio	to take wholly, seize entirely, take possession of, seize, occupy
percontatum	
perconto	
percontor	to ask particularly, question strictly, inquire, interrogate, investigate
percontumax	very obstinate, utterly contumacious
percupio	to desire earnestly
percurro	to run, run along, run all the way, run through, hasten through, traverse, run over, pass over
percutio	to strike through and through, thrust through, pierce, transfix
perditor	a ruiner, destroyer
per-do	
perdo	to make away with, destroy, ruin, squander, dissipate, throw away, waste, lose
perdoceo	to teach thoroughly, instruct well
perdoleo	to pain deeply, grieve greatly
perdolesco	to feel great pain, be deeply grieved
perduco	to lead through, lead, bring, conduct, guide
perduro	to last, endure
peregre	abroad, away from home, out of the country
peregrina	
peregrinus	from foreign parts, strange, foreign, exotic, alien
pereo	to pass away, come to nothing, vanish, disappear, be lost
pereurre	
perfector	a finisher, perfecter
perfero	to bear through, bring home
perficio	to achieve, execute, carry out, accomplish, perform, despatch, bring about, bring to an end, finish, complete
perficus	
perfluo	to leak
perfluus	
perfortiter	very bravely
perfringo	to break through, break in pieces, shiver, shatter
perfungor	to fulfil, perform, discharge
pergo	to go on, proceed, press on, hasten, continue, go forward, march, make haste
pergravis	very weighty, highly important
perhibeo	to bring forward, adduce
periculum	a trial, experiment, attempt, test, proof, essay
peril	
perinde	in the same manner, just as, quite as, equally, in like manner, just so
perisson	
perliberalis	very well bred
perlongus	very long
permagnum	
permagnus	very great, vast, immense
permaneo	to stay, hold out, last, continue, abide, be permanent, endure, remain, persist, persevere
permano	to flow to, penetrate, reach
permitto	to let pass, let go, let loose
permultus	very much, very many
pernego	to deny stoutly
pernicies	destruction, death, ruin, overthrow, disaster, calamity, mischief
pernimius	
pernocto	to stay all night, pass the night
pernosco	to examine thoroughly
peropus	very necessary
perparce	very sparingly
perpaucus	
perpello	to drive, urge, force, compel, constrain, prevail upon
perperus	
perpes	
perpetior	to bear steadfastly, suffer firmly, stand out, abide, endure, be patient
perpetuo	
perpetuum	
perpetuus	continuous, unbroken, uninterrupted, constant, entire, whole, perpetual
perplaceo	to please greatly
perplexus	interwoven, entangled, involved, intricate
perpulcher	very beautiful
perquam	as much as possible, extremely, exceedingly
perrepto	to creep over, crawl through
persanctus	
persentisco	to perceive clearly, detect
persequor	to follow perseveringly, follow after, follow up, pursue
persolvo	to unravel, solve, explain
persona	a mask, false face
persono	to sound through and through, resound, fill with sound, reëcho
personus	
perspicax	sharpsighted, penetrating, acute, perspicacious
perspicio	to look through, look into, look at, see through
perstrepo	to make much noise
persuadeo	to convince, persuade
persuasus	fixed, settled
pertendo	to press on, carry out, continue
pertento	
perterrefacio	to frighten thoroughly
perterreo	to frighten thoroughly, terrify
pertimeo	
pertimesco	to be frightened, be alarmed, fear greatly
pertinacia	perseverance, persistence, stubbornness, obstinacy, pertinacity
perturbo	to confuse, disturb, confound, throw into disorder
pervenio	to come up, arrive
pervicax	determined, stubborn, obstinate, headstrong, wilful
pervium	
pervius	that may be crossed, affording a passage, passable, accessible
pervolvo	to roll over, tumble about
pervulgo	
perjurus	
pes	a foot
pessime	badly, wrongly, ill, wretchedly
pessimo	
pessulum	
pessulus	a bolt
pessum	to the ground, to the bottom
pessus	
pestis	an infectious disease, plague, pest, pestilence
petitum	
peto	to strive for, seek, aim at, repair to, make for, travel to
pejoro	
phaleratus	decorated, wearing ornamental plates
phalero	
phasma	an apparition, spectre, phantom
philosophus	philosophical
phormio	
phy	pish! tush!
pictura	painting, the art of painting
pietas	dutiful conduct, sense of duty, religiousness, devotion, piety
pigeo	
pignus	a pledge, gage, pawn, security, guaranty
pingo	to paint, make by painting
piscator	a fisherman, fisher
pisciculus	a little fish
piscis	a fish
pistrilla	a little poundingmill
pistrinum	a corn-mill, poundingmill, mill
pius	dutiful, pious, devout, conscientious, religious
placabilis	to be conciliated, easily pacified, placable
placeo	to please, give pleasure, be approved, be pleasing, be agreeable, be acceptable, suit, satisfy
placidus	gentle, quiet, still, calm, mild, peaceful, placid
placito	
placitum	
placo	to quiet, soothe, assuage, allay, appease
plaga	
plago	
planum	
planus	
platalea	a waterfowl, spoonbill
platea	a broad way, street, avenue
plaudo	to clap, strike, beat
plautus	
plebs	the common people, commons, commonalty, plebeians, folk
plecto	to plait, interweave
plenum	
plenus	full, filled
pleo	
pleraque	
plerus	
ploro	to cry out, wail, lament, weep aloud, weep over, bewail
plumbeus	of lead, leaden
plurimus	most, very much, very many
plusculus	somewhat more, a little more
poena	indemnification, compensation, recompense, retribution, satisfaction, expiation, punishment, penalty, price
poenitebat	
poenitet	
poeta	a poet
poeto	
pol	by Pollux! indeed! truly!
polliceo	
polliceor	to hold forth, offer, promise
pollicitatio	a promising, promise
pollicitor	to promise
pollicitum	a promise, pledge
pollis	
pompa	a solemn procession, public procession, parade
pompo	
pone	
pono	to put down, set down, put, place, set, fix, lay, deposit
populares	
popularis	of the people, proceeding from the people, popular, general, common
populo	to lay waste, ravage, plunder, pillage, spoil
populor	to lay waste, ravage, devastate, spoil, plunder, pillage
populus	
porro	forward, onward, farther on, to a distance, at a distance, afar off, far
porrum	a leek, scallion
porrus	
porta	a city-gate, gate
porticus	a covered walk between columns, colonnade, piazza, arcade, gallery, porch, portico
portitor	
porto	to bear, carry, convey, take
portus	a harbor, haven, port
posco	to ask urgently, beg, demand, request, desire
positus	
possedi	
possideo	to have and hold, be master of, own, possess
possido	to take possession of, occupy, seize
possiem	
possiet	
possum	to be able, have power, can
post	
postea	after this, after that, hereafter, thereafter, afterwards, later
posteriores	
posterius	later, at a later day
posterus	m
posthabeo	to place after, esteem less, postpone, neglect
posthac	after this, hereafter, henceforth, in future
posthaec	hereafter, afterwards
postilla	after that, afterwards
postmodum	after a while, a little later
postputo	to regard as secondary, disregard
postquam	after that, after, as soon as, when
postquami	
postremo	at last, finally, last of all
postridie	on the day after, the next day
postulatio	a requiring, demand, request, desire
postulo	to ask, demand, claim, require, request, desire
potaturus	
potens	able, mighty, strong, powerful, potent
poterion	
poterium	
potesse	
potestas	ability, power, capacity, force
potio	a drinking
potior	to become master of, take possession of, get, obtain, acquire, receive
potis	able, capable
potissimus	
potitus	
poto	to drink
potus	
praccipio	
practermitto	
prae	
praebeo	to hold forth, reach out, proffer, offer, tender
praecaveo	to take care, take heed, use precaution, be on one's guard, beware
praeceps	
praeceptor	a teacher, instructor, preceptor
praeceptum	a maxim, rule, precept, order, direction, command, injunction
praecido	to cut off in front, cut off
praecipio	to take beforehand, get in advance
praecipito	to throw headlong, cast down, hurl down, precipitate
praecipuus	taken before others, particular, peculiar, especial
praecurro	to run before, hasten on before, precede
praedico	
praedictum	something previously said
praeditus	gifted, provided, possessed, furnished
praedium	a farm, estate, manor
praedo	one that makes booty, a plunderer, robber
praeficio	to set over, place in authority over, place at the head, appoint to command
praefinio	to determine beforehand, ordain, prescribe
praefinito	in the prescribed manner
praegnatem	
praegno	
praemium	an advantage, prerogative, favor, license, privilege
praemonstrator	one who points out the way, a guide
praenarro	to tell beforehand
praeopto	to choose rather, desire more, prefer
praepediti	
praepono	to place in front, put upon, affix
praeposita	
praepositus	
praeripio	to snatch away, carry off
praesagio	to feel in advance, perceive beforehand, have a presentiment, forebode
praescio	to know beforehand, foreknow
praescripsti	
praesens	at hand, in sight, present, in person
praesentia	a being at hand, presence
praesentio	to feel beforehand, perceive in advance, have a presentiment of, presage, divine
praesento	
praesertim	especially, chiefly, principally, particularly
praesidero	
praesidium	defence, protection, guardianship, help, aid, assistance
praesidiun	
praestabilis	pre-eminent, distinguished, excellent
praestituo	to determine beforehand, fix in advance, prescribe
praesto	
praestolor	to stand ready for, wait for, expect
praestus	
praeter	
praeterea	in addition, beyond this, further, besides, moreover
praetereo	to go by, go past, pass by, pass
praeterita	
praetermitto	to permit to go by, let pass, let go
praetero	
praeterquam	beyond, besides, except, other than, save
praeut	in comparison with, compared with
prandium	a late breakfast, luncheon
pravitas	crookedness, distortion, deformity
pravus	crooked, distorted, misshapen, deformed
precarium	
precarius	obtained by entreaty, granted to prayer
precator	a suppliant, intercessor
preco	
precor	to ask, beg, entreat, pray, supplicate, request, call upon, beseech, sue
prehendo	to lay hold of, grasp, snatch, seize, catch, take
premo	to press
pretio	
pretium	a price, money value, value in exchange
prex	a prayer, request, entreaty
pridem	long ago, long since, a long time ago
prima	
primarius	first in rank, principal, eminent, distinguished
primo	at first, at the beginning, first, in the first place
primulus	
primus	the first, first
princeps	first in order, foremost
principia	
principio	
principium	a beginning, commencement, origin
prior	former, previous, prior, first
priores	
pristinus	former, early, original, primitive, pristine
privo	to bereave, deprive, rob, strip
pro	
proba	
probo	to make good, esteem good, approve, esteem, commend
probrum	a shameful act, base deed
probrus	
probus	estimable, good, serviceable, excellent, superior, upright, honest, honorable, virtuous
procax	pertinacious, bold, insolent, forward, pert, wanton
procedo	to go before, go forward, advance, proceed, march on, move forward, go forth
proclive	
proclivis	sloping, steep, going downward, downhill
proclivus	
procul	in the distance, at a distance, away, apart, far, afar off, from afar
prodeambulo	to walk abroad
prodeo	to go forth, come forth, come forward
proditor	a betrayer, traitor
prodo	to put forth, exhibit, reveal
produco	to lead forth, lead forward, bring out
pro-eo	
profecto	actually, indeed, really, truly, assuredly, certainly
profectus	advance, effect, increase, profit, success
profero	to carry out, bring forth, produce
proficio	to make headway, advance, make progress, have success, profit, succeed, effect, accomplish
proficisco	
proficiscor	to set forward, set out, start, go, march, depart
profiteor	to declare publicly, own freely, acknowledge, avow, confess openly, profess
profor	to speak out, say, speak
profugio	to flee, run away, escape
profundo	to pour out, pour forth, shed copiously, cause to flow
progenies	descent, lineage, race, family
prognatus	born, descended, sprung
proh	
prohibeo	to hold before, hold back, keep away, check, restrain, hinder, prevent, avert, keep off, debar
proinde	hence, therefore, accordingly, then
prolato	to extend, enlarge
prolixus	well-disposed, obliging, courteous
prologium	
prologus	a preface to a play, prologue
proloquium	
proloquor	to speak out, utter, express, declare, announce
prolubium	desire, inclination, fancy
promereo	to deserve, be deserving of, merit
promereor	to deserve, merit, earn, be worthy
promissum	a promise
promissus	hanging down, long
promitto	to let go, put forth, let hang down, let grow
promoveo	to move forward, cause to advance, push onward, advance
pronus	turned forward, bent over, inclined, leaning, hanging, stooping, bending
prope	near, nigh
propediem	
propemodum	
properenus	
propero	to make haste, hasten, be quick, be in haste, go quickly
properus	quick, speedy, hastening
propino	to drink to one's health, pledge
propinqua	
propinquo	to draw near, come nigh, approach
propinquum	
propinquus	near, nigh, neighboring
propio	
propitius	favorable, well-disposed, gracious, kind, propitious
propius	
proprio	
proprium	
proprius	not common with others, own special, several, individual, peculiar, particular, proper
propter	
propterea	therefore, for that cause, on that account
propulso	to drive back, ward off, repel, repulse
prorsum	forwards
prorsus	forward, right onward
proruo	to rush forth, make an onset, sally
prosa	
prosilio	to leap forward, spring forth, spring up
prospectus	a lookout, distant view, prospect
prosper	
prosperus	according to hope, as desired, favorable, fortunate, prosperous
prospex	
prospexti	
prospica	
prospicio	to look forward, look into the distance, have a view, look out, look, see
prospicus	
prosterno	to strew before, spread out, cast down, throw to the ground, overthrow, prostrate
prosum	fut
protelo	to drive forth, drive away
proterreo	to frighten off, scare away, drive away, affright, terrify
protervio	
protervitas	wantonness, pertness, sauciness, impudence
protervus	pressing forward, violent, vehement
protinam	forthwith, immediately
provideo	to see in advance, discern, descry
provincia	an office, duty, pursuit, charge, business, province
proviso	
provisus	a looking forward, distant view
provoco	to call forth, call out, summon
provolvo	to roll forward, roll along, roll over, overturn
proximi	
proximo	very lately, shortly
proximum	
proximus	the nearest, next
prudens	foreseeing, foreknowing
psaltria	a female player on the cithara, lutist
publicitus	on the public account, at the public expense
publicum	
publicus	of the people, of the state, done for the state, public, common
pucduisse	
pudeo	to be ashamed, feel shame
pudicitia	shamefastness, modesty, chastity, virtue
pudicus	
pudor	a shrinking from blame, desire of approval, shame, shamefastness, modesty, decency, propriety
puella	a female child, girl, maiden, lass
puellula	a little girl, little sweetheart
puer	a male child, boy, lad, young man
puera	
puerilis	boyish, childish, youthful
pueritia	boyhood, childhood, youth
puerpera	
puerperus	parturient, bringing forth children
pugilem	
pugilum	
pugna	a hand-to-hand fight, fight at close quarters, battle, combat, action, engagement
pugno	to fight, combat, give battle, engage, contend
pugnus	a fist
pulcher	beautiful, beauteous, fair, handsome
pulchre	beautifully, excellently, finely, nobly, very
pulchritudo	beauty
pulchrum	
pulpamentum	flesh, animal food, a choice bit, relish, appetizer
pulto	to beat, strike, knock
punctum	a prick, puncture
punctus	
pungo	to prick, puncture
purgatio	a cleansing, purging
purgo	to free from what is superfluous, make clean, make pure, clean, cleanse, purify
puro	
purum	
purus	free from dirt, free from admixture, clean, pure, unstained, unspotted
puteo	to stink
puto	to clean, cleanse, trim, prune
putus	pure, bright, splendid
pytisso	
P	
Pamphila	
Pamphilam	
Pamphilamne	
Pamphilus	
Parmeno	
Parmenone	
Parmenonem	
Parmenonis	
Paros	
Pasibula	
Patrae	
Paulus	
PAMIPHILUS	
PAMPHILA	
PAMPHILLUS	
PAMPHILUS	
PARMENO	
Penates	the Penates, guardian gods of the family, household gods
Perga	
Pergus	
Peril	
Perinthius	
Peta	
Phaedrias	
Phaedrus	
Phania	
Phanio	
Phanium	
Phanocratae	
Phidippus	
Philotis	
Philotium	
Philtere	
Philumema	
Philumena	
Philumenae	
Philumenam	
Phormio	
Phrygia	
Phrygius	Phrygian, of Phrygia
PHAEDR	
PHAEDRIA	
PHIDIPPUS	
PHILOTIS	
PHRYGIA	
Pietas	
Piraeeus	the port of Athens
Plautinus	
Plautius	
Plautus	
Postilla	
POSTUMIO	
Practer	
Preti	
Probus	
Produxe	
Profera	
Promisti	
PRAENEST	
PRAENESTINUS	
PROTHIMUS	
Pyrrhus	
Pythia	
Pythias	
Pythius	
PYHIAS	
PYTHIAS	
qnam	
qua	on which side, at which place, in what direction, where, by what way
quacro	
quadrupedem	
quaerito	to seek earnestly, ask persistently
quaero	to seek, look for
quaesitum	
quaesitus	sought out, select, special
quaeso	to beg, pray, beseech, entreat
quaesti	
quaestus	a gaining, acquiring, gain, acquisition, profit, advantage
quake	
qualis	how constituted, of what sort, of what nature, what kind of a
qualum	
qualus	a wicker basket, work-basket
quam	Relat., in what manner, to what degree, how greatly, how, how much
quamobrem	
quamprimum	
quamquam	though, although, albeit, notwithstanding that
quamvis	as you will, as much as you will, however much, as much as possible, very much, extremely, exceedingly
quando	at what time? when?: Do
quandoquidem	since indeed, since, seeing that
quanquam	
quantivis	
quanto	by how much, by as much as, according as
quantum	as much as, so much as, to as great an extent
quantus	Relat
quapiam	
quapropter	—Interrog., for what, wherefore, why
quaque	
quare	
quasi	as if, just as if, as though
quatio	to shake
quenquam	
queo	to be able, can
queror	to express grief, complain, lament, bewail
qui	
quia	because
quicumque	rel., whoever, whatever, whosoever, whatsoever, every one who, everything that, all that
quidam	a certain, a kind of, as one might say
quidanm	
quidelm	
quidem	assuredly, certainly, in fact, indeed
quiden	
quidum	
quies	a lying still, rest, repose, inaction, freedom from exertion
quiesco	to rest, repose, keep quiet, be inactive, be at peace
quieti	
quietum	
quill	
quin	why not? wherefore not?
quindecim	fifteen
quingenti	
quintus	the fifth
quippe	of course, as you see, obviously, as one might expect, naturally, by all means
quis	plur
quisnam	who then? who in the world? which, I insist? what, pray?
quispiam	any one, anybody, anything, any, some one, something, some
quisquam	indef
quisquami	
quisque	whoever it be, whatever, each, each one, every, everybody, every one, everything
quisquis	rel
quivis	whoever it be, whom you please, any one, any whatever, anything
quo	loci
quoad	as far as
quodam	
quolibet	to any place whatever
quomodo	
quonam	whither pray?
quondam	at some time, at one time, once, heretofore, formerly, on a time
quoniam	since now, since then, since, seeing that, as, because, whereas
quopiam	to any place
quoquam	to any place, in any direction, whithersoever
quoquo	to whatever place, whithersoever
quorsum	to what place, whitherward, whither
quot	how many?
quotidie	
quotiens	how often? how many times?
quovis	to any place whatever, whither you will
qutun	
quummaxime	
Q	
Quamprimum	
Quanquam	
Quicni	
Quill	
Quorsumnam	
Quotidie	
rabio	to rave, be mad
rapio	to seize and carry off, snatch, tear, pluck, drag, hurry away
raptio	an abduction, ravishing, rape
rapum	
rarus	of loose texture, thin, rare, not thick
rastri	
ratio	a reckoning, numbering, casting up, account, calculation, computation
rationein	
ratiuncula	a small reckoning, little account
rea	
recens	
recepto	to take back, wrest away
recido	
recingo	to ungird, loosen, undo
recipero	
recipio	To take back, bring back, carry back, retake, get back, regain, recover
rectum	good, uprightness, rectitude, virtue
recurro	to run back, hasten back, return
recuso	to make an objection against, decline, reject, refuse, be reluctant to do
redactus	
reddo	To give back, return, restore
redeo	to go back, turn back, return, turn around
redigo	to drive back, force back, lead back, bring back
redimo	to buy back, repurchase, redeem
reditio	a going back, coming back, returning, return
reducem	
re-duco	
reduco	imper
re-ducto	
refello	to show to be false, disprove, rebut, confute, refute, repel, expose
refercio	to fill up, stuff, cram
referio	to strike back
re-fero	
refero	to bear back, bring back, drive back, carry back
reflecto	to bend back, turn backwards, turn about, turn away
refrigesco	to grow cold, be chilled
regero	to carry back, bring back, throw back, throw again
regina	a queen
regio	a direction, line
regius	of a king, kingly, royal, regal
regno	to have royal power, be king, rule, reign
regnum	kingly government, royal authority, kingship, royalty
rego	to keep straight, lead aright, guide, conduct, direct, control
reicio	to throw back, fling back, hurl back
relevo	to life up, raise
relictus	
religio	conscientiousness, sense of right, moral obligation, duty
religiosus	conscientious, scrupulous, strict, precise, accurate
relino	to unseal, open
relinquo	to leave behind, not take along, not stay with, leave, move away from
reliqua	
reliquiae	what is left, a remainder, leavings, remains, relics, remnant, rest
reliquum	
reliquus	left, left over, remaining
rellatum	
remedio	
remedior	
remedium	that which restores health, a cure, remedy, antidote, medicine
reminisco	
remissa	
remitto	to let go back, send back, despatch back, drive back, cause to return
remoratus	
remoror	to hold back, stay, detain, obstruct, hinder, delay, defer
removeo	to move back, take away, set aside, put off, drive away, withdraw, remove
renittis	
renumero	to pay back, repay
renunciata	
renuntio	to bring back word, carry tidings back, report, give notice, declare, announce
renuntius	
reor	to reckon, calculate, believe, think, suppose, imagine, judge, deem
repens	predic., suddenly, unexpectedly
repentinus	sudden, hasty, unlooked for, unexpected, impetuous
reperio	to find again, find, meet with, find out, discover
repeto	to fall upon again, attack anew, strike again
repleo	to fill again, refill, fill up
repo	to creep, crawl
reposco	to demand back, ask again
repperis	
reprehendo	to hold back, hold fast, take hold of, seize, catch
reprimo	to press back, keep back, check, curb, restrain, hem in
repudiatus	
repudio	to cast off, put away, reject
repudium	a putting away, dissolution of marriage, divorce
reputo	to count over, reckon, calculate, compute
requiesco	to rest, take rest, repose
requiro	to seek again, look after, search for
res	a thing, object, matter, affair, business, event, fact, circumstance, occurrence, deed, condition, case
resarcio	to patch up, mend, repair, restore
rescindo	to cut off, cut loose, cut down, tear open
re-scio	
rescisco	to learn, find out, ascertain, bring to light
rescribo	to write back, write in return, reply in writing
resisto	to stand back, remain standing, stand still, halt, stop, stay, stay behind, remain, continue
respecto	to look back, look round, gaze about
respicio	to look back, look behind, look about, see behind, look back upon, gaze at, look for
respiro	to blow back, breathe back, breathe out, exhale
respondeo	to answer, reply, respond, make answer
responsum	an answer, reply, response
responsus	
restinguo	to put out, quench, extinguish
restis	a rope, cord
restito	to stay behind, loiter, tarry, hold back, resist
restituo	to set up again, replace, restore, reconstruct, rebuild, revive, renew, reform, rearrange
resto	to withstand, resist, oppose, stand firm, hold out, not yield
resupino	to bend back, turn back
rete	a net
reticeo	to be silent, keep silence
retineo	to hold back, keep back, keep, detain, retain, restrain
retraho	to draw back, withdraw, call back
retro	backward, back, to the rear
retulldam	
re-tulo	
reus	concerned in a thing, party to an action
reverendus	inspiring awe, venerable, reverend
reviso	to look back, look back to see, come back to inquire
reviviscet	
revoco	to call again, call back, recall
revolvo	to roll back, unroll, unwind, revolve, return
revorto	
rex	an arbitrary ruler, absolute monarch, king
rejectus	
rideo	to laugh
ridicula	
ridiculum	
ridiculus	exciting laughter, laughable, droll, funny, amusing, facetious
rimaraum	
ringor	to open the mouth wide, be vexed, chafe, snarl
riscus	a trunk, chest
risus	a laughing, laughter, laugh
rivales	
rivalis	of the same brook, a neighbor, competitor, rival suitor, rival, adversary in love
rogito	to ask eagerly, inquire persistently, keep asking
rogo	to ask, question, interrogate: My
rogum	
rogus	a funeral pile
rubicundus	red, ruddy
rufus	red, reddish
rumor	a rustle, murmur, vague sound
rumpo	to break, burst, tear, rend, rive, rupture, break asunder, burst in pieces, force open
ruo	to fall with violence, rush down, fall down, tumble down, go to ruin
rursum	
rus	the country, lands, fields, a country-seat, farm, estate
rusticus	of the country, rural, rustic, country-
Renunciatum	
Resipisco	
Resipisse	
Rex	
Rhamnusius	
Rhodii	
Rhodius	
Rhodos	
Riecte	
ROMANIS	
sacellum	a little sanctuary, small open place consecrated to a divinity, chapel
sacrifico	to make a sacrifice, offer sacrifice, sacrifice
sacrificor	
sacrilega	
sacrilegus	that steals sacred things, that robs a temple, sacrilegious
saeculum	a race, generation, age, the people of any time
saepe	often, oft, oftentimes, many times, frequently
saepes	a hedge, fence
saepis	
saevidicus	spoken furiously
saevio	to be fierce, be furious, rage, rave
saevitia	fury, fierceness, violence, harshness, savageness, cruelty, barbarity, severity
saevus	raging, mad, furious, fell, fierce, savage, ferocious
salem	
salio	to leap, spring, bound, jump, hop
salo	
salsa	
salsamentum	fish-pickle, brine. —Plur., salted fish, pickled fish
saltabis	
saltem	saved, save, at least, at the least, at all events, anyhow
salum	the open sea, high sea, main, deep
salus	soundness, health, good health, vigor
salutare	
salutaris	of wellbeing, healthful, health-giving, wholesome, salutary
saluto	to greet, wish health, pay respects, salute, hail
salve	well, in good health, in good condition
salveo	to be well, be in good health
salvo	
salvus	
samio	
sancio	to make sacred, render inviolable, fix unalterably, establish, appoint, decree, ordain, confirm, ratify, enact
sanctum	
sanctus	consecrated, established as inviolable, sacred, inviolable
sandalium	a slipper, sandal
sanguis	blood
sannio	one who mimics in mockery, a harlequin, buffoon
sanus	sound, whole, healthy, well
sapa	must, new wine boiled thick
sapiens	wise, knowing, sensible, well-advised, discreet, judicious
sapienter	sensibly, discreetly, prudently, judiciously, wisely
sapientia	good taste, good sense, discernment, discretion, prudence, intelligence, forethought
sapio	to taste of, smack of, savor of, have a flavor of
sat	enough, sufficient, satisfactory, adequate, ample
sata	standing corn, crops
satagit	
satietas	a sufficiency, abundance, adequacy
satio	
satum	
satur	full, sated, having eaten enough
satura	a mixture, hotchpotch
saturo	to fill, glut, cloy, satiate
saxum	a large stone, rough stone, broken rock, bowlder, rock
scaenicus	of the stage, scenic, dramatic, theatrical
scapula	
scapulae	the shoulder-blades, shoulders
scdulo	
scelero	to pollute, defile, desecrate
scelerosus	full of wickedness, vicious, abominable
scelerus	
scelestus	impious, wicked, villanous, infamous, accursed, knavish, roguish
scelus	a wicked deed, heinous act, crime, sin, enormity, wickedness
scibit	
scibo	
scilicet	you may know, you may be sure, it is certain, it is obvious
scio	to know, understand, perceive, have knowledge of, be skilled in
scirpo	
scirpus	a rush, bulrush
sciscitor	to inform oneself, seek to know, ask, inquire, question, examine, interrogate
scissus	rent
scitum	an ordinance, statute, decree, resolution, popular vote
scitus	
scius	
scopulus	a projecting point of rock, rock, cliff, crag, shelf, ledge
scortor	to associate with harlots
scortum	a harlot, prostitute
screatus	a hawking, hemming
scriba	a public writer, official scribe, professional writer, clerk, secretary
scribo	to scratch, grave, engrave, draw
scriptum	something drawn, a space enclosed by lines
scriptura	a writing, written characters
scrupulus	a sharp bit of stone
sectarius	
sector	
secunda	
secundae	
secundo	
secundum	following, by, along, beside
secundus	following, next, second
secus	
sed	but, on the contrary, but also, but even, but in fact
sedecim	
sedeo	to sit
seditio	a going aside, going apart, insurrectionary separation, dissension, civil discord, insurrection, mutiny, sedition
sedo	to bring to rest, lay
seduco	to lead aside, take apart, draw aside, lead away, carry off, set aside, put by
sedulus	persistent, busy, diligent, industrious, zealous, careful, unremitting, solicitous, assiduous, sedulous
se-eo	
segnitiae	
segregatus	
segrego	to separate from the flock
semel	once, a single time
semiper	
semoveo	to move apart, put aside, remove, separate
semper	ever, always, at all times, continually, perpetually, forever
sempiternus	everlasting, everduring, perpetual, continual, imperishable, eternal, sempiternal
senecta	old age, extreme age, senility
senectus	old age, extreme age, senility
seneo	to be old
senex	old, aged, advanced in years
seni	six each
senium	old age, senility, decline
sensa	perceptions, ideas
sensti	
sensus	a perceiving, observation
sententia	a way of thinking, opinion, judgment, sentiment, thought, notion, purpose, determination, decision, will, desire
sentio	to discern by sense, feel, hear, see, perceive, be sensible of
sentus	thorny, rough, rugged
seorsus	
sepelio	to bury, inter
septem	seven
septimus	the seventh
sepulcrum	a place where a corpse is buried, burial-place, grave, tomb, sepulchre
sequor	to follow, come after, follow after, attend, accompany
seria	a cylindrical earthen vessel, large jar, tun, cask
serium	
serius	grave, earnest, serious
sermo	continued speech, talk, conversation, discourse
sermons	
sero	late, at a late hour
serum	
serupulus	
serus	long hence
serva	a female slave, hand-woman, maid
servatrix	she that preserves, a saviour, deliverer
servibo	
servio	to be a servant, be enslaved, serve, be in service
servitium	the condition of a slave, service, slavery, servitude
servitus	the condition of a servant, slavery, serfdom, service, servitude
servo	to make safe, save, keep unharmed, preserve, guard, keep, protect, deliver, rescue
servulus	
servus	
setius	less, in a less degree
severitas	seriousness, gravity, sternness, strictness, severity
severus	serious, sober, grave, strict, austere, stern, severe
sex	six
sexagesimus	the sixtieth
sexa_ginta	
si	if, when, inasmuch as, since
sic	thus, in this way, as I do, as you see
sicine	so? thus? in this way?
sicubi	if in any place, if anywhere, wheresoever
signo	to set a mark upon, mark, mark out, designate
signum	a mark, token, sign, indication, proof
siit	
silentium	a being still, keeping silence, noiselessness, stillness, silence
silentiumr	
sileo	to be noiseless, be still, be silent, keep silence, not speak of, keep silent about, suppress
silesco	to become still, fall silent, grow calm
silicernium	a funeral feast
sill	
simila	
similis	like, resembling, similar
simo	
simplex	simple, single, plain, uncompounded, unmixed
simul	at the same time, together, at once, simultaneously
simulatio	an assumption, false show, feigning, shamming, pretence, feint, insincerity, deceit, hypocrisy, simulation
simulo	to make like, imitate, copy, represent
simultas	a hostile encounter, dissension, enmity, rivalry, jealousy, grudge, hatred, animosity
simulus	
simus	flat-nosed, snub-nosed
sin	if however, if on the contrary, but if
sincerus	clean, pure, sound, uninjured, whole, entire
sine	without
sinister	left, on the left, on the left hand, at the left side
sinistra	
sinistrum	
sino	to let down, set, fix
sinum	a large vessel of earthenware, pot, jar
sinus	a bent surface, curve, fold, hollow, coil
siquidem	
siquis	
sitio	to thirst, be thirsty
sitis	thirst
sive	or if
sobrinus	a cousin by the mother's side, mother's sister's child
sobrius	not drunk, sober
soccus	a low-heeled shoe, light shoe, Grecian shoe, slipper, sock
socer	a father-in-law
socius	
socordem	
socordia	dulness, carelessness, negligence, sloth, laziness, indolence, inactivity
socrus	Masc., a fatherin-law
sodalis	of companions, friendly, companionable, sociable
sodes	if you will, if you please, with your leave, prithee, pray
sol	the sun
solea	a sole, sandal, slipper
soleo	to use, be wont, be accustomed
solertem	
solidum	
solidus	undivided, unimpaired, whole, complete, entire
solitudo	a being alone, loneliness, solitariness, solitude, lonely place, desert, wilderness
solium	a seat, official seat, chair of state, chair, throne
sollicitatio	a vexing, vexation, anxiety
sollicito	to disturb, stir, agitate, move, shake
sollicitudo	uneasiness of mind, care, disquiet, apprehension, anxiety, solicitude
sollicitus	thoroughly moved, agitated, disturbed
solo	
solum	
solus	alone, only, single, sole
solvo	to loosen, unbind, unfasten, unfetter, untie, release
somnio	to dream
somnium	a dream
somnus	sleep
sonitus	a noise, sound, din
sono	to make a noise, sound, resound
sorbilans	
sordeo	to be dirty, be mean, be despised, be unvalued, appear worthless
sordes	dirt, filth, uncleanness, squalor
sordidatus	in dirty clothes, meanly dressed, shabby
sordido	
sordidus	dirty, unclean, foul, filthy, squalid, sordid
sorex	a shrew-mouse
soror	a sister
sors	a lot
spargo	to strew, throw here and there, cast, hurl, throw about, scatter, sprinkle
spatior	to spread abroad, spread out, expand
spatium	a space, room, extent
spectator	a looker-on, beholder, observer, spectator
specto	to look on, look at, behold, gaze at, watch, observe, inspect, attend
speculum	a reflector, lookingglass, mirror
sperno	to separate
spernor	to despise
spero	to hope, look for, trust, expect, promise oneself
spes	hope
spolio	to strip, uncover, bare, unclothe
sponsa	a betrothed woman, bride
sponso	
sponsum	a covenant, agreement, engagement
sponte	
spretus	
squalidus	stiff, rough, dirty, foul, filthy, neglected, squalid
st	hist! whist! hush!
stabilis	firm, steadfast, steady, stable, fixed
statarius	standing fast, standing firm, stationary, steady
statim	steadily, regularly
statuo	to cause to stand, set up, set, station, fix upright, erect, plant
status	
sterno	to spread out, spread abroad, stretch out, extend, strew, scatter
sterquilinium	
sterto	to snore
stilo	
stilus	a pointed instrument
stimulo	to goad, rouse, set in motion, stir, spur, incite, stimulate
stimulus	a prick, goad
stipula	a stalk, stem, blade, halm
stipulus	
sto	to stand, stand still, remain standing, be upright, be erect
stolidus	slow, dull, obtuse, coarse, uncultivated, rude, stupid, stolid
stomachor	to be irritated, be angry, fume, fret
stratum	a covering, horse-cloth, housing, saddle
stratus	prostrate, prone, lying
strenuus	brisk, nimble, quick, prompt, active, vigorous, strenuous
strepitus	a confused noise, din, clash, crash, rustle, rattle, clatter, murmur
stripes	
struo	to place together, heap up, pile, arrange
studeo	to give attention, be eager, be zealous, take pains, be diligent, be busy with, be devoted, strive after, apply oneself, pursue, desire, wish
studiosus	eager, zealous, assiduous, anxious, fond, studious
studium	application, assiduity, zeal, eagerness, fondness, inclination, desire, exertion, endeavor, study
stultitia	folly, foolishness, simplicity, silliness, fatuity
stultus	foolish, simple, silly, fatuous, stupid, dull
stupeo	to be struck senseless, be stunned, be benumbed, be aghast, be astounded, be amazed, be stupefied
stupidus	senseless, confounded, amazed
styrax	
sua	
suadeo	to advise, recommend, exhort, urge, persuade
suasum	
suasus	an advising, persuading
suavio	
suavior	to kiss
suavis	sweet, agreeable, grateful
suavium	a kiss
sub	under, below, beneath, underneath, behind
sub-agito	
sub-cieo	
subditus	
subdo	to put under, set to, apply
subduco	to draw away, take away, lead away, carry off, wrest, withdraw, remove
subduxti	
subeo	to come under, go under, enter
subiice	
subitum	
sublimis	uplifted, high, lofty, exalted, elevated
sublimo	
subolat	
suboleo	to emit a trifling smell
subsensi	
subservio	to serve, come to the help of, aid
subsidium	the troops in reserve, line of reserve, third line of battle, triarii
substerno	to strew under, scatter below, spread beneath
substo	to stand firm, hold out
subtemen	that which is woven in, a woof, weft
subtero	
subtristis	somewhat sad
subvenio	to come to help, aid, assist, reinforce, relieve, succor
subverto	to turn upside down, upset, overturn, overthrow
succeaseo	
succedo	to go below, come under, enter
succenseo	
succenturio	
succurro	to run under, run to help, hasten to the aid of, help, aid, assist, succor
sudo	to sweat, perspire
suffarcino	to stuff full, stuff out below
suffero	to take up, submit to, undergo, bear, endure, suffer
suggero	to bring under, lay beneath, apply below
sui	Reflex
sum	to be, exist, live
summa	the top, summit
summas	
summoneo	
summum	at the utmost, at farthest, at most
summus	uppermost, highest, topmost
sumntum	
sumo	to take, take up, take in hand, lay hold of, assume
sumptus	outlay, expense, cost, charge
sumtibus	
sumtu	
sumtum	
sumtuosa	
sumtus	
sunmus	
suo	to sew, stitch, sew up, sew together
superbia	loftiness, haughtiness, pride, arrogance
superbus	haughty, proud, vain, arrogant, insolent, discourteous, supercilious, domineering
supero	to go over, rise above, overtop, surmount, transcend
supersto	to stand upon, stand over
supersum	to be over and above, be left, remain
superus	that is above, upper, higher
supo	
suppedito	to give in abundance, furnish bountifully, provide, supply freely
supplex	kneeling in entreaty, begging, entreating, humble, submissive, beseeching, suppliant, supplicant
supplicium	a kneeling, bowing down, humble entreaty, petition, supplication
supplico	to kneel down, humble oneself, pray humbly, beseech, beg, implore, supplicate
suppono	to put below, set under
supra	
supremum	for the last time
surdus	deaf
surgo	to rise, arise, get up, stand up
sursum	from below, up, upwards, on high
surtu	
sus	a swine, hog, pig, boar, sow
suscepto	
susceptum	an undertaking
suscipio	to take, catch, take up, lift up, receive
suspecto	to look up at, gaze upon, observe
suspectus	
suspendo	to hang up, hang, suspend
suspicio	
suspiciosus	full of suspicion, mistrustful, ready to suspect, suspicious
suspicor	to mistrust, suspect
sustento	to hold up, hold upright, uphold, support, prop, sustain
sustineo	to hold up, hold upright, uphold, bear up, keep up, support, sustain
susurro	to hum, buzz, murmur, mutter, whisper
suum	
suus	of oneself, belonging to oneself, his own, her own, his, her, its, their
sycophanta	an informer, tale-bearer, backbiter, slanderer
symbola	a contribution to a feast, share, scot, shot
symbolum	
symbolus	
syron	
syrus	
Samia	
Samius	of Samos
Sanga	
Sape	
Sapis	
Satrapes	
SANGA	
SARRANIS	
Scibis	
Scirte	
Sena	
Sentius	
Servius	
Sexcentas	
SEMPRONIO	
Simalio	
Simo	
Simulus	
Singulatim	
Sinis	
Soli	
Sophrona	
Sosia	
Sostrata	
Sostratae	
Sostratam	
SOPHRONA	
SOSIA	
SOSTRATA	
Stephanio	
Stephanium	
Stilpho	
Stilphonem	
Strato	
Stratos	
Sue	
Sumtus	
Sunium	
Supellectile	
Superbus	
Superi	
SULPITIO	
Sy	
Synapothnescontes	a comedy by Diphilus
Syra	
Syri	
Syriscus	
Syrius	
Syros	
Syrunm	
Syrus	
tabesco	to dwindle, waste away, melt, decay
tabula	a board, plank
taceo	to be silent, not speak, say nothing, hold one's peace
tacito	
tacitum	
taciturnitas	a keeping silent, silence, taciturnity
taedet	it excites loathing, disgusts, offends, wearies
talentum	a talent, half a hundred-weight
talis	such, of such a kind, such like, the like
talltum	
talus	an ankle, ankle-bone, pasternbone, knuckle-bone
tam	quam
tamen	notwithstanding, nevertheless, for all that, however, yet, still
tametsi	notwithstanding that, although, though
tamquam	as much as, so as, just as, like as, as if, so to speak: Ge
tandem	at length, at last, in the end, finally
tango	to touch
tanti	
tantilem	
tantillum	
tantillus	so little, so small
tantisper	for so long a time, in the meantime, meanwhile
tanto	
tantopere	so earnestly, so greatly, in so high a degree, so very, so much
tantummodo	
tantundem	just so much, just as much, the same amount
tantus	of such size, of such a measure, so great, such
tardiusculus	somewhat slow, rather stupid
tardus	slow, not swift, sluggish, tardy
tarn	
tarum	
techna	
tectum	a covered structure, roofed enclosure, shelter, house, dwelling, abode, roof
tego	to cover, cover over
tegula	a tile, roof-tile
tegulae	
tegulum	
tela	a web
telum	a missile weapon, missile, dart, spear, shaft, javelin
temerarius	rash, heedless, thoughtless, imprudent, inconsiderate, indiscreet, unadvised, precipitate
temere	by chance, by accident, at random, without design, casually, fortuitously, rashly, heedlessly, thoughtlessly, inconsiderately, indiscreetly
tempero	to observe proper measure, be moderate, restrain oneself, forbear, abstain, be temperate, act temperately
tempestas	a portion of time, point of time, time, season, period
templum	an open place for observation, place marked off by the augur's staff
tempus	
temulentus	drunk, drunken, intoxicated, tipsy
tenax	holding fast, griping, tenacious
tendo	to stretch, make tense, stretch out, spread out, distend, extend
tenebra	
tenebrae	darkness, gloom
teneo	to hold, keep, have, grasp, hold fast
tener	soft, delicate, tender, yielding
tento	
tenue	
tenuis	drawn out, meagre, slim, thin, lank, slender
tenuiter	thinly
tergeo	to rub off, wipe off, wipe dry, wipe clean, cleanse
tergum	the back
tero	to rub, rub away, wear away, bruise, grind, bray triturate
terra	the earth
terreo	to frighten, affright, put in fear, cause to dread, alarm, terrify, scare, dismay
territo	to put in terror, frighten, affright, alarm, terrify
tertio	for the third time
tertius	the third
tes	
tessera	a die, cube
testa	a piece of burned clay, brick, tile
testimonium	witness, evidence, attestation, testimony
testis	
testo	
testor	to cause to testify, call as a witness, invoke, appeal to
texebat	
thesaurus	something laid up, a hoard, treasure, provision, store
tias	
tibia	a large shin-bone, tibia, shin, leg
tibicina	a female flute-player
tibicino	
tibinus	
tilio	
timeo	to fear, be afraid, be fearful, be apprehensive, be afraid of, dread, apprehend
timidus	fearful, afraid, faint-hearted, cowardly, timid
timor	fear, dread, apprehension, timidity, alarm, anxiety
titubo	to stagger, totter, reel
to	
tolerabilis	that may be borne, supportable, endurable, passable, tolerable
tolero	to bear, endure, support, sustain, suffer
toleror	
tollo	to lift, take up, raise, elevate, exalt
tonstrina	
tonstrinum	
tot	so many, such a number of
toties	
totus	all, all the, all at once, the whole, entire, total
tracto	to draw violently, drag, tug, haul, pull
traditor	a betrayer, traitor
traditus	
trado	to give up, hand over, deliver, transmit, surrender, consign
traduco	
traho	to draw, drag, haul, train along, draw off, pull forth, drag away
tranquillissima	
tranquillo	
tranquillum	
tranquillus	quiet, calm, still, tranquil
transactum	
transcurro	to run over, run across, go by, pass
trans-do	
transeo	perf
transfero	to bear across, bring through, carry over, convey over, transport, transfer
transigo	to drive through, stab through, pierce through, transfix, transpierce
transitor	
transmoveo	to remove, transfer
tremo	to shake, quake, quiver, tremble
tremulus	shaking, quaking, quivering, trembling, tremulous
trepido	to hurry with alarm, be in confusion, be agitated, be disturbed
trepidus	restless, agitated, anxious, solicitous, disturbed, alarmed, in trepidation
tres	three
tribula	
tribulis	a fellow tribesman
tribulum	a threshingsledge, wooden platform studded with iron teeth
tribulus	
triduum	three days' time, three days
triennia	a festival held every three years, triennial festival
triennis	
triennium	three years' time, three years
triginta	thirty
triste	sadly, sorrowfully
tristis	sad, sorrowful, mournful, dejected, melancholy, gloomy, downcast, disconsolate
tristitia	sadness, mournfulness, sorrow, grief, melancholy, gloom, dejection
triumpho	to march in triumphal procession, celebrate a triumph, triumph
triumphus	a triumphal procession, triumph, celebration of victory by a public entrance into Rome
truculentus	savage, fierce, ferocious, stern, grim, harsh, cruel, fell
trudis	a pointed pole, pike
trudo	to thrust, push, shove, crowd forward, press on, drive, impel
tu	thou, you
tuber	a lump, bump, swelling, tumor, protuberance, hump
tueor	to look at, gaze upon, behold, watch, view, regard, consider, examine
tulo	
tum	then, at that time, in those times
tumulti	
tumultuarius	bustling, hurried, confused, irregular, disorderly
tumultuor	to make a disturbance, be in confusion
tumultus	an uproar, bustle, commotion, disturbance, disorder, tumult, panic
tunc	then, at that time, just then, on that occasion
tundo	to beat, strike, thump, buffet
turba	a turmoil, hubbub, uproar, disorder, tumult, commotion, disturbance
turbo	
turpe	
turpis	ugly, unsightly, unseemly, repulsive, foul, filthy
turpiter	in an unsightly manner, repulsively
tussio	to cough, have a cough
tussis	a cough
tutela	a watching, keeping, charge, care, safeguard, defence, protection
tuto	safely, securely, in safety, without danger
tutor	
tutum	
tuus	thy, thine, your, yours
T	
Tacitus	
Tantundem	
Tem	
Tenos	
Tercle	
Testitum	
Texentem	
Thais	
Thraso	
THAIS	
THRASO	
Tur	
TURPIO	
uber	
ubi	Relat., in which place, in what place, where
ubicumque	—Relat., wherever, wheresoever
ubivis	where you will, be it where it may, wherever it may be, anywhere, everywhere
ulciscor	to avenge oneself on, take vengeance on, punish, recompense
ulcus	a sore, ulcer
ullus	negation
ulter	
ulterior	farther, on the farther side, that is beyond, more remote
ultima	
ultimi	
ultimo	
ultimum	finally, for the last time
ultro	to the farther side, beyond, on the other side
umerus	the upper arm, shoulder
umquam	at any time, ever
unciatim	by twelfths, by ounces
unctum	a rich banquet, savory dish
unctus	anointed, oiled
unde	Relat., from which place, whence
undo	to rise in waves, throw up waves, surge, swell
ungo	to smear, besmear, anoint
unguento	
unguentum	an ointment, unguent, perfume
unguis	a nail
unicus	only, sole, single, singular, unique
universi	
universum	
universus	all together, all in one, whole, entire, collective
uno	
unqualm	
unquam	
unumquicquid	
unus	One, a single
urbanus	of the city, of the town, in the city, in Rome
urbs	a walled town, city
uro	to burn
uspiam	at any place, anywhere, somewhere
usquam	at any place, anywhere
usque	all the way, right on, without interruption, continuously, even
usus	use, practice, employment, exercise, enjoyment
ut	
utcumque	at whatever time, whenever
uter	
uterus	the womb, matrix
uti	
utibilis	to be used, fit, appropriate, useful, serviceable
utile	
utilis	useful, serviceable, beneficial, profitable, advantageous, expedient, to good purpose
utilitas	use, usefulness, utility, serviceableness, service, expediency, benefit, profit, advantage, welfare
utinam	oh that! I wish that! if only! would to heaven! would that!
utitor	
uto	
utor	to use, make use of, employ, profit by, take advantage of, enjoy, serve oneself with
utramvis	
utrum	ne
utut	however, in whatever manner
uxor	a wife, spouse, consort
uxorein	
uxorium	
uxorius	of a wife, of a married
Ubius	
Uniusmodi	
Unlde	
vacivus	
vacuum	
vacuus	empty, void, unoccupied, vacant, free, clear, devoid of, without
vado	to go, walk, go hastily, proceed rapidly, rush
vadum	a shallow place, shallow, shoal, ford
vae	ah! alas! woe!
vagio	to cry, squall, scream
vah	ah! oh!
valeo	to be strong, be vigorous, have strength, be able
validus	strong, stout, able, powerful, robust, vigorous
vanitas	emptiness, aimlessness, absence of purpose
vanum	emptiness, nothingness, naught
vanus	containing nothing, empty, void, vacant
vapulo	to get a cudgelling, be flogged
varia	
vario	to diversify, variegate, change
varius	variegated, party-colored, mottled, diverse, various
vecordia	want of reason, senselessness, silliness, folly, madness, insanity
vectis	a strong pole, bar, lever
vehemens	eager, violent, furious, impetuous, ardent, vehement
vehementer	eagerly, impetuously, ardently, violently, earnestly, vehemently
veho	to bear, carry, convey, draw
vel	
vela	
vello	to pluck, pull, tear away, pull out
velum	that which propels, a sail
vena	a blood-vessel, vein
vendo	to sell, vend
venefica	a poisoner, sorceress, witch
veneficus	poisoning, poisonous, sorcerous, magic, magical
venia	indulgence, kindness, grace, favor
venio	to come
venor	to hunt, chase
venter	the belly, paunch
ventulus	a little wind, breeze
ventus	wind
venum	that which is sold, that which is for sale, sale
venus	loveliness, attractiveness, beauty, grace, elegance, charm
venustas	loveliness, comeliness, charm, grace, beauty, elegance, attractiveness
venusto	
venustus	charming, pleasing, winning, agreeable, beautiful
verbena	a leafy twig, olive-branch, sacred bough
verbenae	
verber	a lash, whip, scourge, rod
verbero	
verbium	
verbum	a word
verecundus	ashamed
vereor	to reverence, revere, respect, stand in awe
verisimile	
verisimilia	
veritas	truth, truthfulness, verity, reality
vero	in truth, in fact, certainly, truly, to be sure, surely, assuredly
verro	to sweep, brush, scour, sweep out, sweep together
verso	to turn often, keep turning, handle, whirl about, turn over
versor	
versura	a conversion, funding, borrowing to pay a debt
versus	
verto	to turn, turn up, turn back, direct
verum	
verumtamen	
verus	true, real, actual, genuine
vesperascit	
vesperus	
vester	your, yours, of you
vestimentum	clothing, a garment, vestment, article of clothing, dress
vestio	to cover with a garment, provide with clothing, dress, clothe, vest
vestis	collect., a covering for the body, clothes, clothing, attire, vesture
vestitus	clothing, clothes, dress, apparel, raiment, attire, vesture
veterator	one wedded to routine, a commonplace orator
veteres	
veternosus	lethargic, sleepy, drowsy, dreamy
vetero	
vetitum	that which is forbidden, something prohibited, a forbidden thing
veto	not to suffer, not to permit, to oppose, forbid, prohibit
vetus	old, aged, advanced in years
via	a way, highway, road, path, street
vicet	
vicina	
vicinia	neighborhood, nearness, vicinage, vicinity
vicinitas	neighborhood, nearness, proximity, vicinity
vicinum	
vicinus	of the neighborhood, near, neighboring, in the vicinity
vicis	change, interchange, alternation, succession, vicissitude
vicissim	on the other hand, on the contrary, again, in turn, back
vicissitudo	change, interchange, alternation, vicissitude
victito	to live, subsist
victus	that which sustains life, means of living, sustenance, nourishment, provisions, victuals
videlicet	one may see, it is evident, clearly, obviously, plainly, evidently, manifestly, naturally, of course
videns	
video	to see, discern, perceive
vidua	an unmarried woman
viduus	deprived, bereft, destitute, without
vigil	awake, on the watch, alert
vigilantia	wakefulness
vigilo	to watch, keep awake, not to sleep, be wakeful
viginti	twenty
vilis	of small price, of little value, purchased at a low rate, cheap
vilitas	lowness of price, cheapness
vilito	
villa	a country-house, country-seat, farm, villa
villum	a sup of wine
villus	a tuft of hair, shaggy hair, wool, fleece
vincibilis	to be gained, easily maintained
vincio	to bind, bind about, fetter, tie, fasten, surround, encircle
vinco	to conquer, overcome, get the better of, defeat, subdue, vanquish, be victorious
vinctus	
vines	
vinolentus	full of wine, drunken with wine, tipsy, intoxicated
vinum	wine
vinus	
vio	
violens	impetuous, furious, violent
violenter	impetuously, furiously, passionately, vehemently, violently
violentus	forcible, violent, vehement, impetuous, boisterous
vir	a male person, adult male, man
vira	
virgo	a maid, maiden, virgin
virilis	of a man, like a man, manly, masculine, virile
virtus	manliness, manhood, strength, vigor, bravery, courage, excellence
virus	a potent juice, medicinal liquid, poison, venom, virus
vis	strength, force, vigor, power, energy, virtue
viso	to look at attentively, view, behold, survey
visum	a thing seen, sight, appearance, vision
visus	a looking, look, act of seeing, power of sight, vision
vita	life
vitio	to make faulty, injure, spoil, mar, taint, corrupt, infect, vitiate, defile
vitis	a vine, grape-vine
vitium	a fault, defect, blemish, imperfection, vice
vito	to shun, seek to escape, avoid, evade
vitupero	to inflict censure, find fault with, blame, censure, reproach, disparage, vituperate
vivo	to live, be alive, have life
vivum	
vivus	alive, living, having life
vix	with difficulty, with much ado, hardly, scarcely, barely
vocabulum	an appellation, designation, name
voco	to call, summon, invoke, call together, convoke
vola	
volo	a volunteer
voluntas	will, free-will, wish, choice, desire, inclination
volup	agreeably, delightfully, satisfactorily
volupe	
voluptas	satisfaction, enjoyment, pleasure, delight
volvo	to cause to revolve, roll, turn about, turn round
voro	to swallow whole, swallow up, eat greedily, devour
voveo	to vow, promise solemnly, engage religiously, pledge, devote, dedicate, consecrate
vox	a voice, sound, tone, utterance, cry, call
vulgo	
vulgus	
vulnero	
vulnus	
vultus	
vus	
VALERIO	
Venus	
Virmn	
Vixdum	
Vol	
zamia	
jacio	
jactus	
jam	
jamdudum	
jampridem	
janua	
jocor	
jocularia	
jocularis	
jocularius	
jocus	
jubeo	
judex	
judicium	
judico	
jugulo	
jugulum	
jugulus	
junceus	
jungo	
jurandum	
jurgium	
jurgo	
juro	
juror	
jus	
jussum	
jussus	
justa	
justitia	
justitium	
justum	
justus	
juvo	
Juno	
