a	from, away from, out of
ab	
a-baco	
abacorum	
abacus	a table of precious material for the display of plate
abax	
abduco	to lead away, take away, carry off, remove, lead aside
abicio	to throw from one, cast away, throw away, throw down
abiegnei	
abiegnus	of fir-wood, deal
abies	the fir-tree, silver-fir
abscedo	to give way, go off, move away, retire, withdraw, depart
absento	
absolvo	to set free, release, discharge
abstantia	
abstemius	abstaining from drink, temperate, abstemious, moderate
absto	to stand off
abstrudo	to thrust away, push into concealment, hide, conceal
absum	to be away from, be absent
abundantia	plenty, fullness, abundance
abunde	in profusion, more than enough, abundantly, amply
abundo	to overflow, stream over
abundus	
acanthus	bear's-foot
accedo	sync
accendo	to kindle, set on fire, light
accenseo	to reckon to, count among
accessus	a coming near, approach
accido	
accipio	to take without effort, receive, get, accept
accommodo	to fit, adapt, put on, apply
accumbo	to lay oneself down, lie beside
aceo	
acer	
acervatim	by heaps, in heaps
aceto	
acetum	vinegar
acide	
acidus	sour, acid, tart
acieris	
acies	a sharp edge, point, cutting part
acriter	sharply, fiercely
acritudo	
acroasis	a hearing
acrobatae	
acrolithus	
acroteria	
acta	the sea-shore, sea-beach
actio	a putting in motion
actor	a driver
actum	a deed, transaction, proposition, decree, law
actus	a driving, impulse, setting in motion
aculeus	a sting
acumen	a point
acuo	to sharpen, whet, point, make sharp
acutus	sharpened, pointed, sharp, cutting
ad	to, toward
adaugeo	to increase by adding, augment
ad-cresco	
addo	to put to, place upon, lay on, join, attach
adduco	to lead to, bring to, bring along
ad-emo	
adeo	
adepta	
adepti	
ad-eximo	
adfixa	
ad-glutino	
adhaeresco	to cleave, stick, adhere
adhibeo	to hold toward, turn to, apply, add to
adhuc	
adicio	to throw to, cast to, fling at, put, put to, set near
adigo	to drive, urge, bring by force, take
adimo	to take away, take from, deprive of
aditus	a going to, drawing near, approach, access
administratio	aid, help, co-operation
administro	to manage, control, guide, superintend, execute, regulate, rule, direct
admirandus	to be wondered at, admirable, wonderful
admiratio	admiration, wonder
admiror	to regard with wonder, admire
admisceo	
admixtus	
admodum	to the proper limit, to full measure
admoveo	
adnato	to swim up
adopto	to take by choice, select, choose, adopt
adorno	to provide, furnish, fit out, equip, make ready
ad-probo	
ad-rogo	
ad-sequor	
ad-signo	
adsum	to be at, be present, be at hand
ad-sumo	
adulescens	growing, near maturity, young, youthful
adumbratio	a sketch, outline
aduro	to set on fire, kindle, scorch, parch, burn, singe
adusta	
adveho	
advenio	to come to, reach, arrive at
adventus	a coming, approach, arrival
adverro	
adversa	
adversarius	opposite, hostile, contrary
adverso	
adversum	misfortune, calamity, disaster
adversus	an enemy, opponent
adverto	to turn to, turn towards, direct
adjectio	
adjectus	
adjicio	
adjuncta	
adjungo	
adjutrix	
aedes	
aedicula	a small temple, chapel, niche
aedificatio	the process of building
aedificator	a builder
aedificium	a building, edifice, structure
aedifico	to build, erect a building
aedilis	a commissioner of buildings, aedile, magistrate for public works
aedilitas	the office of an aedile, aedileship
aedium	
aediumque	
a-edo	
aeger	unwell, ill, sick, diseased, suffering, feeble
aegroto	to be sick, languish, pine
aegrum	
aegyptii	
aegyptiis	
aegyptios	
aeneus	
aeoli	
aeolis	
aequalis	equal, like, even, on a par
aequalitas	equality, similarity, likeness
aequaliter	evenly, equably
aeque	equally, in like manner, just as, in an equal degree, to the same extent
aequilatatio	
aequilibris	
aequinoctialis	equinoctial
aequinoctium	the equinox
aequipondium	
aequo	to make equal, equalize
aequum	a plain, level
aequus	even, plain, level, flat
aer	the air, atmosphere, sky
aera	
aeracius	
aeraria	a mine
aerarium	part of the temple of Saturn at Rome, in which the public treasure was kept, the treasury
aerarius	
aereum	
aereus	of copper, of bronze
aero	
aeruca	
aerugo	rust of copper, verdigris
aesculinus	
aesculus	the Italian oak
aestas	summer
aestimatio	the determination of value, value, valuation, appraisement
aestimo	to determine the value of, estimate, value, rate, appraise
aestiva	a summer camp, summer resort
aestivo	
aestivus	of summer, as in summer, summer-like, summer
aestuarium	a tract overflowed at high tide, salt marsh
aestuosus	burning hot, glowing
aestus	an agitation, glow, heat, rage of fire
aetas	the life of man, age, lifetime, years
aeternitas	eternity, endlessness, immortality
aeterno	to perpetuate, immortalize
aeternus	of an age, lasting, enduring, permanent, endless
aether	the upper air, sky, firmament
aevum	neverending time, eternity
affero	
affigo	
affluo	
africum	
africus	
ager	productive land, a field, farm, estate, arable land, pasture
agger	a mass, heap, collection, pile
aggeratio	
aggero	to make a mound of, heap up, pile
agitatio	movement, motion, agitation
agitatus	
agito	to set in violent motion, drive onward, move, impel, urge
agmen	that which is driven
agnosco	
ago	to put in motion, move, lead, drive, tend, conduct
agrammatus	
agrestis	
agricola	a husbandman, agriculturist, ploughman, farmer, peasant
agrius	
aio	to say yes, assent, affirm
ala	a wing
alba	
albarius	
albidus	whitish, white
albulus	whitish
album	white color, whiteness
albus	white
alga	sea-weed
alia	
alias	at another time, some other time, at other times
alieno	to make strange, make another's, transfer, make over, part with
alienum	the property of a stranger, another's possessions
alienus	
alimentum	nourishment, nutriment, aliment
alio	to another place, to another, elsewhere
aliqua	by any way, in any direction, any whither
aliqui	some, any
aliquis	any end
aliquo	to some place, somewhere, anywhither
aliter	in another manner, otherwise, in any other way, differently
alius	another, other, different
allecto	
alligatio	
alligo	
allium	
alneus	
alnus	the alder
alo	to feed, nourish, support, sustain, maintain
altanus	
alter	one, another, the one, the other
alternus	one after the other, alternate, in turn, reciprocal
altitudo	height, altitude
alto	
altum	
altus	nourished, grown great, high, lofty, tall
alum	
alumen	
aluminosus	
alus	
alveolatus	
alveolus	a tray, trough, basin
alveus	a hollow, cavity, excavation
alvus	the belly, paunch, bowels, womb
amaritas	
amariter	
amarus	bitter, pungent
amaxopodes	
ambitio	a going about
ambitus	a going round, moving about, revolution
ambiundo	
ambiunt	
ambiuntur	
ambulatilis	
ambulatio	a walking about, walk
ambulatorius	
ambulo	to walk, walk about, take a walk
amentia	want of reason, madness, senselessness
amica	a female friend
amicus	
amitto	to send away, dismiss, part with
amnis	a river
amo	to love
amolcie	
amphiprostylos	
amphithalamos	
amphitheatrum	an amphitheatre, oval building for public spectacles
amplector	to twine around, encircle, encompass, embrace
amplificatio	an extending, enlarging
amplifico	to broaden, extend, enlarge, increase, make wide, give space to
amplio	to widen, extend, increase, enlarge, amplify
amplitudo	wide extent, width, amplitude, breadth, size, bulk
amplo	
amplus	of large extent, great, ample, spacious, roomy
amusium	
amusos	
an	or
analemmatorum	
analemmatos	
anaphoricus	
anatonus	
ancon	
andronas	
andronitis	
angiportum	
angiportus	
anguis	a serpent, snake
angularis	
angulo	
angulus	an angle, corner
angustia	narrowness, straitness
angustiae	
angustio	
angusto	to make narrow, straiten
angustum	a narrow place
angustus	narrow, strait, contracted
aniatrologetus	
anima	air, a current of air, breeze, breath, wind
animadversio	investigation, inquiry
animadverto	to direct the mind, give attention to, attend to, consider, regard, observe
animal	a living being, animal
animalis	of air, aerial
animo	
animosus	
animus	the rational soul
anisocycla	
anniversarius	returning every year, annual, yearly
anno	
annus	a year
ansa	a handle, haft
antae	
antarius	
ante	before, in front, forwards
antea	before, earlier, formerly, aforetime, previously
antecurro	
antefixus	fastened before
antelucanum	
antelucanus	before light, before dawn
antemeridianus	before mid-day, of the forenoon
antenna	
antepagmentum	
antequam	
anterides	
antes	rows
antibasis	
antiboreus	
antiqui	
antiquitas	age, antiquity
antiquitus	in former times, of old, anciently, long ago
antiquo	to reject, not to pass
antiquum	
antiquus	ancient, former, of old times
anularius	a maker of rings
anulus	a ring, finger-ring, seal-ring, signet-ring
aperio	to uncover, lay bare
aperto	
apertum	
apertura	
apertus	without covering, uncovered
apophysi	
apotheca	a repository, storehouse, magazine, warehouse
apothesim	
appagineculi	
apparatio	a preparing
apparationem	
apparationes	
apparatus	
apparentia	
appareo	to appear, come in sight, make an appearance
appario	
apparitio	a serving, service, attendance
appellatio	an addressing, accosting
appello	
appendo	to weigh out
applico	to join, connect, attach, add
apportatio	
apporto	to carry, convey, bring along
appropinquo	to come near, approach, draw nigh
apricum	
apricus	exposed to the sun, warmed by sunshine, sunny
apte	closely, fitly, suitably, rightly
apto	to adapt, fit, apply, adjust
aptus	fastened, joined, fitted, bound, attached
apud	
aqua	water
aquarium	
aquarius	of water, watery
aquatilis	living in water, aquatic
aquila	an eagle
aquilo	the north wind
aquilonalem	
aquilus	
ara	a structure for sacrifice, altar
arachnen	
a-rado	
araeostylis	
araeostylo	
araeostylos	
aratro	
aratrum	a plough
arbiter	a spectator, beholder, hearer, eye-witness, witness
arbitrium	a judgment, decision of an arbitrator
arbitror	to testify on information and belief, depose to one's best knowledge
arbor	
arbuscula	
arbustivus	
arbustum	a place where trees are planted, plantation, vineyard planted with trees
arbustus	set with trees
arca	a place for safe-keeping, chest, box
arceo	to shut up, enclose
architecta	
architectandum	
architectata	
architectatus	
architectent	
architectonice	
architectonicus	
architectura	the art of building, architecture
architectus	a masterbuilder, architect
arctos	
arctous	
arcturus	the brightest star in Boötes
arcula	a small box, casket
arculum	
arcus	a bow
ardeo	to be on fire, burn, blaze, be burned
ardor	a burning, flame, fire, heat
area	ground
areae	
arearum	
arefacio	
areis	
areo	to be dry, be parched
aresco	to become dry, dry up
argentaria	
argentarius	of money
argenteus	of silver, made of silver
argentifodina	
argentum	silver
argestes	the west-southwest wind
argilla	white clay, potter's earth, marl
argumentatio	a proving, reasoning
argumentum	an argument, evidence, ground, support, proof
aridum	
aridus	dry, arid, parched
aries	a ram
arietarius	
ariete	
arieti	
arietis	
arieto	to strike violently, ram
ariis	
aris	
arithmeticus	
arma	implements, outfit, instruments, tools
armamentarium	an arsenal, armory
armarium	a closet, chest, safe
armatus	
armenium	
armenta	
armentum	cattle for ploughing
armiger	one who bears arms
armilla	a bracelet, armlet, armsing
armillum	
armo	to furnish with weapons, arm, equip
armus	the shoulder
aro	to plough, till
aron	
aros	
arrectarius	
arrogantia	
ars	practical skill
artemisia	
artemon	
arteriace	
arteriacus	
articulo	
articulus	a joint, knuckle
artifex	a master of an art, professional man, artist, artificer
artificiosus	full of skill, skilful, artistic
artificium	a profession, trade, employment, art
artio	
artius	
arto	to contract, straiten
artum	
artus	
arx	a castle, citadel, fortress, stronghold
as	one, a whole, unity
ascendo	to mount, climb, ascend, scale, go up
ascensio	a rising
ascensus	a climbing, ascent
ascia	
ascio	to receive, adopt, select
ascius	
asia	
aspectus	a seeing, looking at, sight, view, glance, look
asper	without hope, adverse, calamitous, troublesome, cruel, perilous
aspergo	
asperitas	unevenness, roughness
asperum	
aspicio	to look at, look upon, behold, look
asser	a stake, post
assero	
assiduitas	
assis	
asso	
assula	
assum	
assus	roasted
astragalus	
astrologia	the science of the heavenly bodies, astronomy
astrologus	an astronomer
astrum	a heavenly body, star, constellation
asty	
a-sum	
at	but, but on the other hand, but meanwhile
ater	black, coal-black, gloomy, dark
athleta	a wrestler, athlete, combatant in public games
atomus	an indivisible particle, atom
atque	and, as well as, together with
atramentum	a black liquid
atrium	a room which contains the hearth, fore-court, hall, principal room
attempero	
attendo	to stretch toward, direct
attica	
attici	
atticum	
atticurges	
attingo	to touch, come in contact with
attollo	to lift up, raise up, raise, elevate
attribuo	to assign, allot, make over
attributum	an attribute, predicate
aucto	to increase much, prosper
auctor	a promoter, producer, father, progenitor
auctoritas	origination, production
auctoro	to bind, oblige
auctumnalis	
auctumnus	
auctus	
audacia	daring, courage, valor, bravery, boldness, intrepidity
audax	daring, bold, courageously, spirited
audeo	to venture, dare, be bold, dare to do, risk
audio	to hear
auditio	a hearing, listening to
auditor	a hearer, auditor
auditus	the hearing, sense of hearing
aufero	to take away, bear off, carry off, withdraw, remove
augeo	to increase, augment, enlarge, spread, extend
augustus	consecrated, sacred, reverend
aula	a court, fore-court, yard
aura	the air
aurea	
aureus	of gold, golden
auriga	a charioteer, driver
aurigo	
auripigmentum	
auris	the ear
auro	
aurum	gold
auster	the south wind
austrinus	southern
ausus	
aut	or
autem	but, on the other hand, on the contrary, however
automatopoetasque	
autor	
autumnum	
auxilia	
auxilio	
auxilior	to give help, aid, assist, succor
auxilium	help, aid, assistance, support, succor
avaritia	inordinate desire, greed, avarice, covetousness
aversum	
averto	to turn away, avert, turn off, remove
avia	a grandmother
avis	a bird
avium	
avius	out of the way, remote, trackless, untrodden
avoco	to call off, call away
avus	a grandfather
axiculus	
axis	an axle, axle-tree
axon	
axona	
Abderita	
Abderites	
Achaia	
Achaius	Grecian
Adriaticum	
Aedium	
Aegyptius	Egyptian
Aegyptus	
Aequiculus	
Aeschylus	
Aesculapium	
Aesculapius	
Aethiopia	
Aethiopus	
Aetna	
Aetne	
Africa	
Africanus	
Afrique	
Afrorum	
Agatharchus	
Agesilaus	
Agesistratos	
Alabanda	
Alabandei	
Alabandeus	
Albana	
Albanus	
Albula	old name of the Tiber
Alexa	
Alexander	
Alexandrea	
Alexandrinus	
Alexis	
Alii	
Alis	
Alius	
Allia	
Alpis	
Altinum	
Altinus	
Amiterninus	
Ammon	
Amyntas	
Anaxagoras	
Ancona	
Andria	
Andrius	
Androcydes	
Andromeda	
Andronicus	
Anicianus	
Anteridon	
Antimachides	
Antiochus	
Antipater	
Antistates	
Apaturius	
Apelles	
Apenninus	
Apollo	Apollo
Apollonia	
Apolloniatibus	
Apollonius	
Appulia	
Aquileia	
Aquilianus	
Aquitania	
Arabia	
Arabius	
Aratus	
Araus	
Arcadia	
Arcadius	
Arcesius	
Archimedes	
Archytas	
Ardeatinus	
Areopagus	Mars' Hill at Athens, on which the highest court sat
Areuanias	
Argi	the Argives, Greeks
Argo	
Argus	
Ariobarzanes	
Aristarchus	
Aristides	
Aristippus	
Aristomenes	
Aristophanes	
Aristoteles	
Aristoxenus	
Arretium	
Arsinoes	
Artemisia	
Artemisium	
Asia	
Asius	
Astansobam	
Astoboam	
Athenae	Athens
Athenienses	
Atheniensis	
Athenodorus	
Athos	
Atlantis	
Atlas	
Atrius	
Attalica	
Attalicus	of Attalus
Attalus	
Attica	
Attice	
Attici	
Atticurge	
Atticus	Athenian, Attic
Attius	
Augustus	a cognomen given to Octavius Caesar as emperor, his majesty
Aurelius	
Aventinum	
Aventinus	
b	
baca	a small round fruit, berry
baco	
balinea	
balinearum	
balineis	
balineum	
ballista	an engine for hurling
balnea	
balneae	
balnearia	
balnearis	
balnearius	of baths, at baths
balneum	
balteum	
balteus	
barathrum	an abyss, chasm, gulf, pit
barbaricum	
barbaricus	foreign, strange
barbarum	
barbarus	of strange speech, speaking jargon, unintelligible
barycephalus	
basem	
baseos	
basilica	a portico, basilica
basilicon	
basilicum	
basilicus	
basim	
basis	a foundation, base, support, pedestal
basium	a kiss
beati	
beatum	happiness, felicity
beatus	happy, prosperous, blessed, fortunate
bellicum	the war - trumpet, war-signal
bellicus	of war, military
bellum	war
bellus	pretty, handsome, neat, pleasant, fine, agreeable
bene	
beneficium	a favor, benefit, service, kindness
benignitas	kindness, friendliness, courtesy, benevolence, benignity
benus	
beo	to make happy, gladden, bless
bes	two thirds
besalibus	
besem	
bestia	a beast, animal
bestiola	a small animal, little living creature
bibo	to drink
biduum	a period of two days, two days
biennis	
biennium	a period of two years, two years
biforus	
bini	two by two, two to each, two each, two at a time
bipedale	
bipedalis	of two feet, measuring two feet
bipertito	
bis	twice, at two times, on two occasions
bitumen	mineral pitch, bitumen
bituminosus	
bitur	
blandio	
blandior	to fawn, soothe, caress, fondle, coax
bonae	
bonitas	goodness, excellence
bonum	
bonus	good
bos	an ox, bull, cow
bracchium	the forearm, lower arm
breve	
brevi	in a little while, in a short time, soon
brevia	
brevio	
brevis	short
brevitas	shortness
breviter	shortly
bruma	the shortest day
brumalis	of the winter solstice
bubile	a stall for oxen
bubula	
bubulus	of neat cattle, of oxen
buccula	the beaver, mouthpiece of a helmet
bucina	a trumpet, horn
bulla	a water-bubble, bubble
bullio	
bullitus	
bullo	
buxum	the wood of the box-tree, box-wood
buxus	the box-tree
bybliothecae	
bybliothecam	
bybliothecas	
bybliothecis	
Babylo	a Babylonian
Babylon	
Babylonius	
Baianum	
Baianus	
Balearibus	
Berosus	
Boedas	
Boeotia	
Boeotius	Boeotian
Borysthenes	
Bryaxis	
Byzantii	
Byzantius	
c	
cacumen	an extremity, point, peak, top, summit
cacumino	to make pointed, sharpen
cado	to fall, fall down, descend
caecias	
caedes	a cutting-down
caedo	to cut, hew, cut down, fell, cut off, cut to pieces
caelestia	
caelestis	of heaven, from heaven, of the heavens, heavenly, celestial
caelo	to engrave in relief, make raised work, carve, engrave
caelum	the sky, heaven, heavens, vault of heaven
caelus	
caementa	
caementicius	
caementum	an unhewn stone, quarry-stone
caeruleum	
caeruleus	like the sky, azure, blue, dark blue, dark green
caerulus	azure, blue, dark blue, cerulian
caesa	
caesum	
caesus	
calamitas	loss, injury, damage, mischief, harm, misfortune, calamity, disaster
calamus	a reed, cane
calathus	a wicker-basket, hand-basket
calatus	
calcata	
calcatura	
calcatus	
calceo	to furnish with shoes, put on shoes, shoe
calceus	a shoe, halfboot
calcis	
calco	to tread, tread upon, trample
calculosus	
calculus	a small stone, pebble
caldaria	
caldarium	
caldarius	
caldus	
caleo	to be warm, be hot, glow
calesco	to grow warm, be heated
calfacere	
calfaciantur	
calfaciundo	
calida	
calidum	
calidus	warm, hot
calix	a cup, goblet, drinkingvessel
calleo	to be callous
calo	
calor	warmth, heat, glow
calx	
calxque	
camara	a boat with arched deck
camera	a vault, an arched roof, arch
campana	
campaneus	
campe	
campestre	
campestrem	
campestres	
campestria	
campus	a plain, field, open country, level place
canaliculus	
canalis	a pipe, groove, channel, canal, passage for a fluid, conduit
cancri	
cancro	
cancrum	
candela	a wax-light, tallowcandle, taper
candelabrum	a candlestick, chandelier, lamp-stand
candentia	
candeo	to be brilliant, be glittering, shine, glitter, glisten
candescat	
candida	
candido	
candidus	shining white, clear, bright
candor	a dazzling whiteness, lustre, clearness, radiance, brightness, brilliancy, splendor
caneo	to be gray, be hoary
cani	
canis	a dog
canna	a reed, cane
cannula	
cano	to utter melodious notes, make music, sing, sound, play
canon	
canona	
canonicus	
cantherius	a gelding
canticum	a musical monologue, recitative, monody
canticus	
cantio	an incantation, charm, spell
canto	to produce melodious sounds, sound, sing, play
cantur	
cantus	a musical utterance, singing, song
canus	white, hoary
capacitas	space for holding, capacity
capillamentum	
capillum	
capillus	collect., the hair of the head, hair
capio	to take in hand, take hold of, lay hold of, take, seize, grasp
capitulum	a little head, darling, pet
capitum	
capra	a she-goat
capreola	
capreolus	a wild goat, chamois, roebuck
capricorni	
capricorno	
caprile	
caprilis	
capsus	
captio	a deceiving, deception, fraud, deceit
captivus	taken prisoner, captive
capto	to strive to seize, lay hold of, catch at, snatch, chase, hunt, capture
captus	
caput	the head
carbas	
carbo	a coal, charcoal
carbunculo	
carbunculus	a small coal
carcer	a prison, jail
carchesium	a Greek drinking - cup, oblong beaker with handles
cardinalis	
cardinatus	
cardo	a hinge, pivot and socket
carie	
cariem	
caries	decay, dry-rot
caritas	dearness, costliness, high price
carmen	a song, poem, verse, oracular response, prophecy, form of incantation, tune, air, lay, strain, note, sound
carne	
caro	flesh
carpinus	
carrum	
carrus	a wagon for freight, baggagewagon
carus	dear, precious, valued, esteemed, beloved
caryatides	
casa	a small house, cottage, hut, cabin, shed
castellum	a castle, fort, citadel, fortress, stronghold
castitas	purity, chastity
castor	the castor, beaver
castra	a military camp, encampment
castro	to emasculate
castrum	a fortified place, castle, fort, fortress
castum	
castus	morally pure, unpolluted, spotless, guiltless, virtuous
casus	a falling, falling down, fall
catapulta	an engine for hurling missiles, catapult
cataracta	a drawbridge, portcullis
catatonus	
catena	a chain, fetter, shackle
catenationes	
catenationibus	
cateno	
cathetoe	
cathetus	
catinum	
catinus	a deep vessel of earthenware, bowl
catlaster	
cauda	a tail
caudex	a trunk of a tree, stock, stem
cauliculus	
caurio	
caurum	
caurus	
causa	a cause, reason, motive, inducement, occasion, opportunity
cautes	
caveant	
caveatur	
caveo	to be on one's guard, take care, take heed, beware, guard against, avoid
cavo	to make hollow, hollow out, excavate
cavum	
cavus	hollow, excavated, concave
ceam	
cedrium	
cedrus	the cedar, juniper
celata	
celatum	
celer	swift, fleet, quick, speedy
celeritas	swiftness, quickness, speed, celerity
celeriter	quickly, swiftly, speedily, in haste, immediately, promptly
celero	to quicken, hasten, accelerate
cella	a place of concealment, store-room, cell, granary
celo	to hide from, keep ignorant of, conceal from
cena	a dinner, principal meal
cenaculum	an upper story, upper room, garret, attic
censeo	to tax, assess, rate, estimate
centauri	
centauros	
centaurus	
centena	
centenarius	
centeni	
centrum	
centum	a hundred
centunculus	a cloth of many colors
cera	wax
cerno	to separate, part, sift
cero	
cerrus	
certamen	a decisive contest, measuring of forces, struggle, strife, dispute, dissen
certatim	in rivalry, emulously, zealously, with competition
certatio	a competition, contest, strife, rivalry
certioro	
certo	
certor	
certus	determined, resolved, fixed, settled, purposed, certain
cerussa	white-lead, ceruse
cervicula	a small neck
cervix	a head-joint, neck, nape
ceter	
ceterum	for the rest, in other respects, else, otherwise
ceterus	the other, remainder, rest
cetus	
chalcidice	
chele	
chelonia	
chelonium	
cherolabae	
choragium	stage apparatus, scenery and costumes
chorda	catgut, a string
chordus	
chorobates	
chorographiis	
chorte	
chortes	
chorus	a dance in a ring, choral dance, dance
chroma	
chromatice	
chromaticus	
chromatos	
chrysocolla	
cibdelus	
cibo	
cibus	food, victuals, nutriment, fodder
cichorium	
cieo	to cause to go, move, stir, drive
cilicium	a covering, originally of Cilician goat's hair, used by soldiers and seamen
cincinnus	curled hair, a lock of hair, curl
cingo	to go around, surround, encompass, environ, gird, wreathe, crown
cinis	ashes
circinatio	
circini	
circinique	
circino	to make round, round
circinum	
circiter	about, not far from
circito	
circius	
circo	
circos	
circuitio	
circuitus	a going round, circling, revolving, revolution
circulo	
circulus	a circular figure, circle
circum	around, round about, all around
circumactio	
circumactus	
circumago	to drive in a circle, turn round
circumcido	to cut around, cut, clip, trim
circumcingo	
circumcludo	to shut in, enclose, surround
circumcurro	
circumdati	
circum-dedo	
circum-do	
circumdo	to place around, cause to surround, set around
circumductio	
circumeo	to go around, travel around, march around
circumfero	to bear round
circumlatione	
circummetior	
circumsedeo	to sit around, surround, besiege, blockade, invest, encompass, beset
circumsono	to sound, resound on every side
circumvagor	
circumvallo	to surround with a wall, circumvallate, blockade, invest, encompass
circumvolvo	to roll around, revolve through
circus	a circular line, circle
cisium	a light two-wheeled vehicle, cabriolet
citatus	quick, rapid, speedy, swift, in haste, at full speed
citer	
citharoeda	
citharoedus	one who sings to the accompaniment of the cithara
cito	to put in quick motion, rouse, excite
citra	on this side, on the hither side
citreum	
citro	to this side
citrum	
civilis	of citizens, civil, civic
civis	a citizen
civitas	the condition of a citizen, citizenship, freedom of the city, membership in the community
clamo	to call, cry out, shout aloud, complain aloud
claritas	brightness
claro	to make bright, exhibit
clarus	clear, bright, shining, brilliant
classis	a class, great division
clathro	
clava	a knotty branch, rough stick, cudgel, club
clavicula	a tendril
clavis	a key
clavus	a nail
climacida	
climacidos	
clipeum	
clipeus	a round shield of metal
cliva	
clivius	
clivus	a declivity, slope, ascent, hill, eminence
cloaca	a canal for waste liquids, sewer, drain
cnodacas	
cnodaces	
cnodacibus	
coacto	
coactum	
coactus	compulsion, constraint
coagmentatio	a joining, connection, union
coagmento	to join, cement together, connect
coagmentum	a joining together, joint
coagulum	an agent of coagulation, rennet, runnet
co-alo	
coartatio	a crowding, pressing together
coarto	to press together, compress, contract, confine
coaxatio	
coaxatione	
coaxationem	
coaxationibus	
coaxo	
cocio	
coclea	a snail
cocta	
coctio	
coctum	
coctura	
coeo	
coepio	to begin, commence
cogitata	
cogitatio	a thinking, considering, deliberating, thought, reflection, meditation, imagination
cogitatum	a thought, reflection, notion, idea
cogitatus	deliberate
cogito	to consider thoroughly, ponder, weigh, reflect upon, think
cognatus	
cognomen	a surname, second-name, family-name
cognosco	to become acquainted with, acquire knowledge of, ascertain, learn, perceive, understand ; perf., to know
cogo	to drive together, collect, crowd, bring together, summon, congregate, convene
cohaerentia	a coherence, connection
cohaereo	to cling together, be united, cohere
cohaeresco	to hang together, cohere
cohors	a court, enclosure, yard, pen, cattle-yard
cohorto	
coitus	sexual union
collecta	
collector	
collectus	
collegium	
colliciae	
colligatio	
colligo	
collina	
collino	
collinus	
colliquiaria	
collis	an elevation, high ground, hill
collocatio	
collum	the neck
collus	
colo	to till, tend, care for, cultivate
colon	
colona	a countrywoman
colonia	a colony, colonial town, settlement
colonus	a husbandman, tiller of the soil
color	color, hue, tint
coloro	to give a color to, color, tinge, dye
colossicotera	
colossicus	
colum	a vessel for straining, colander
columbarium	
columbarius	
columella	a small column, pillar
columen	a pillar, column
columna	a column, pillar, post
columnar	
columnatus	
colus	a distaff
combibo	
comburo	to burn up, consume
comes	a compan
comicus	of comedy, comic, in comic style
comitium	a place of assembly, place of meeting
comito	to accompany, attend, follow
commeatus	a going to and fro, passing back and forth
commendatio	a commit ting, commending, recommending, recommendation
commendo	to commit for protection, intrust, confide, deposit with
commensus	
commentarium	
commentarius	a notebook, notes, memorandum
commetior	to measure
commis	
commisceo	to mix, mingle together, intermingle
commissura	a joining together, joint, seam, juncture, commissure
committo	
commoditas	fitness, convenience, a fit occasion, advantage, benefit
commodo	to serve with, accommodate, grant, supply, lend
commodulatio	
commodum	
commodus	with due measure, full, complete, of full weight
commonefacio	to recall, bring to mind
commoro	
commoror	to tarry, linger, abide, sojourn, remain, stay
commoveo	To put in violent motion, move, shake, stir
commune	that which is common
communicatio	a making common, imparting, communicating
communico	to divide with, communicate, impart, share
communio	a community, mutual participation, fellowship
communis	common, general, universal, public
communitas	community, society, fellowship, friendly intercourse
communiter	together, in common, jointly, generally
communitio	road-making
commutatio	a changing, change, alteration
commuto	to alter wholly, change entirely
comoedia	a comedy
compaciscor	
compactilis	
compactio	a joining together
compactum	an agreement
compactura	
comparatio	
comparatus	
compareo	to be evident, appear, be plain, be visible
comparo	
compendio	
compendium	gain, profit
compingo	to join together, frame, make by joining
complector	to clasp, embrace, grasp
compleo	to fill up, fill full, fill out, make full, cram, crowd
complures	more than one, not a few, several, a number, many
compluvium	
compono	to bring together, place together, collect, unite, join, connect, aggregate
comportatio	
comporto	to bring in, carry together, collect, accumulate, gather
compositio	a putting together, connecting, arranging, composition
compositum	an agreement, compact
compositus	well - ordered, orderly, regular
comprehendo	to bind together, unite
compressio	concise expression, condensation
compresso	
compressus	a compression
comprimo	to press together, bring together, compress, close
conarachnen	
conatum	
conatus	an attempt, effort, undertaking, enterprise, endeavor
concaedes	an abattis, barricade of felled trees
concalefacio	to warm thoroughly
concalesco	to grow hot, glow
concamaranda	
concamarationes	
concamarationesque	
concameratio	
concamero	
concapit	
concedo	to go away, pass, give way, depart, retire, withdraw, remove
concentus	a concert, symphony, harmony, harmonious music
concepta	
conceptio	a conception, becoming pregnant
concepto	
conceptum	
conceptus	a conceiving, conception
concha	a bivalve, shell - fish, mussel
conchylium	a shell - fish
concido	
concilium	a meeting, rendezvous
concinno	to cause, produce
concipio	to take hold of, take up, take in, take, receive
concito	to put in quick motion, rouse, excite, urge, drive, incite, spur, agitate, disturb
conclave	a room, chamber, suite, apartment
conclaviorum	
concludo	to shut up, close, imprison, enclose, confine
conclusio	a shutting up, shutting in, siege, blockade
conclusum	a conclusion
conclusura	
conclusus	
concoquo	to digest
concrescentia	
concresco	to grow together, harden, condense, curdle, stiffen, congeal
concrispo	
concurro	to run together, assemble, flock together
condecoro	to grace, applaud, honor
condemno	to convict, condemn, sentence, find guilty
condicio	an agreement, stipulation, condition, compact, proposition, terms, demand
conduco	to draw together, assemble, collect, gather, unite
conductor	a hirer, lessee, farmer, tenant.—Plur
conecto	to bind together, connect, entwine, join, unite, link
conexus	adjoining
confacio	
confero	To bring together, collect, gather, unite, join
confervefacio	
confervesco	to begin to boil, grow hot
conficio	to make ready, make, prepare, bring about, complete, accomplish, execute, consummate, fulfil
confido	to trust, confide, rely upon, believe, be assured
configo	to join, fasten together
confirmo	to make firm, make strong, establish, strengthen
confiteor	to acknowledge, confess, own, avow, concede, allow, grant
conflagro	to burn, be consumed, be on fire
conflicto	to come in conflict, collide
confluo	to flow together, run together
conformatio	a symmetrical forming, conformation, shape, form, fashion
conformo	to form, fashion, shape
confornicatio	
confornico	
confrico	to rub vigorously
confundo	to pour together, mingle, mix, blend
congelo	to freeze together, congeal
congero	to bring together, collect, heap up, throw together
congesticius	heaped, piled up, thrown together
congestio	
congesto	
congestus	a bring
congialis	
conglobo	to gather into a ball, press together in a mass, roll up
conglomero	
conglutino	to join together, unite, cement
congredior	to come together, meet, have an interview
congrego	to collect in a flock, swarm
congressus	a meeting, assembly, conference, conversation, interview
congruo	to coincide, agree
conicio	To throw together, unite, collect
conicum	
conisterium	
con-ligo	
conlo	
con-loco	
conor	to undertake, endeavor, attempt, try, venture, seek, aim, make an effort, begin, make trial of
conquaero	
conquiro	to seek for, hunt up, search out, procure, bring together, collect
conscribo	to write together, write in a roll, enroll, enlist, levy
conscriptio	a record, report
conscriptus	one enrolled
consecuntur	
consensus	agreement, accordance, unanimity, concord
consentio	to agree, accord, harmonize, assert unitedly, determine in common, decree, unite upon
con-sequor	
consequor	to follow, follow up, press upon, go after, attend, accompany, pursue
consequus	
conservo	to retain, keep safe, maintain, preserve, spare
considerantia	
consideratio	contemplation, consideration
considero	to look at closely, regard attentively, inspect, examine, survey
consido	to sit down, take seats, be seated, settle
consilior	to take counsel, consult
consilium	a council, body of counsellors, deliberative assembly
consimilis	entirely similar, very like
consisto	to stand still, stand, halt, stop, take a stand, post oneself
consolida	
consonantia	
consono	to sound together, sound aloud, re-echo, ring, resound
conspargo	
conspectus	
conspicio	to look at attentively, get sight of, descry, perceive, observe, fix eyes upon
constantia	steadiness, firmness, constancy, perseverance
constituo	to put, place, set, station
constitutio	a disposition, constitution, nature
constitutum	an agreement, appointment, compact
consto	to agree, accord, be consistent, correspond, fit
constricto	
constrictus	
constringo	to bind, fetter, shackle, chain
construo	to heap together, pile up, accumulate
consuetudo	a custom, habit, use, usage, way, practice, familiarity, experience, tradition, precedent
consummo	to accomplish, complete, finish, perfect
consumo	to use up, eat, devour
consuo	
consutum	
contabulatio	a structure of planks, flooring, floor, story
contectus	
contego	to cover, roof, bury
contemno	
contemptor	he who disregards, a contemner, despiser
contemptus	
contendo	to stretch, bend, draw tight, strain
contentio	a stretching, straining, exertion, tension, effort, struggle
contero	to grind, bruise, pound, wear out
contexo	to weave, entwine, join, bind
contextus	
contignatio	a floor, storey
contigno	to join with beams, furnish with joists
continens	
continenter	continuously, without interruption
contineo	to hold together, bound, limit, comprise, enclose, surround, environ
contingo	to touch, reach, take hold of, seize
continuo	
contra	in opposition, opposite, face to face, in front, on the other side
contractio	a drawing together, contraction
contractura	
contractus	drawn together, compressed, contracted, short, narrow, restricted, limited
contraho	to draw together, collect, assemble
contrarium	
contrarius	lying over against, opposite
con-tricor	
contritus	worn out, trite, common
controversia	a contention, quarrel, question, dispute, controversy, debate
contueor	to look on, gaze upon, behold, survey
contumelia	insult, abuse, affront, reproach, invective, contumely
contundo	to beat, bruise, grind, crush, pound, break to pieces
contusum	
conus	a cone
convalesco	to recover, regain health, grow strong, gain strength
convenientia	agreement, harmony, symmetry
convenio	to come together, meet, assemble, gather, come in a body
conventus	a meeting, assembly, throng
converro	to sweep together
conversatio	familiar intercourse, association
converso	to turn around
converto	to turn round, cause to turn, turn back, reverse, direct
convictus	a living together, intimacy, social intercourse
convinco	to overcome, convict, refute, expose
convivium	a meal in company, social feast, entertainment, banquet
conjecto	
conjectus	
conjunctio	
conjuncto	
conjunctum	
conjunctus	
conjungo	
conjunx	
copia	an abundance, ample supply, plenty
copiosus	furnished abundantly, well supplied, having abundance, rich, copious, plentiful, abounding
copis	a short, curved sword, yataghan
coquo	to cook, prepare by cooking, bake, boil, roast, parch, steep, melt, heat
cora	
coracino	
coracinus	
coram	in the presence, before the eyes, in the face, openly, face to face
corax	
corinthia	
corinthiae	
corinthiarum	
corinthii	
corinthiis	
corinthiisque	
corinthio	
corinthiorum	
corinthios	
corinthium	
corion	
corium	skin, hide, leather
corius	
cornetum	
corneus	
cornu	a horn, antler
cornus	a cornel cherry-tree
corona	a garland, chaplet, wreath
coronarius	for a crown
coronis	
corono	to furnish with a garland, crown, wreathe
corporatura	
corporo	
corpus	a body
correctus	
correptio	
correpto	
corrigo	to make straight, set right, bring into order
corripio	to seize, snatch up, grasp, collect, take hold of, arrest
corrumpo	to destroy, ruin, waste
corrupta	
corruptus	spoiled, marred, corrupted, bad
corsa	
corsae	
cortex	the bark, rind, shell, hull
corum	
corus	
corvus	a raven
coryceum	
cote	
cottidianus	of every day, daily
cottidie	daily, every day
co-jacio	
crassitudo	thickness
crasso	
crassus	solid, thick, fat, gross, stout
crastinus	of to-morrow, to-morrow's
cratera	a mixing-vessel, winebowl, punch - bowl
craterem	
craticius	
cratis	wicker-work, a hurdle
creber	thick, close, pressed together, frequent, numerous, repeated
crebre	
crebritas	thickness, closeness, frequency
crebriter	
credo	to give as a loan, lend, make a loan
creo	to bring forth, produce, make, create, beget, give origin to
crepido	a foundation of masonry, base
crepitus	a rattling, creaking, clattering, clashing, rustling
crepo	To rattle, crack, creak, rustle, clatter, tinkle, jingle, chink
crescentia	
cresco	to come into being, spring up
creta	Cretan earth, pipe - clay, chalk
cretosus	abounding in chalk
cretus	
crinis	the hair, hair of the head
crispo	to swing, brandish
crispus	having curled hair, curly-headed
crista	a tuft, comb, crest
crocodilion	
crocodilus	a crocodile
crudelis	rude, unfeeling, hard, unmerciful, hard - hearted, cruel, severe, fierce
crudeliter	cruelly, fiercely, in a cruel manner
crudus	bloody, bleeding, trickling with blood
crus	the leg, shank, shin
crusta	a hard surface, rind, shell, crust, bark
crusto	
crustum	a hard loaf, cake, pastry
crux	a gallows, frame, tree
crypta	a vault, cavern
cubiculum	a room for reclining, sleeping - chamber, bedchamber
cubicus	
cubile	a place of rest, couch, bed
cubito	to lie down often, be accustomed to lie
cubitor	
cubitum	the elbow
cubitus	
cubo	to lie down, recline
culina	a kitchen
cullearis	
culmen	the top, summit, roof, gable
culpa	a fault, error, blame, guilt, failure, defect
culta	plantations, fields of grain
cultellus	a small knife
culter	a knife, butcher's knife
cum	
cumque	whenever, always
cunctus	all in a body, all together, the whole, all, entire
cuneolus	a little wedge
cuneus	a wedge
cupiditas	a longing, desire, passion, eagerness
cupidus	longing, desiring, desirous, eager, zealous, wishing, loving, fond
cupresseus	of cypress, of cypress wood
cupresso	
cupressus	the cypress
cur	why? wherefore? for what reason?
cura	trouble, care, attention, pains, industry, diligence, exertion
curandus	
curatio	a caring for, administration, oversight, care, management, charge
curculio	a corn-worm, weevil
curia	a court, curia, association
curiosus	bestowing care, painstaking, careful, diligent, thoughtful, devoted, attentive
curo	to care for, take pains with, be solicitous for, look to, attend to, regard
curro	to run, move quickly, hasten
cursim	quickly, swiftly, hastily, speedily
cursus	a running, course, way, march, passage, voyage, journey
curvatura	a bend
curvo	to crook, bend, bow, curve, round
curvum	
curvus	crooked, curved, bent
custodio	to watch, protect, keep, defend, guard
custos	a guard, watch, preserver, keeper, overseer, protector, defender, attendant
cujus	
cybum	
cybus	
cyclas	a circular, white or purple state-robe, with a border
cylindri	
cylindrorum	
cymatium	
cymbalum	a cymbal; two hollow plates of brass, which ring when struck together
cynosurae	
cyprus	
cyzicena	
cyzicenos	
C	
Caecubum	
Caecubus	of Caecubum
Caesar	
Callaeschros	
Calliam	
Callias	
Callimachus	
Callippus	
Camena	a Muse
Campania	
Campanius	
Campanus	
Canopus	
Capitolium	the Capitol, temple of Jupiter, at Rome
Capitulum	
Cappadocia	
Cappadocius	
Caria	
Carpion	
Carthaginiensis	
Carthago	
Carya	
Caryatibus	
Caryatium	
Casio	
Cassiepia	
Cassiepiae	
Castor	
Catacecaumenites	
Caucasus	
CC	
CCCC	
CCCCLXXX	
CCCLX	
CCCLXV	
CCCXIII	
CCXL	
CCXVI	
CCXXV	
Cea	
Celtica	
Celticum	
Celticus	
Cepheius	
Cepheus	
Cephisus	
Ceres	the daughter of Saturn, goddess of agriculture
Chalcedonius	
Chaldaei	
Chaldaeus	Chaldaean
Chaldaicus	
Charias	
Chersiphron	
Chersiphrone	
Chersiphronos	
Chii	
Chionides	
Chius	Chian, of Chios
Chrobsi	
Cicero	
Cilbianis	
Cilicia	
Cilicius	
Circe	daughter of the Sun, a sorceress
Clazomenae	
Clazomenii	
Clazomenius	
Climacidos	
Clitor	
CLX	
CLXXX	
Colchi	
Colchis	
Colchus	
Collina	
Collinus	
Colonia	
Colophona	
Colophonius	
Concamarationes	
Corinthia	
Corinthii	
Corinthius	of Corinth, Corinthian
Cornelius	
Coronae	
Corone	
Coronis	
Cos	
Cossutius	
Cottius	
Coum	
Cous	of Cos, Coan
Crates	
Crathis	
Creta	
Cretenses	
Cretensis	
Creusa	
Croesius	
Croesus	
Crotoniates	
Ctesibicus	
Ctesibius	
Cumae	
Cumani	
Cumanum	
Cumanus	
Cutilia	
Cutiliae	
Cutilius	
CXCVI	
CXX	
CXXXV	
Cybus	
Cydnos	
Cyrenae	
Cyrenaei	
Cyrenaeus	
Cyrene	
Cyrrestes	
Cyzicos	
Cyzicum	
Cyzicus	
damno	to adjudge guilty, condemn, convict
daphne	
datio	a giving
de	from, away from, down from, out of
dealbo	to whiten, whitewash, plaster
debeo	to withhold, keep back
decastylos	
decedo	to go away, depart, withdraw, retire
decem	ten
deceptus	
decerno	to decide, determine, pronounce a decision, judge, decree, resolve, vote
decet	
decido	
decies	
decima	
decimo	
decimus	the tenth
decipio	to catch, ensnare, entrap, beguile, elude, deceive, cheat
declinatio	a bending aside, turning away, averting
declino	to bend aside, turn away
decor	comeliness, elegance, grace, beauty, charm, ornament
decoris	
decoro	to adorn, embellish, grace, beautify, decorate
decorum	seemliness, propriety
decorus	becoming, fitting, seemly, proper, suitable, decorous
decrescentia	
decresco	to grow less, become fewer, decrease, diminish, wane, shrink
decretum	a decree, decision, ordinance, vote, resolution
decuria	a division of ten, decuria, decade
decurio	
decurro	to run down, hasten down, run, hasten
decursus	a running down, downward course, descent
decus	grace, glory, honor, dignity, splendor, beauty
decusatim	
decusationem	
decusationes	
decusationibus	
decusis	
dedico	to dedicate, consecrate, set apart
dedo	to give away, give up, surrender, deliver, consign, yield, abandon, render
deduco	to lead away, draw out, turn aside, divert, bring out, remove, drive off, draw down
deductio	a leading away, conducting off
deductor	
deeo	
defatigo	to weary out, tire, fatigue, exhaust
defectio	a failing, failure, want, lack, disappearance
defendo	to ward off, repel, avert, keep off
defensa	
defensio	a defending, defence
defenso	to defend diligently, protect
defero	to bring away, carry off, take down, carry, take, remove
defervefacio	
deferveo	
defervesco	to cease raging, cool down, be allayed, be assuaged
deficio	to withdraw, revolt, desert, fall off
definio	to bound, set bounds to, limit, terminate, define
defio	
deflagro	to burn down, be consumed by fire
defluo	to flow down
defodio	to dig deep, dig up, make by digging
deformatio	a deforming, disfiguring, defacing
deformo	
defundo	to pour down, pour out
deicio	to throw down, hurl down, precipitate, prostrate, raze, fell, cut down, tear down, destroy
deinde	then, next, thereafter, thence
delectatio	a delighting, delight, pleasure, amusement, satisfaction
delecto	to allure, attract, delight, charm, please, entertain, interest
delector	
delibero	to weigh well, consider maturely, deliberate, ponder, meditate, take counsel, consult, advise upon
delicatus	alluring, charming, pleasing, delightful, luxurious, voluptuous
delicia	
deliciae	a delight, pleasure, charm, allurement, luxury, voluptuousness
delicium	a sweetheart
delicius	
delico	
deliquia	
delphini	
delphinique	
delphinum	
delphinus	a dolphin.—The Dolphin
delumbo	to enervate, weaken
demeo	
demereo	to deserve well of
deminutio	a diminution, decrease, lessening, abatement
demissio	a letting down, sinking, lowering
demissus	lowered, sunken, low-lying, low
demitto	to send down, let down, drop, lower, put down, let fall, sink
demo	to take away, take off, subtract, remove, withdraw
demolio	
demolior	to throw down, tear down, raze, demolish
demolitio	a tearing down, demolishing
demolitor	
demonstratio	a showing, pointing out, description
demonstro	to point out, indicate, designate, show
demoror	to retard, detain, delay
dempta	
dempti	
dempto	
denarius	containing ten each
deni	distrib., ten each, ten at a time, by tens
denigro	
denique	and thenceforward, and thereafter, at last, at length, finally, lastly, only, not until
dens	a tooth
densus	thick, close, compact, dense, crowded
dentatus	having teeth
denticulus	
denuo	once more, a second time, anew, afresh, again
depingo	to depict, portray, paint, draw
depono	to lay away, put aside, set down, lay, place, set, deposit
deporto	to carry down, carry off, take away
deprecor	to avert by prayer, deprecate, plead against, beg to escape, seek to avoid
depressio	
deprimo	to press down, weigh down, sink down, depress
depurgo	
descendo	to climb down, come down, descend, fall, sink
descensus	a descent, way down
describo	to copy off, transcribe, write out, write down
descripta	
descriptio	a marking out, delineation, copy, transcript, draft
desero	to leave, forsake, abandon, desert, give up
deserta	
desertum	
desertus	deserted, desert, solitary, lonely, waste
desideo	to sit long, sit idle, remain inactive
desideratio	a desiring, longing, missing
desiderium	a longing, ardent desire, wish, want, grief, regret
desidero	to long for, ask, demand, call for, wish for, desire, require, expect
desido	to sink, settle down, fall
designatio	a marking out, specification
designo	to mark out, point out, trace, designate, define
desino	to leave off, give over, cease, desist, forbear
desisto	to leave off, cease, give over, desist from
de_-sono	
despectatio	
despica	
despicio	to look down upon
despicor	
despumo	to skim off, skim
destina	
destino	to make fast, make firm, bind, fix, stay
desum	to be away, be absent, fail, be wanting, be missing
detego	to uncover, expose, lay bare, unroof
deterior	lower, worse, poorer, meaner
deterreo	to frighten off, deter, discourage, prevent, hinder
detineo	to hold off, keep back, detain, check
detractio	a taking away, wresting, withdrawal, removal
detraho	to draw off, take down, pull down, take away, remove, withdraw, drag, bring
deus	a god, deity
devenio	to come, arrive, reach
devoro	to swallow, gulp down, devour, consume
dextante	
dexter	to the right, on the right side, right
dextera	the right hand
dejecto	
dejectus	
diagonalis	
diagonioe	
diagonios	
diagonium	
diagramma	
diametros	
diametrum	
diapason	
diapente	
diastylis	
diastylo	
diastylos	
diatessaron	
diatonum	
diatonus	
diazoma	
dica	a lawsuit, judicial process, action
dichalcum	
dico	
dictum	something said, a saying, word, assertion, remark
diduco	to draw apart, part, split, separate, sever, sunder, divide, undo, relax
dies	a day, civil day
diezeugmenon	
differo	to carry apart, spread abroad, scatter, disperse, separate
difficilis	hard, difficult, troublesome, impracticable, laborious, perilous
difficiliter	with difficulty
difficultas	difficulty, trouble, distress, poverty, want, embarrassment
difficulter	with difficulty, hardly
diffluo	to flow in different directions, flow away
diffundo	to spread by pouring, pour out, pour forth
digitalis	
digitus	a finger
dignitas	worth, merit, desert, character
digno	to deem worthy
dignus	worthy, deserving, meritorious, deserved, suitable, fitting, becoming, proper
diheseon	
diheses	
dihesis	
dilabor	to fall asunder, go to pieces, melt away, dissolve
dilatatio	
dilato	to spread out, dilate, broaden, stretch, enlarge, extend
diligens	industrious, careful, assiduous, attentive, diligent, accurate, scrupulous, faithful
diligenter	industriously, attentively, diligently, assiduously
diligentia	attentiveness, earnestness, diligence, industry, assiduity, care, faithfulness
diligo	to single out, value, esteem, prize, love
dilucidus	clear, distinct, evident
diluo	to wash away, dissolve, dilute, wash, drench
dimetior	to measure, measure out, lay out
dimidia	
dimidio	
dimidium	the half
dimidius	half, one half
dimitto	to send different ways, send out, send forth, send about, scatter, distribute
dioptra	
diplinthius	
dipteri	
dipteron	
dipteros	
directio	
directum	
directura	
directus	
dirigo	to distribute, scatter
diripio	to tear asunder, tear in pieces
diruo	to tear asunder, overthrow, demolish, destroy
discedo	to go apart, part asunder, divide, separate, disperse, scatter
discerno	to separate, set apart, mark off, bound, part, divide
discessus	a going asunder, parting
disciplina	instruction, tuition, teaching, training, education
disco	to learn, learn to know, acquire, become acquainted with
discolorius	
disconvenio	to disagree, be inconsistent
discrepantia	discordance, dissimilarity, discrepancy
discrepo	to differ in sound, be discordant, fail to harmonize
discrimen	that which parts, an intervening space, interval, distance, division, separation
discrimino	to divide, part, separate
discurro	to run different ways, run to and fro, run about, wander, roam
discus	a quoit
discutio	to strike asunder, dash to pieces, shatter
disdiapason	
disdiapente	
disdiatessaron	
dis-frango	
disicio	to throw asunder, drive asunder, scatter, disperse, break up, tear to pieces
disparatio	
disparguntur	
disparibus	
dis-pario	
disparo	to part, separate, divide
dispensatio	management, charge, direction, superintendence, provision, stewardship
dispicio	to descry, discern, perceive, make out, distinguish, detect
displiceo	to displease, be unsatisfactory
displuviatum	
dispono	to place here and there, array, distribute, set in order, arrange, dispose
dispositio	a regular disposition, arrangement
dispositus	a disposition, arrangement
disputatio	an argument, discussion, debate, dispute
disputo	to weigh, examine, investigate, treat, discuss, explain
disrumpo	
dissaeptio	
dissensio	difference of opinion, disagreement, dissension, discord, strife
dissero	
dissilit	
dissiliunt	
dissimilis	unlike, dissimilar, different
dissimiliter	differently, in a different manner
dissipabit	
dissipabitur	
dissipabunt	
dissipabuntur	
dissipando	
dissipant	
dissipantur	
dissipare	
dissipat	
dissipatur	
dissipaverunt	
dissipentur	
dissipetur	
dissolutio	a dissolving, destroying, breaking up, dissolution
dissolutum	
dissolvo	to take apart, disunite, part, destroy
distantia	remoteness, diversity
distendo	to stretch asunder, stretch out, extend
distineo	to keep asunder, separate, part, hold back
distinguo	to separate, divide, part
disto	to stand apart, be separate, be distant
distribuo	to divide, distribute, apportion, spread
distributio	a division, distribution
disturbo	to drive asunder, separate by violence, throw into disorder, disturb
disjunctum	
disjunctus	
disjungo	
diu	by day, all day
diurno	
diurnum	
diurnus	of the day, by day
dius	godlike, divine, worshipful, adorable
diuturnitas	length of time, long duration, durability
diuturnus	of long duration, lasting, long
divarico	to spread asunder, stretch apart
diverto	
divido	to divide, force asunder, part
divina	
divinitas	godhead, divinity
divino	to foresee, divine, foretell, predict, prophesy, expect, dread, conjecture
divinum	
divinus	of a god, of a deity, divine
divisio	a division, distribution
divisor	one who distributes
divisus	a division, distribution
divitiae	riches, wealth
divorto	
divus	
do	to hand over, deliver, give up, render, furnish, pay, surrender
doceo	to cause to know, make aware, teach, instruct, inform, show, prove, convince, tell
docilis	easily taught, teachable, tractable, docile
docti	
doctrina	teaching, instruction, learning
dodrantalis	
dodrante	
dodrantis	
dolium	a large, wide - mouthed, globular jar
dolo	
dolor	pain, smart, ache, suffering, anguish
dominicus	
dominium	a feast, banquet
dominus	a master, possessor, ruler, lord, proprietor, owner
domo	to domesticate, tame, break, subdue, master
domuncula	
domus	a house, dwelling-house, building, mansion, palace
donec	as long as, while
dono	To give as a present, present, bestow, grant, vouchsafe, confer
donum	a gift, present
dorica	
doricae	
doricam	
doricarum	
doricas	
dorice	
dorici	
doricis	
dorico	
doricorum	
doricum	
dorsum	the back
drachma	a drachma, drachm
draco	a serpent, a large serpent, dragon
dubitatio	uncertainty, doubt, perplexity
dubito	to waver in opinion, be uncertain, be in doubt, be perplexed, doubt, question
dubium	
dubius	moving two ways, fluctuating
ducenti	
duco	to lead, conduct, guide, direct, draw, bring, fetch, escort
ductarius	
ductio	
ducto	to lead, draw, conduct
ductus	a leading, conducting
dulcedo	sweetness, pleasantness, agreeableness, delightfulness, charm
dulcis	sweet
dum	
dummodo	
dumtaxat	while one examines
duo	two
duodecim	twelve
duodecimque	
duodecimus	the twelfth
duodecuma	
duodecumam	
duodecumas	
duodenum	
duodevicensima	
duplex	twofold, double
duplicatio	
duplicia	
duplico	to double, multiply by two, repeat
dura	
duresco	to grow hard, harden
duriter	roughly, coarsely
durities	
durius	
duro	to make hard, harden, solidify
durum	
durus	hard
duum	
dux	a leader, conductor, guide
D	
Daphne	
Daphnis	
Dareus	
Darius	
DC	
DCCCCLX	
Delos	
Delphi	
Delphicus	
Delphis	
Delus	
Demetrius	
Democles	
Democritus	
Demophilus	
Dempta	
Diade	
Diades	
Diana	the goddess of light and of the moon
Diastyli	
Dinocrates	
Diognetus	
Diomedes	
Dionysodorus	
Diphilus	
Dipteros	
Displuviata	
Doricus	
Dorieon	
Dorus	
Dyris	
Dyrrachium	
eadem	by the same way
eblandior	to persuade by flattery, obtain by coaxing
echea	
echinus	a sea-urchin
ecphora	
editor	
editum	Heights, elevations
edo	
educo	to bring up, rear, train, educate
effectum	an effect
effectus	an effecting, execution, accomplishment, performance
effero	
effervesco	to boil up, boil over
effervo	to boil up, boil over
efficio	to make out, work out, bring to pass, bring about, effect, cause, produce, make, form, execute, finish, complete, accomplish
effluo	to flow out, flow forth, run out
effugio	to flee away, get away, escape
effundo	to pour out, pour forth, shed, spread abroad
effusio	a pouring forth, outpouring, shedding
egeo	to be needy, be in want, be poor, need, want, lack, have need
egero	to carry out, bring out, take away, remove, discharge
ego	I, me, we, us
egredior	to go out, come forth, march out, go away
egregium	
egregius	select, extraordinary, distinguished, surpassing, excellent, eminent
egressus	a going out, going away, egress, departure
ei	
eicio	to cast out, thrust out, drive away, put out, eject, expel
eiusmodi	
elaeothesium	
elate	loftily, proudly
elatio	a transport, exaltation, elevation
electa	
electio	a choice, selection
electo	
electus	
eleganter	with good judgment, tastefully, neatly, finely, gracefully, elegantly
elegantes	
elegantia	taste, propriety, finement, grace, elegance
elego	
elevo	to lift up, raise
elicio	to draw out, entice out, lure forth, bring out, elicit
elido	to strike out, dash out, tear out, force out, squeeze out
eligo	to pluck out, root out
eloquens	eloquent
eloquentia	eloquence
eloquor	to speak out, speak plainly, utter, pronounce, declare, state, express
eluceo	to shine out, shine forth, gleam
embatere	
embolium	an interlude
embolum	
embolus	
emendate	faultlessly, perfectly
emendo	to free from faults, correct, improve, amend
emeo	
emereo	to obtain by service, earn, merit, deserve
emereor	
emergo	to bring forth, bring to light, raise up
emersus	
eminentes	
eminentia	a distinctive feature, conspicuous part
emineo	to stand out, project, reach upward
emitto	to send out, send forth
emo	to buy, purchase
emorior	to die off, die, decease
emporium	a place of trade, market-town, market, mart
enato	to swim away, escape by swimming
encarpa	
enclima	
encyclioque	
encyclios	
enim	for, for instance, namely, that is to say, I mean, in fact
enlychnii	
enodis	free from knots, smooth
enti	
enutrio	to bring up, nourish, support
eo	
eodem	loci, in the same place
ephebeum	
ephebus	a youth
epibata	
epigramma	an inscription
epigrammatos	
episcaenum	
episcenos	
epistylium	
epitonium	
epizygis	
equile	
equio	
equus	a horse, steed, charger
erectio	
ergata	
ergo	in consequence of, on account of, because of, for the sake of
erigo	to raise up, lift, set up, erect, elevate
eripio	to tear out, snatch away, wrest, pluck, tear, take away
erisma	
erismatorum	
errabundus	wandering about, vagrant, at random
errantia	
erraticus	wandering, roving, erratic
erratio	a wandering, roving about
erro	
error	a wandering, straying, strolling
erudero	
erudio	to educate, instruct, teach, polish
eruditio	an instructing, instruction
eruditus	instructed, educated, learned, accomplished
erumpo	to cause to break forth, emit, throw out
erus	the master of a house, head of a family
erythraeus	
esca	a dish
et	also, too, besides, moreover, likewise, as well, even: Ph
etenim	for, for truly, and indeed, because, since
etesiae	Etesian winds, trade-winds, N. W. winds which prevail in summer in the eastern parts of the Mediterranean Sea
etesias	
etesius	
etiam	now too, yet, as yet, even yet, still, even now
etiamnum	
etiamsi	
etsi	though
eum	
euricircias	
euripus	a channel, strait, narrow sea
eurus	the southeast wind
eurythmia	
eustyli	
eustylo	
eustylos	
euthygrammum	
evanesco	to vanish, pass away, die away, disappear
evanidus	vanishing, passing away
evenio	to come out, come forth
eventus	an occurrence, accident, event, fortune, fate, lot
everganeae	
everto	to overturn, upturn, turn upside down
evito	
evocatus	called out.— Plur. m
evoco	to call out, call forth, summon, evoke
evomo	to spew out, vomit forth
ex	out of, from
exactio	a driving out, expelling
exacuo	to sharpen, make pointed
exaequatio	a likening, uniformity
exaequo	to make equal, place on a level, equal
exaggero	to heap, pile, load
examen	
examinatio	
examino	to weigh
exanimo	to put out of breath, tire fatigue, weaken, exhaust
exaudio	to hear clearly, distinguish, discern, hear
ex-caedo	
excalptae	
excalptas	
excavo	to hollow out
excellentia	superiority, excellence
excellentiae	
excello	to be eminent, be superior, surpass, excel
excelsi	
excelsitas	loftiness, ascendency
excelsum	
excerno	to sift out, separate, part
excido	
excipio	To take out, withdraw
excisio	a destroying
excito	to call out, summon forth, bring out, wake, rouse
exclamo	to call out, cry aloud, exclaim
exclaro	
excludo	to shut out, exclude, cut off, remove, separate
exclusio	a shutting out, exclusion
excogito	to think out, contrive, devise, invent
excoquo	to boil out, melt out, dry up
excurro	to run out, run forth, hasten forwards
excutio	to shake out, shake off, cast out, drive out, send forth
ex-edo	
ex-emo	
exemplar	a transcript, copy
exemplares	
exemplaris	
exemplarium	
exemplo	
exemplum	a sample, specimen
exemptus	
exeo	to go out, go forth, go away, depart, withdraw, retire
exerceo	to drive, keep busy, keep at work, oversee, work, agitate
exercio	
exercitatio	exercise, practice, training, discipline, experience
exercito	
exercitus	
ex-eximo	
exhaurio	to draw out, empty, exhaust
exhedra	
exhedrae	
exhedras	
exhedris	
exigo	to drive out, push forth, thrust out, take out, expel
exiguitas	scantiness, smallness, littleness, shortness, insufficiency, scarcity
exiguum	
exiguus	strict, exact, scanty, small, little, petty, short, poor, mean, inadequate, inconsiderable, paltry
exilis	strict, narrow, thin, slender, lank, small, meagre, poor
eximo	to take out, take away, remove
exinanio	to empty, make empty, desolate
existimatio	a judging, judgment, opinion, supposition, decision, estimate, verdict
existimo	to value, estimate, reckon
exitus	a going out, going forth, egress, departure
exonero	to free, disburden, unload, empty
exorior	to come out, come forth, spring up, rise, appear
exorno	to fit out, equip, furnish, supply, provide
exortus	a coming forth, rising
expectanda	
expectandam	
expectatio	
expectatione	
expectationes	
expedio	to extricate, disengage, let loose, set free, liberate
expeditio	an enterprise against the enemy, expedition, campaign
expeditus	unfettered, unimpeded, unencumbered, without a burden
expendo	to weigh out, weigh
experior	to try, prove, test, experience, endure
expers	having no part in, not sharing in, not privy to
expertio	
expleo	to fill up, fill full, fill, stuff
explicata	
explicatas	
explicati	
explicatio	an unfolding, uncoiling
explicatus	
explicaverunt	
explicavisse	
explicavit	
explico	to unfold, uncoil, unroll, unfurl, unclose, spread out, loosen, undo
exploro	to cause to flow forth, bring out, search out, examine, investigate, explore
expolio	to smooth, polish, finish, adorn, embellish, refine, elaborate
expolitio	a smoothing off, polishing, finishing, embellishing
expono	to put out, set forth, expose, exhibit
exposita	
expressio	
expressor	
expressus	clearly exhibited, distinct, manifest, clear, plain, express
exprimo	to press out, force out, squeeze forth
ex-quaero	
exsanguinatus	
exsiccesco	
exsicco	to dry up, make dry
exsilio	to spring out, spring forth, leap up, start up, bound
exsolvo	to loose, unloose, set loose, release, deliver, free
exspecto	to look out for, await, wait for
exsuco	
exsugeo	
exsugo	
exsupero	to mount up, tower
exsurgo	to rise up, rise, get up, stand up
ext	
extantem	
extantes	
extanti	
extantia	
extendo	to stretch out, spread out, extend
ex-tendo	
extent	
extentio	
extento	
extenuo	to make small, reduce, diminish
exter	on the outside, outward, of another country, foreign, strange
extergeantur	
extergo	
extero	to tread down, crush
ex-tingo	
extinguantur	
extinguatur	
extinguendum	
extinguitur	
extollo	to lift out, lift up, raise, elevate
extra	on the outside, without
extraho	to draw out, draw forth, pull out, drag
extraneus	from without, strange
extrastilis	
extremo	at last, finally
extremum	at last, finally
extremus	outermost, utmost, extreme, farthest, last
extribus	
extrinsecus	from without, from abroad
extro	
extruantur	
extruaturque	
extructa	
extructae	
extructis	
extructus	
extrudo	to thrust out, push forth, drive out, drive away
extruendum	
exuo	to draw out, take off, pull off, put off
exuro	to burn out, burn up, consume
ejectio	
ejecto	
ejectus	
Elephantida	
Eleusinus	
Elpias	
Empedocles	
Ennius	
Eos	
Ephesii	
Ephesius	
Ephesus	
Epicharmus	
Epicurus	
Epimachum	
Epitoxidos	
Eptabolo	
Eptagonum	
Equestris	
Eratosthenes	
Erythrae	
Erythraei	
Erythraeus	
Erythras	
Etruria	
Etrusci	
Etruscus	
Euangelus	
Euctemon	
Eudoxus	
Eumenicae	
Euphranor	
Euphrates	
Euripides	
faber	
fabrica	a joiner's shop, smith's shop, workshop
fabricatio	a structure, construction
fabricatus	
fabrico	to make, build, construct, erect
fabricor	to make, frame, forge, construct, build
fabrilis	of an artificer
fabrio	
fabula	a narration, narrative
facies	appearance, form, figure, shape, build
facilis	easy to do, easy, without difficulty
facilitas	easiness, ease, facility, readiness
facio	to make, construct, fashion, frame, build, erect, produce, compose
factio	a making, doing, preparing
factum	a deed, act, exploit, achievement
factus	elaborate, finished, artistic
facultas	capability, possibility, power, means, opportunity, skill, ability
facundus	speaking easily, fluent, eloquent
faecem	
faex	grounds, sediment, lees, dregs
fagus	a beech-tree
fallo	to trip, cause to fall
falso	untruly, unfaithfully, deceitfully, falsely, erroneously
falsum	an untruth, falsehood, fraud, deceit
falsus	deceptive, feigned, spurious, deceitful, false, pretended, delusive, unfounded
fama	a report, rumor, saying, talk, tradition
familia	the slaves in a household, a household establishment, family servants, domestics
familiaricus	
familiaris	of a house, of a household, belonging to a family, household, domestic, private
fano	
fanum	a shrine, sanctuary, temple
farcio	to stuff, cram
farina	flour, meal
farnus	
farraria	
farrarius	
fartum	
fartura	
fartus	
fascia	a band, band age, swathe, girth, fillet
fasciculus	a small bundle, packet
fascio	
fastigatus	pointed, sharp, wedge-shaped
fastigium	the top of a gable, gable end, pediment
fastigo	
fauces	the upper part of the throat, pharynx, throat, gullet
favilla	cinders, hot ashes, glowing ashes, embers
favonio	
favonium	
favonius	
favor	favor, good-will, inclination, partiality
favus	a honey-comb
fax	a torch, firebrand, flambeau, link
febrio	
febris	a fever
felicitas	fertility, happiness, felicity, good-fortune, luck
felicito	
femina	a female, woman
feminibus	
femino	
feneratoribus	
fenestra	an opening for light, window
fenestro	
fenilia	
fera	a wild beast, wild animal
fere	closely, quite, entirely, fully, altogether, just
ferio	to strike, smite, beat, knock, cut, thrust, hit
fero	to bear, carry, support, lift, hold, take up
ferramentum	
ferrati	
ferratus	furnished with iron, iron-shod, ironed
ferreus	made of iron, iron
ferrum	iron
ferula	a reed, whip, rod, ferule, staff
ferus	wild, untamed, uncultivated
ferveo	to be boiling hot, boil, ferment, glow, steam
fervesco	
fervidus	glowing, burning, fiery, fervid
fervo	to boil, be hot, glow, rage, blaze
fervor	a boiling heat, violent heat, raging, boiling, fermenting
festucationibus	
festucato	
festum	a holiday, festival, festal banquet, feast
festus	of holidays, festive, festal, solemn, joyful, merry
fetus	
fibula	a fastening, clasp, buckle, pin, latchet, brace, brooch
fibulatio	
fibulo	
fictilia	
fictilis	made of clay, earthen, fictile
fidelis	trusty, trustworthy, faithful, sincere, true
fides	
fido	to trust, confide, put confidence in, rely upon
fiducia	trust, confidence, reliance, assurance
fiducio	
fidus	trusty, trustworthy, faithful, sure, credible
figlinum	
figo	to fix, fasten, drive, thrust in, attach, affix, post, erect, set up
figulus	a potter
figura	a form, shape, figure
figuratio	
figuro	to form, fashion, shape
filex	
filia	a daughter
filius	a son
fingo	to touch, handle
finio	to limit, bound, enclose within boundaries
finis	that which divides, a boundary, limit, border
finitio	
fio	
firmitas	firmness, durability, strength, vigor
firmiter	steadfastly, immovably, fixedly
firmo	to make firm, strengthen, fortify, sustain
firmus	strong, steadfast, stable, enduring, powerful
fistucatio	
fistula	a pipe, tube, water-pipe
fistulosus	
flaccesco	to wither, droop, languish
flagro	to flame, blaze, burn
flaminium	the office of flamen
flaminius	
flamma	a blazing fire, blaze, flame
flammo	to kindle, inflame, blaze, burn
flatura	
flatus	a blowing, breathing, snorting
flecto	to bend, bow, curve, turn, turn round
flexura	
flexus	
flo	to blow
florem	
floreo	to bloom, blossom, flower
floribus	
floridus	in bloom, flowering
florus	bright, gleaming
flos	a blossom, flower
fluctus	a flood, flow, tide, wave, billow, surge
fluento	
flumen	a flowing, flood, stream, running water
fluo	to flow, stream,
fluviaticus	
focus	a fire-place, hearth
fodio	to dig, dig up
foliatura	
folium	a leaf
folleo	
follis	a pair of bellows
fons	a spring, fountain, well, source
fontalis	
fonticulus	a little spring
for	to speak, say
foramen	an opening, aperture, orifice, hole
forensis	of the market, of the forum, public, forensic
fores	
forfices	
fori	
forio	
foris	
forma	a form, contour, figure, shape, appearance, looks
formatio	
formica	an ant, pismire
formo	to shape, fashion, form, build
formosus	finely formed, beautiful, handsome
formus	
fornace	
fornacem	
fornacibus	
fornacula	a small oven, little furnace
fornicatio	
fornix	an arch, vault, cellar
foro	
fors	chance, hap, luck, hazard, accident
fortasse	perhaps, peradventure, probably, possibly
fortis	strong, powerful, mighty
fortitudo	strength, force
fortuitus	happening by chance, casual, accidental, fortuitous
fortuna	chance, hap, luck, fate, fortune
fortuno	to make prosperous, make happy, speed, further, prosper, bless
forum	an open space, public place, court, market-place
forus	a gangway
fossa	a dilch, trench, fosse
fossicius	
fossio	a digging
fosso	
fossor	a digger, delver, ditcher
fossura	
foveo	to warm, keep warm
fraces	
fragilis	easily broken, brittle, fragile
fragor	a crashing, crash, noise, din
frango	to break in pieces, dash to pieces, shiver, shatter, fracture
fraxinus	
frequens	often, regular, constant, repeated, assiduous
frequentia	an assembling in great numbers, concourse, multitude, crowd, throng
fretum	a strait, sound, channel
fretus	leaning, supported, relying, depending, trusting, daring, confident
fricatura	
fricatus	
frico	to rub, rub down
frigida	
frigidarium	
frigidarius	
frigido	
frigidum	
frigidus	cold, cool, chill, chilling
frigor	
frigus	cold, coldness, coolness, chilliness
frio	
frondeo	to put forth leaves, be in leaf, become green
frons	
frontati	
fructus	an enjoying, enjoyment, delight, satisfaction
frumentarius	of corn
frumentum	corn, grain, harvested grain
fruor	to derive enjoyment from, enjoy, delight in
fugio	to flee, fly, take flight, run away, make off
fugo	to cause to flee, put to flight, drive off, chase away, rout, discomfit
fulcio	to prop up, keep up by props, stay, support
fulgeo	to flash, lighten
fulgur	flashing lightning, lightning
fulgurio	
fuligo	soot
fullonica	
fullonicus	
fulmenta	
fulmentum	
fultura	a prop, support
fultus	
fumo	to smoke, steam, reek, fume
fumus	smoke, steam, fume
funda	a sling
fundamentum	a foundation, ground-work, basis
fundatio	
fundo	
fundula	
fundulus	
fundus	the bottom, lowest part
funis	a rope, sheet, line, cord
furca	a two-pronged fork
furcilla	a little fork, pitchfork
furnus	an oven
furor	
furtum	theft, robbery
fusco	to make swarthy, blacken
fuscus	dark, swarthy, dusky, tawny
fusio	an outpouring, effusion
fusterna	
fusus	
futurus	going to be, yet to be, to come, future
F	
Faberius	
Falernum	
Faliscus	
Fanestri	
Faunius	
Faunus	a mythical king of Latium, worshipped as the Italian Pan
FC	
Ferentinum	a small town of Latium
Fidenates	
Flaminius	
Flora	
Forentum	
Fortuna	
FS	
Fuficius	
Fundi	
FZ	
gallica	
gallicus	
gaudium	inward joy, joy, gladness, delight
gelicidium	
gemellus	born together, twin-born, twin-
gemini	
geminus	born together, twin-born, twin-
gemma	a bud, eye, gem
gemmo	to put forth buds, bud, gem
gener	a daughter's husband, son-in-law
generatim	by kinds, by species, in classes, in detail
genero	to beget, procreate, engender, produce, create
genethlialogiae	
geniculatus	having knots, hnotted
geniculo	
geniculum	
geniculus	
gens	a race, clan, house
genu	a knee
genuorum	
genus	
geometres	a geometer
geometria	geometry
geometrica	
geometrice	
geometricus	of geometry, geometrical.—Plur. n
gero	to bear about, bear, carry, wear, have, hold, sustain
gerusia	
gesta	deeds, acts, achievements
gestio	
gestus	bearing, carriage, posture, attitude, motion, gesture, movement, action, sign
gladiator	a swordsman, gladiator, fighter
gladiatorium	
gladiatorius	of gladiators, gladiatorial
glaeba	a lump of earth, clod
glaebula	a little piece of earth, bit of land
glarea	gravel
glareosus	full of gravel
gloria	glory, fame, renown, praise, honor
glorior	to boast, vaunt, glory, brag, pride oneself
gloriosus	full of glory, glorious, famous, renowned
glutino	
glutinum	
gnomon	
gnomonica	
gnomonice	
gnomonici	
gnomonicus	
gorgoneum	
gracilis	thin, slight, slender, slim, meagre, lean
gracilitas	slenderness, thinness, leanness, meagreness
gracilus	
gradatim	step by step, by degrees, little by little, gradually
gradatio	a climax
grados	
gradus	a step, pace, gait, walk
graeca	
graecae	
graece	
graeci	
graecis	
graecorum	
grammatica	grammar, philology
grammatice	
grammaticus	of grammar, grammatical
grammicus	
granaria	a store-house for corn, granary
granarium	
grandio	
grandis	full-grown, large, great, full, abundant
graneus	
graphicoteran	
graphidis	
graphidos	
grassor	to go, move, go about
gratia	favor, esteem, regard, liking, love, friendship, partiality
gratuitus	done without pay, not for reward, free, spontaneous, voluntary, gratuitous
gratus	beloved, dear, acceptable, pleasing, agreeable
gravis	heavy, weighty, ponderous, burdensome, loaded, laden, burdened
gravitas	weight, heaviness
gravitudo	
gravo	to make heavy, load, burden, weigh down, weight, oppress
groma	
gruem	
grumus	
gubernaculum	a helm, rudder
gubernator	a steersman, helmsman, pilot
guberno	to steer, pilot
gummus	
gusto	to taste, take a little of
gutta	a drop
guttur	the gullet, throat, neck
gutus	a narrow-necked flask, cruet, oil-flask
gymnasium	a Grecian school for gymnastic training, gymnasium
gynaeconitis	the women's apartments
gypsum	white lime plaster gypsum
G	
Gades	
Gaditani	
Gaditanus	
Gaius	
Gallia	
Gallicus	
Gallius	
Ganges	
Gn	
Gnosius	
Gnosus	
Gortyna	
Graece	in the Greek language, in Greek
Graeci	
Graecia	
Graecum	
Graecus	of the Greeks, Greek, Grecian
Graius	of the Greeks, Grecian, Greek
habentia	
habeo	to have, hold, support, carry, wear
habitatio	a dwelling, habitation
habitator	a tenant, occupant, inhabitant
habito	to dwell, abide, reside, live
haedus	a young goat, kid
haereo	to hang, stick, cleave, cling, adhere, hold fast, be fixed, sit fast, remain close
haeresim	
harena	sand
harenaria	a sand-pit
harenarium	
harenarius	
harenatio	
harenatum	
harenatus	
harenosa	
harenosum	
harenosus	full of sand, sandy
harmonia	an agreement of sounds, consonance, concord, harmony
harmonice	
harmonicus	
harundo	a reed, cane
haruspex	a soothsayer, diviner, inspector of the entrails of victims
haurio	to draw up, draw out, draw
haustrum	
hedera	ivy, ivy-vine
helepolis	
helice	
helix	
hemicyclium	a semicircle, semicircular recess, with seats
hemicyclus	
hemimetopia	
hemisphaerium	
hemitonium	
hemitriglyphus	
herba	an herb, grass, green blades, herbage, turf
hexachordos	
hexaphorum	
hexastyli	
hexastylon	
hexastylos	
hiberna	
hibernacula	tents for winter-quarters, an encampment for winter, winter tents
hibernaculum	
hiberno	to pass the winter, winter, occupy winter-quarters
hibernum	
hibernus	of winter, wintry, winter-
hic	
hiemo	to winter, pass the winter, keep winter-quarters
hiems	the winter, winter time, rainy season
hippopotamus	
hirundo	a swallow
hispanico	
historia	a narrative of past events, history
hodie	to-day
hodiernus	of this day, to-day's
holeribus	
holero	
homo	a human being, man, person
homotonus	
honestas	honor received from others, repute, consideration, honor, reputation, character, respectability, credit
honestum	honesty, integrity, virtue
honestus	regarded with honor, respected, honored, of high birth, distinguished, honorable, respectable, noble
honor	
honoro	to honor, respect, adorn, ornament, embellish, decorate
honorus	conferring honor, honorable
hora	an hour
horae	
horizon	
horologium	a clock, horologe, sun-dial, water-clock
horresco	to rise on end, stand erect, bristle up, grow rough
horreum	a storehouse, barn, granary, magazine, cellar
horridus	standing on end, rough, shaggy, bristly, prickly
horto	
hortor	to urge, press, incite, instigate, encourage, cheer, exhort
hortus	a garden, pleasure-garden
hospes	an entertainer, host
hospitalia	
hospitalis	of a guest, of a host, hospitable
hospitium	a hospitable reception, entertainment
hostia	an animal sacrificed, victim, sacrifice
hostile	
hostilis	of an enemy, enemy's, hostile
hostio	
hostis	a stranger, foreigner
hostus	
huc	to this place, hither
humana	
humani	
humanitas	human nature, humanity
humanum	
humanus	of man, human
humile	
humilis	low, lowly, small, slight
hydraletes	
hydraula	
hydraules	
hydraulicus	
hydraulus	a water-organ
hydria	a jug, ewer, urn
hydrius	
hypaethra	
hypaethroe	
hypaethros	
hypaethrum	
hypaethrus	
hypate	
hypaton	
hyperbolaeus	
hyperthyrum	
hypocausis	
hypogeum	
hypogeus	
hypomochlion	
hypotrachelium	
hysginum	
H	
Hadrianus	
Halicarnassus	
Hegesias	
Hegetor	
Hegias	
Hellados	
Hellenos	
Heraclea	
Heracleum	
Heracleus	
Heraclitus	
Herculis	
Herculius	
Hermodorus	
Hermogenes	
Herodotus	
Hierapolis	
Hiero	
Himera	
Hipparchus	
Hippocrates	
Hispania	
Hispaniae	
Homeromastix	
Homerus	
Horus	
Hostilius	
Hymettus	
Hypanis	
ibi	in that place, there
ichneumon	an Egyptian rat, ichneumon
ichnographia	
icta	
idem	the same
identidem	again and again, repeatedly, often, now and then, at intervals, ever and anon, continually, constantly, habitually
ideo	for that reason, on that account, therefore
idiota	an uneducated man, ignorant person, layman, outsider
idoneus	fit, meet, proper, becoming, suitable, apt, capable, convenient, sufficient
igitur	then, therefore, thereupon, accordingly, consequently
ignarus	ignorant, not knowing, unacquainted with, unskilled in, inexperienced, unaware
ignio	
ignis	fire
ignominia	disgrace, dishonor, ignominy
ignosco	to pardon, forgive, excuse, overlook, allow, indulge, make allowance
ignotitiam	
ignotum	
ignotus	unknown, strange, unrecognized, unfamiliar
iii	
illa	in that way, in that direction, there
ille	dem
illic	
illustris	
imagino	
imago	an imitation, copy, image, representation, likeness, statue, bust, picture
imbecillis	
imbecillitas	helplessness, imbecility, weakness, feebleness
imbecillus	weak, feeble
imber	a rain, heavy rain, violent rain, shower, pouring rain
imbrico	
imbrium	
imbuo	to wet, moisten, soak, steep, saturate
imi	
imitabilis	that may be imitated, imitable
imitatio	a copying, imitation
imitatus	fictitious
imito	
imitor	to imitate, act like, copy after, seek to resemble, counterfeit, mimic
immanis	monstrous, enormous, immense, huge, vast
imminutus	weak
immissarium	
immoderatus	boundless, immeasurable
immolo	to sprinkle with sacrificial meal
immortalis	undying, immortal
immortalitas	exemption from death, immortality, endless life
immotus	unmoved, immovable, motionless
immutabilis	unchangeable, unalterable, immutable
immutatio	an interchange, substitution
immutatus	unchanged, unaltered
impages	
impeditio	a hinderance, obstruction
impensa	disbursement, expenditure, outlay, cost, charge, expense
impense	exceedingly, greatly, very much, earnestly, eagerly, zealously
imperator	a commander-in-chief, general
imperatum	a command
imperatus	
imperitus	inexperienced, unversed, unfamiliar, not knowing, unacquainted with, unskilled, ignorant
imperium	a command, order, direction, injunction
impero	to command, order, enjoin, bid, give an order: Pa
impetro	to gain one's end, achieve, bring to pass, effect, get, obtain, procure
impetus	an attack, assault, onset
impio	
impius	irreverent, ungodly, undutiful, unpatriotic, abandoned, wicked, impious
impleo	to fill up, fill full, make full, fill
implico	to infold, involve, entangle, entwine, inwrap, envelop, encircle, embrace, clasp, grasp
impressus	unpressed, not milked
improbe	badly, wrongly, wickedly, recklessly
improbus	not good, bad, wicked, reprobate, abandoned, vile, base, impious, bold, shameless, wanton
improvide	recklessly, improvidently
improviso	on a sudden, unexpectedly
improvisum	
improvisus	not foreseen, unforeseen, unexpected
imprudens	not foreseeing, not expecting, without knowing, unaware, unsuspecting, ignorant, inconsiderate, heedless, inadvertent
impudicus	shameless, impudent, without modesty
impulsus	a striking against, push, pressure, shock, impulse
imum	
imus	the lowest, deepest, last
in	unequal
inaequalis	uneven
inane	an empty space, void, open space
inanio	
inanis	empty, void
inaresco	
inauratus	gilded, golden
inauro	to overlay with gold
incedo	to advance, march, proceed, stride, move, stalk, strut
incendium	a burning, fire, conflagration
incendo	to set fire to, kindle, burn
incense	
incensum	
incensus	
incepto	to begin, attempt
inceptum	a beginning
inceptus	a beginning, undertaking
incerno	to sift in, add with a sieve
incerto	
incertum	
incertus	not fixed, unsettled, undetermined
incesso	to fall upon, assault, assail, attack
incido	
incipio	to take hold, take in hand, begin
incitatus	hurried, rapid, swift, at full speed
incito	to set in rapid motion
inclinatio	a leaning, bending, inclining
inclinatus	inclined, disposed, prone
inclino	to cause to lean, bend, incline, turn, divert
includo	to shut up, shut in, confine, enclose, imprison, keep in
incola	an inhabitant, resident
incolumis	unimpaired, uninjured, unharmed, safe, sound, entire, whole
incommodo	to occasion inconvenience, be inconvenient, trouble, annoy
incommodum	inconvenience, trouble, disadvantage, detriment, injury, misfortune, loss
incommodus	inconvenient, unsuitable, unfit, unseasonable, troublesome, disagreeable
inconsuetus	
incorruptus	unspoiled, uninjured, uncorrupted
incredibilis	not to be believed, incredible, beyond belief, extraordinary, unparalleled
incremento	
incrementum	growth, increase, augmentation
incubo	to lie upon, rest on
incumba	
incumbo	to lay oneself, lean, press, support oneself
incurro	to run into, run upon, rush at, make an attack
incursus	a running to, hurried approach, rush, dash
indagatio	a tracking out, investigation
indagator	
inde	from that place, thence
indecentia	
indeceo	
index	one who points out, a discloser, discoverer, informer, witness
indicibus	
indicium	a notice, information, discovery, disclosure, charge, evidence
indico	
indictus	not said, unsaid
indicum	
indigeo	to need, want, stand in need of, demand, require
indignor	to deem unworthy, be indignant, despise, resent, be offended
individuum	an atom, indivisible particle
individuus	indivisible
indo	to put into, insert
indoctus	untaught, unlearned, uninstructed, ignorant, unskilful
induco	to lead in, bring in, introduce, conduct, lead up, bring forward
inductio	a bringing in, introducing, production, admission
inductor	
inductus	
indulgeo	to be complaisant, be kind, be tender, exercise forbearance, incline, yield, indulge, concede, grant, allow
industria	diligence, activity, assiduity, industry, zeal
industrius	active, diligent, assiduous, industrious
ineo	to go into, enter
inertia	want of art, unskilfulness, ignorance, rudeness
infamia	ill fame, ill report, bad repute, dishonor, disgrace, infamy
infamis	of ill repute, disreputable, notorious, infamous
infectiva	
infectivus	
infectus	not done, unwrought, unmade, undone, unaccomplished, unfinished
infer	
inferiores	
inferius	lower, further down
infernates	
infernus	lower, under
inferus	below, beneath, underneath, lower
infestus	made unsafe, disturbed, molested, infested, unquiet, unsafe
inficiens	
inficio	to stain, tinge, dye, color
infigo	to fasten, implant, drive in, affix
infimae	
infimo	
infimus	lowest, last
infinitas	boundlessness, endlessness, infinity
infinitum	
infinitus	not limited, infinite, endless, boundless, unlimited
infirma	
infirmis	
infirmo	to weaken, invalidate, disprove, refute, impair, annul
infirmus	not strong, weak, feeble, infirm
inflatio	a puffing up, flatulence
inflo	to blow into, blow, inflate, swell
influo	to flow in, run in
infra	
infractus	broken, exhausted, weakened, subdued
infringo	to break off, break, bruise
infundibulum	
infundo	to pour in, pour upon
infusus	
ingeniculo	
ingeniosus	full of intellect, superior in mind, able, intellectual, clever, ingenious
ingenium	innate quality, nature, temperament, constitution
ingenua	
ingenuus	native, indigenous
ingratus	unpleasant, disagreeable, unacceptable
ingredior	to advance, go forward, march, proceed
ingressus	an advancing, walking, gait
inhonestus	dishonorable, disgraceful, shameful
inibi	therein, in that place, there
inimica	
inimicus	unfriendly, hostile, inimical
iniquitas	inequality, unevenness
iniquo	
iniquus	uneven, slanting, steep
initio	to begin, initiate, consecrate, admit
initium	a going in, entrance
in-ligo	
inlinienda	
in-lumino	
in-minuo	
in-mitto	
innitor	to lean upon, support oneself by
innumerabilis	countless, innumerable, immeasurable, immense
inopia	want, lack, scarcity
inops	without resources, helpless, weak
in-pareo	
in-pario	
in-paro	
inpediant	
inpediatur	
inpedient	
inpediente	
inpedientes	
inpedientur	
inpedierit	
inpedietur	
inpedire	
inpedirent	
inpediti	
in-pedito	
inpediundo	
inpediuntur	
in-pedo	
in-pello	
in-pendeo	
in-pendo	
inplicata	
in-plumbo	
in-pono	
in-porto	
inprimantur	
in-probo	
inquam	to say
inquinamentum	
inquino	to befoul, stain, pollute, defile
in-rigo	
in-ruo	
inscribo	to write upon, inscribe
inscriptum	
inscriptus	
insculpo	to cut in
insecabilis	
inseco	to cut into, cut up
in-sedeo	
insemino	
insequor	to follow, follow after, come next
insideo	to sit upon, settle on
insidiae	a snare, trap
insido	to sit in, settle on
insipiens	unwise, foolish
inspicio	to look into, look upon, inspect, consider, contemplate, examine, survey
instinctus	instigation
instinguo	to instigate, incite, impel
instituo	to put in place, plant, fix, set
institutio	disposition, arrangement
institutum	a purpose, intention, design
insto	to stand upon, take a position
instructio	an array
instruo	to build in, insert
insuavis	unpleasant, disagreeable
insuesco	to habituate oneself, become accustomed, be inured
insula	an island, isle
insum	to be in, be upon
insumo	to take for, apply, expend
insuper	above, on the top, overhead
intactus	untouched, uninjured, intact
integer	untouched
integritas	completeness
integro	to make whole
intellectus	a perception, discernment
intellego	to come to know, see into, perceive, understand, discern, comprehend, gather
inter	between, betwixt
interaresco	to become dry, dry up, decay
intercapedo	an interruption, interval, respite
intercardinatus	
intercludo	to shut out, shut off, cut off, hinder, stop, block up, intercept
intercolumnium	a space between two columns, intercolumniation
intercurro	to run between, intervene, mediate
interdum	sometimes, occasionally, now and then
interea	meanwhile, in the meantime, in the interim
intereo	to go among, be lost
interfacio	
interficio	to put out of the way, destroy, bring to naught
interim	meanwhile, in the meantime
interimo	to take from the midst, take away, do away with, abolish
interior	inner, interior, middle
interiora	
interiores	
interitio	destruction, ruin
intermissio	a breaking off, intermission, interruption, discontinuance
interpellatio	a speaking between, interruption
interpello	to interrupt, break in upon
interpensiva	
interpensivus	
interpono	to put between, place among, interpose, insert, intersperse
interpositio	an insertion, introduction
interpretor	to explain, expound, interpret, understand, conclude, infer, comprehend
interrogo	to ask, question, inquire, interrogate
interscalmium	
interseco	
intersectio	
intertignium	
intervallo	
intervallum	the space between palisades, an intermediate space, interval, distance
intervenium	
interverto	to turn aside, divert, intercept, embezzle, squander
intervorto	
intestina	
intestini	
intestinum	a gut
intestinus	inward, internal, intestine
intexo	to weave in, inweave, interweave, plait, join together, interlace, surround, envelop
intextus	
intinctus	
intingo	to dip, soak
intorqueo	to twist, wind about, fold, wrench, distort
intra	
intrinsecus	
intro	
introeo	to go in, enter
introeuntibus	
introitus	a going in, entering, entrance
introrsus	inwards, within
intus	on the inside, within
inus	
inusitatus	unusual, uncommon, extraordinary, very rare
inutilis	useless, unserviceable, unprofitable
invector	
invectus	
inveho	to carry in, bring to, introduce
invenio	to come upon, find, meet with, light upon
inventio	the faculty of invention
inventor	a contriver, author, discoverer, inventor
inventum	an acquisition:
inventus	
invenustus	without charm, ungraceful, unattractive
inversura	
inverto	to turn upside down, turn about, upset, invert, reverse
invictus	unconquered, unsubdued, unconquerable, invincible
invidiose	enviously, hatefully
invidiosus	full of envy, invidious
invidus	envious, envying
invisitatus	unseen, unknown
invito	to invite, treat, feast, entertain
invocatus	uncalled, without a summons
invoco	to call upon, invoke, appeal to
involutio	
involuto	
involvo	to roll, roll upon
injecto	
injuria	
injurius	
iocinera	
iocinerum	
ionica	
ionicae	
ionicam	
ionicarum	
ionice	
ionici	
ionicis	
ionico	
ionicorum	
ionicum	
ipse	Self, in person
ira	anger, wrath, rage, ire, passion, indig nation
is	he, she, it, the one mentioned
isodomum	
iste	this, that, he, she
ita	in this manner, in this wise, in such a way, so, thus, accordingly, as has been said
italicae	
italico	
item	likewise, besides, also, further, moreover, too, as well
iter	a going, walk, way
iterum	again, a second time, once more, anew
itis	
ito	to go
itus	a going away, departure
Ictinos	
III	
IIII	
IK	
Ilias	
Ilienses	
India	
Indus	
Iollas	
Ion	
Ionas	
Iones	
Ionia	
Ionica	
Ionicus	
Ionius	
Iope	
Isidi	
Ismuc	
Isodomum	
Isthmia	the Isthmian games
Isthmius	
ISK	
Italia	
Iulius	Julian, of Julius
Iuppiter	Jupiter, Jove, son of Saturn, brother and husband of Juno, chief of the gods, god of the sky
IX	
k	
K	
labes	a falling, sinking in, subsidence
labidus	
labium	a lip
labo	to totter, be ready to fall, begin to sink, give way, be loosened
labor	
laboro	to labor, take pains, endeavor, exert oneself, strive
labrum	
lac	milk
lacerta	a lizard
laconici	
laconicum	
lacrima	a tear
lacrimo	to shed tears, weep
lacta	
lacteo	
lactes	
lacuna	a ditch, pit, hole, pool, pond
lacunar	a wainscoted and gilded ceiling, panel-ceiling, ceiled roof
lacunaria	
lacunarium	
lacunarius	
lacuno	to panel, chequer
lacunosus	full of hollows
lacus	an opening, hollow, lake, pond, pool
laedo	to hurt, wound, injure, damage
laeva	the left hand
laevus	left, on the left side
lambo	to lick, lap, touch
lamella	
lamina	a thin slice, plate, leaf, layer, lamina
lamminae	
lamminas	
lamminis	
lana	wool
lanatae	
lanatus	bearing wool, woolly
lancula	
lanifica	
lanificus	that works in wool, spinning, weaving
lapideus	of stone, consisting of stones, stone-
lapidicinae	
lapidicinis	
lapido	to stone, throw stones
lapio	
lapis	a stone
laqueus	a noose, snare
largiter	in abundance, much
larignus	
laser	
latens	lying hid, hidden, concealed, secret, unknown
lateo	to lurk, lie hid, be concealed, escape notice, skulk
later	a brick, tile
lateraria	
laterarius	
laterculum	
laterculus	
latericium	
latericius	made of bricks
latino	
latitudo	breadth, width
latrocinium	freebooting, robbery, highway-robbery, piracy
latus	
laudo	to praise, laud, commend, honor, extol, eulogize, approve
laureatae	
laureatus	crowned with laurel, laureate, laurelled
laus	praise, commendation, glory, fame, renown, esteem
lavatio	a bathing, bath, bathing apparatus
lavo	to wash, bathe, lave
laxamentum	a relaxation, mitigation, alleviation, respite
laxatio	
laxus	wide, loose, open, spacious, roomy
lecto	to be punished, suffer punishment, be beaten
lector	a reader
lectum	
lecturio	
lectus	
legitima	
legitimus	fixed by law, according to law, lawful, legal, legitimate
lego	
legumen	pulse, a leguminous plant
lena	a bawd, procuress
lenio	to soften, mollify, moderate, assuage, soothe, calm
lenis	soft, smooth, mild, gentle, easy, calm
leno	a pimp, pander, procurer
lentitudo	sluggishness, dulness, apathy, insensibility
lento	to make flexible, bend
lentus	pliant, flexible, tough, tenacious, sticky, viscous
leo	a lion
leoninus	
lepor	
lesbium	
leuconotus	
leucophaeus	
levatio	an alleviation, mitigation, relief
levatus	
levigatio	
levigatus	
levigo	
levis	
levitas	
levo	
lex	a formal proposition for a law, motion, bill
liaculorum	
libella	an as, the tenth of a denarius
liber	free, unrestricted, unrestrained, unimpeded, unembarrassed, unshackled
liberi	free persons
libero	to set free, free, liberate, manumit
liberta	a freedwoman
libertas	freedom, liberty, absence of restraint, permission
libertus	a freedman, emancipated person
libet	it pleases, is pleasing, is agreeable
libido	pleasure, desire, eagerness, longing, fancy, inclination
libo	to take out as a sample, take a little of
libonotus	
libra	a balance, pair of scales
libramentum	a weight, load
librarium	
librarius	of books, belonging to books
libratio	
libro	to poise, balance, hold in equilibrium
liceo	to be for sale, be priced, be valued
liceor	to bid, make a bid
licet	It is lawful, is allowed, is permitted
lichanos	
licita	
lienis	
lienosus	
lignatio	a procuring of wood
ligneus	of wood, wooden
lignum	gathered wood, firewood
ligula	a shoe-strap, shoe-latchet
lima	a file
limen	a cross-piece, threshold, head-piece, lintel, sill
liminaris	
limis	
limosa	
limosus	full of mud, slimy, miry, muddy
limpido	
limpidus	limpid, transparent
limus	slime, mud, mire
linea	a linen thread, string, line, plumb-line
linearentur	
lineatio	
lineus	of flax, of lint, flaxen, linen-
lingua	the tongue
lingulatus	
lingulus	
liniantur	
linteum	a linen cloth
linteus	of linen, linen-
linuntur	
lio	
lipara	
lippio	to have watery eyes, be blear-eyed
lippus	blear-eyed, bleared, inflamed
liquefacio	to make liquid, melt, dissolve, liquefy
liquesco	to become fluid, melt, liquefy
liquidum	
liquidus	flowing, fluid, liquid
liquo	to make liquid, melt, dissolve, liquefy
liquor	
littera	a letter, alphabetical sign, written sign of a sound
litteratura	a writing
litteratus	lettered, learned, liberally educated
litus	the sea-shore, sea-side, beach, strand
livido	
lividus	of a leaden color, bluish, blue
locatio	a letting out, leasing
locator	a lessor
locatorius	
loco	to place, put, lay, set, dispose, arrange
locothomus	
loculamentum	
locum	
locus	a place, spot
logeum	archives
longitudo	length
longus	long, extended
lora	
lorica	a leather cuirass, corselet of thongs
loricatio	
lorico	
lorum	a thong, strap, strip of leather
lorus	
lota	
lotio	
luceo	to be light, be clear, shine, beam, glow, glitter
lucerna	a lamp, oil-lamp
luci	by daylight
lucidus	full of light, clear, bright, shining, brilliant
lucifer	lightbringing
lucius	
lucus	
ludius	a stage-player, pantomimist
ludo	to play, play at a game
ludor	
ludus	a play, game, diversion
lum	
lumen	light
lumino	
luminosus	full of light, luminous, conspicuous
lumnas	
luna	the moon
lunaris	of the moon, lunar
luno	to bend like a halfmoon, crook
lus	
luteum	
luteus	
luto	
lutosus	
lutum	
lutus	
lux	light, brightness
lyra	a lute, lyre
lyron	
lysis	
L	
Lacedaemon	
Laco	a Laconian, Lacedaemonian, Spartan
Lacones	
Laconicum	
Laconicus	of Laconia, Laconian, Lacedaemonian
Laodicensium	
Larix	
Lebedus	
Lelegas	
Lemnos	
Leochares	
Leocharis	
Leonidas	
Leonides	
Lesbos	
Licymnius	
Lipara	
Liparae	
Liparis	
Lucani	
Lucanus	of Lucania
Lucius	
Lucretius	
Luna	
Lusitania	
LX	
LXIII	
LXXX	
Lydia	
Lydion	
Lydius	
Lyncestus	
Lysippus	
maceratio	
macero	to make soft, make tender, soften, soak, steep, macerate
machina	a machine, engine
machinatio	a contrivance, mechanism, mechanical artifice
machinatus	
machinor	to contrive skilfully, devise, design, frame, invent
macritas	
macula	a spot, mark, stain
maenianaque	
maenianorum	
magis	
magistra	a mistress, directress
magistratus	the office of master, magisterial office, civil office, magistracy
magistro	
magnes	of Magnesia
magnificenter	
magnificentia	loftiness, grandeur, nobleness, high-mindedness
magnifico	to make much of, set a high value on
magnificus	great, elevated, noble, distinguished, eminent, august
magnitudo	greatness, size, bulk, magnitude
magnus	
magus	
mala	the cheek-bone, jaw
maleficum	
maleficus	nefarious, vicious, wicked, criminal
malleolus	a short, set
malo	to choose rather, prefer
malum	
malus	an upright pole, beam, mast
mammatus	
mammo	
mancipium	a taking by hand, formal acceptance, taking possession, seisin, legal purchase
mando	
maneo	to stay, remain, abide, tarry
manes	a departed spirit, ghost, shade
manifestus	palpable, clear, plain, apparent, evident, manifest
mano	to flow, run, trickle, drop, drip
manon	
manos	
mansuetam	
manubiae	booty, money obtained by the sale of booty, prize-money
manubius	
manubrium	a handle, hilt, haft
manucla	
manupretium	a workman's pay, artisan's hire, wages
manus	a hand
marcesco	to become weak, grow feeble, pine away, waste, languish
marcidus	withered, wilted
mare	the sea
margarita	a pearl
margaritum	
margino	to border, enclose
margo	an edge, brink, border, margin
marinus	of the sea, sea-, marine
maritima	
maritimus	of the sea, sea-, marine, maritime
marmor	marble, a block of marble
marmorarius	
marmoreus	made of marble, marble-
martes	
marum	
masculus	male, masculine
massa	kneaded dough
masso	
mater	a mother
materia	stuff, matter, material, timber, substance
materiatio	
materiatura	
materies	
materio	
materior	to procure wood
mathematicus	a mathematician
matrona	a married woman, wife, matron
matronalis	of a married woman, of a matron, womanly, matronly
maturitas	ripeness, maturity
maturo	to make ripe, ripen, bring to maturity
maturus	ripe, mature
matutinum	
matutinus	of the morning, morning-, early
maxime	in the highest degree, most particularly, especially, exceedingly, altogether, very
maximus	large, great, big, high, tall, long, broad, extensive, spacious
majestas	
majores	
majus	
mechanica	
mechanicus	
medeor	to heal, cure, remedy, be good for
medianum	
medianus	
medica	Median clover, Burgundy-clover, lucern
medicamentosus	
medicamentum	a drug, remedy, antidote, physic, medicine, medicament
medicina	the healing art, medicine, surgery
medicinus	
medico	to imbue with healing power, medicate, drug
medicor	to heal, cure
medicus	
medio	
mediocris	of middling size, medium, middling, moderate, ordinary
mediocritas	a middle state, medium, mean, moderateness, moderation
mediocriter	moderately, tolerably, ordinarily, not very, not remarkably, slightly, somewhat
medion	
meditatio	a thinking over, contemplation, dwelling upon
mediterraneum	
mediterraneus	inland, remote from the sea, mediterranean, continental
medium	the middle, midst, centre, interval, intervening space
medius	in the middle, in the midst, mid, mean, middle
medulla	marrow
megalographia	
mei	
meio	to make water
mel	honey
melinum	
melinus	
meliores	
melioro	
meliton	
mella	
mellum	
melo	
melos	a tune, air, strain, song, lay
membratura	
membro	
membrum	a limb, member
memor	mindful, remembering, heedful
memoria	memory, remembrance
memoro	to bring to remembrance, mention, recount, relate, speak of, say, tell
menaeus	
mendosus	full of faults, faulty, blemished
mens	the mind, disposition, feeling, character, heart, soul
mensa	a table
mensis	a month
menstrua	
menstruo	
menstruum	
menstruus	of a month, of every month, monthly
mensura	a measuring, measurement
mensuro	
mensus	
menta	mint
mentior	to invent, assert falsely, lie, cheat, deceive, pretend
mento	
mentum	the chin
meo	to go, pass
mercatus	trade, traffic, bargaining, buying and selling
merces	price, hire, pay wages, salary, fee, reward
mercis	
mercor	to trade, traffic, deal in, buy, purchase
mereo	to deserve, merit, be entitled to, be worthy of
mereor	to deserve, merit, be entitled to
meridiana	
meridianus	of mid-day, of noon
meridies	mid-day, noon
meridio	to take a mid-day nap, have a siesta.—Supin. acc
meridior	
meritum	a merit, service, kindness, benefit, favor
merula	a blackbird, ousel, merle
mesauloe	
mese	
meses	
mesolabium	
meson	
meta	a cone, pyramid
metallum	metal
metaxa	
methodus	
metior	to measure, mete
meto	to reap, mow, crop, gather, collect, harvest
metopa	
metrum	
metuo	to fear, be afraid, stand in fear, be apprehensive
metus	fear, dread, apprehension, anxiety
meum	
meus	of me, my, mine, belonging to me, my own
mica	a crumb, bit, morsel, grain
mico	to move quickly to and fro, vibrate, quiver, shake, tremble, beat, palpitate
miles	a soldier
milesium	
miliarii	
miliarium	a mile-stone
miliarius	
milito	to be a soldier, perform military service, serve as a soldier
milium	millet
mille	a thousand, ten hundred
miniaceus	
minime	least of all, in the smallest degree, least, very little
minimus	least, smallest, very small, minute, trifling, insignificant
minio	
ministratio	
ministro	to attend, wait upon, serve
minium	red-lead
minius	
mino	
minor	
minoro	
minuo	to make small, lessen, diminish, divide into small pieces
minusculus	rather less, rather small
minutum	
mira	
mirabilis	wonderful, marvellous, extraordinary, amazing, admirable, strange, singular
mirandus	wonderful, strange, singular
miro	
miror	to wonder, marvel, be astonished, be amazed, admire
mirus	wonderful, marvellous, astonishing, extraordinary, amazing
misceo	to mix, mingle, intermingle, blend
missio	a sending, despatching
mitto	to cause to go, let go, send, send off, despatch
mixtione	
mixtionem	
mixtionibus	
mixtionibusque	
mixtionis	
mixtionum	
mobilis	easy to move, movable, loose, not firm
modicum	
modicus	in proper measure, moderate, modest, temperate
modiolum	
modiolus	
modium	
modius	a corn-measure, measure, peck
modo	by a measure, with a limit
modulatio	
modulor	to measure, measure rhythmically, modulate
modulus	a small measure
modus	a measure, extent, quantity
moenia	defensive walls, ramparts, bulwarks, city walls
mola	a millstone, grindstone
molarius	
moles	a shapeless mass, huge bulk, weight, pile, load
molestia	trouble, irksomeness, uneasiness, annoyance, molestation, vexation, distress
molesto	
molestus	troublesome, irksome, grievous, annoying, unmanageable
molio	
molior	to make exertion, exert oneself, endeavor, struggle, strive, toil
molitio	a removing, demolition
molitus	
molle	
molleo	
mollesco	to become soft, soften
mollia	
mollio	to make soft, make supple, soften
mollis	yielding, pliant, flexible, supple, soft, tender, delicate, gentle, mild, pleasant
molliter	softly, gently, agreeably
mollitudo	suppleness, flexibility, softness
molo	to grind
momentum	a movement, motion
moneo	to remind, put in mind of, admonish, advise, warn, instruct, teach
monitum	an admonition, advice, counsel, suggestion, oracle
monitus	a reminding, warning, admonition
monopteroe	
monopteros	
monotriglyphus	
mons	a mountain, mount, range of mountains
monstratio	a showing, direction, guidance
monstro	to point out, exhibit, make known, indicate, inform, advise, teach, instruct, tell
monstrum	a divine omen, supernatural appearance, wonder, miracle, portent
montanus	of mountains, belonging to mountains
monumentum	that which brings to mind, a remembrancer, memorial, monument
mora	
moratio	
moratus	
morbus	a sickness, disease, disorder, distemper, ailment, illness, malady
morior	to die, expire
moror	to delay, tarry, stay, wait, remain, linger, loiter
mors	death
mortalia	
mortalis	subjeet to death, destined to die, mortal
mortarium	a mortar
mortifera	
mortiferam	
morum	a mulberry
morus	a mulberry-tree
mos	a will, way, habit, manner, fashion, caprice, humor
motio	a moving, motion, removing
motus	a moving, motion
moveo	to move, stir, set in motion, shake, disturb, remove
muliebria	
muliebris	of a woman, womanly, feminine
mulier	a woman, female
muliero	
mulinus	of a mule
multa	much, very, exceedingly, greatly, earnestly
multi	
multiplex	with many folds, much-winding
multiplicatio	
multiplico	to multiply, increase, augment
multitudo	a great number, multitude, crowd, throng
multo	by much, much, a great deal, far, by far
multus	adjec
mundo	
mundum	
mundus	
munero	
munia	duties, functions, official duties
municipalis	of a municipality, municipal
municipibus	
municipium	a free town, town whose people were Roman citizens, governed by their own laws and magistrates
munio	to wall, defend with a wall, fortify, defend, protect, secure, strengthen
munitio	a defending, fortifying, protecting
munitus	defended, fortified, protected, secured, safe
munus	a service, office, post, employment, function, duty
muralis	of a wall, wall-, mural
murena	
muro	
murra	the myrrh-tree, an Arabian tree, of which myrrh was the sap
murus	a wall, city wall
mus	a mouse
muscarium	
muscarius	
muscus	moss
musica	the art of music, music
musice	
musicus	of music, musical
mutatio	a changing, change, alteration, mutation
mutatus	different, successive
muto	
mutuatus	
mutulus	
mutuo	mutually, in return
mutuor	to borrow, obtain as a loan
M	
Macedo	
Macedonia	
Macedonius	
Maeonia	a district of Lydia
Maeonius	of Maeonia, Lydian
Magnes	
Magnesia	
Magnesius	
Mamertini	
Mamertinus	of Mars, Mamertine
Marcius	
Mariana	
Marianus	
Mars	Mars, father of Romulus and god of war, with whose month, Martius, the Roman year began
Martius	of Mars
Masinissa	
Massilia	
Massilioticus	
Massilitani	
Massilitanum	
Mathematicus	
Mauretania	
Maurusia	
Maurusius	
Mausoleum	
Mausoleus	
Mausolus	
Maxilua	
Mazaca	
Mazacum	
MCC	
Media	
Medulli	
Medullum	
Medullus	
Mela	
Melae	
Melampus	
Melite	
Mella	
Melo	
Melos	
Menesthe	
Mercurius	Mercury, the messenger of the gods, the god of dexterity and of eloquence, of traders and thieves
Meroe	
Metagene	
Metagenes	
Metellus	
Metrodorus	
Milesia	
Milesiae	
Milesii	
Milesius	
Miletus	
Milo	
Minerva	the goddess of wisdom, sense, and reflection, of the arts and sciences, of poetry, and of spinning and weaving, identified with the Grecian Athene
Minidio	
Mithridaticus	
Moenis	
Mucius	
Mummius	
Murena	
Musa	a muse, one of the nine Muses
Mutius	
Myagrus	
Mylasa	
Myron	
Mysia	
Mysius	
Mytilenae	
Mytilene	
Myunta	
nam	for
nares	
naris	a nostril
nascentia	
nasco	
nascor	to be born, begin life, be produced, proceed, be begotten
nasus	the nose
nata	a daughter
nates	
natio	a birth, origin
natis	the rump, buttocks
nato	to swim, float
natura	birth
naturale	
naturalia	
naturalis	natural, by birth, one's own
naturaliter	naturally, conformably to nature, by nature
natus	birth, age, years
naufragium	a shipwreck
navale	
navalia	
navalis	of ships, ship-, nautical, naval
navicula	a small vessel, boat, skiff
navigatio	a sailing, navigation, voyage
navigo	to sail, cruise
navis	a ship
navo	to do zealously, perform diligently, accomplish, effect, prosecute
navus	busy, diligent, assiduous, active
ne	no
nebula	mist, vapor, fog, smoke, exhalation
nebulosus	full of vapor, foggy, cloudy, dark
necessaria	
necessarius	unavoidable, inevitable, indispensable, pressing, needful, requisite, necessary, compulsory
necesse	unavoidable, inevitable, indispensable, necessary
necessitas	unavoidableness, inevitableness, necessity, compulsion, force, exigency
necne	or not
neco	to kill, slay, put to death, destroy
nefas	something contrary to divine law, an impious deed, sin, crime
nego	to say no, deny, refuse
negotiator	a wholesale dealer, merchant, banker, factor
negotior	to carry on business, do wholesale business, act as banker
negotium	a business, employment, occupation, affair
nemo	no man, no one, nobody
nemus	a tract of woodland, forest pasture, meadow with shade, grove
neo	to spin
nequam	worthless, good for nothing
neque	
nervicus	
nervus	a sinew, tendon, muscle
nete	
ni	not
nidus	a nest
niger	black, sable, dark, dusky
nigro	
nigrum	
nihil	
nihilominus	none the less, just as much
nihilum	
nilum	not a shred, nothing
nimirum	without doubt, doubtless, indisputably, certainly, surely, truly
nimium	too much, too
nimius	beyond measure, excessive, too great, too much
nisi	if not, unless
nisus	a pressing upon, pressure, push, striving, exertion, labor, effort
niteo	to shine, look bright, glitter, glisten
nitidus	shining, glittering, bright, polished, clear
nitor	
nitrion	
nitrosus	
nitrum	native soda, natron
nivit	
nix	snow
no	to swim, float
nobilis	that is known, well-known, famous, noted, celebrated, renowned
nobilitas	celebrity, fame, renown
nobiliter	
nobilito	to make known, render famous, make renowned
nocens	hurtful, harmful, pernicious, baneful, injurious
noceo	to do harm, inflict injury, hurt
nodatio	
nodus	a knot
nolo	to wish . . . not, will . . . not, not to wish, to be unwilling
nome	
nomen	a means of knowing, name, appellation
nominatio	a naming, designation, nomination
nominatus	famed, renowned, celebrated
nomino	to call by name, name, give a name to
non	not, by no means, not at all
nona	
nongenti	nine hundred
nonnulli	
nonnullus	some, several
nonnumquam	sometimes, a few times
nonus	the ninth
norma	a measure, standard
normo	
nos	
nosco	to get knowledge of, become acquainted with, come to know, learn, discern
noster	our, our own, ours, of us
nostras	of our country, native
nota	a means of recognition, mark, sign, stamp, impression
notatus	marked, known, noted
notitia	a being known, celebrity, note, fame
notities	
noto	to mark, designate with a mark
notus	known
novi	
novissimi	
novissimum	
novissimus	
novitas	newness, novelty
novo	to make new, renew, renovate
novum	
novus	new, not old, young, fresh, recent
nox	night
nubes	a cloud, mist, vapor
nubis	
nubo	to veil oneself, be married, marry, wed
nucleus	
nudo	to make naked, strip, bare, lay bare, expose, uncover
nudus	naked, bare, unclothed, stripped, uncovered, exposed
nullus	not any, none, no
numen	a nod
numerarius	
numero	to count, enumerate, reckon, number, take account of
numerus	a number
nummus	a piece of money, coin, money
nunc	now, at present, at this time
nuntio	to announce, declare, report, relate, narrate, make known, inform, give intelligence of
nuntium	
nuntius	that announces, making known, informing
nuptiae	a marriage, wedding, nuptials
nus	
nutrio	to suckle, nourish, feed, foster, bring up, rear
nutrix	a wet-nurse, nurse
nutus	a nodding, nod
nympha	
nymphe	a bride, mistress, young woman
N	
Nemea	
Nemee	
Nemeus	
Neptunius	of Neptune, Neptunian
Nexaris	
Nilus	the Nile, the river of Egypt
Nomas	a herdsman, nomad
Nonacris	
Nymphodorus	
o	O! oh!
ob	towards, to
obicio	to throw before, throw to, cast, offer, present, expose
obligatus	
obligo	to bind up, bandage, swathe
oblino	to daub, smear over, bedaub, besmear
oblique	athwart, obliquely
obliquo	to turn aside, twist, turn awry
obliquus	sidelong, slanting, awry, oblique, crosswise
oblitor	
obliviscor	to forget
oblongus	more long than wide, oblong
obolus	a small Greek coin, a sixth of a drachma
obruo	to overwhelm, overthrow, cover, cover over, hide, bury
obscuratio	a darkening, obscuring
obscuritas	darkness, obscurity, indistinctness, uncertainty
obscuro	to render dark, darken, obscure
obscurum	
obscurus	dark, darksome, dusky, shady, obscure
observatio	a watching, observance, investigation
observo	to watch, note, heed, observe, take notice of, attend to
obsolido	
obsonium	a relish, sauce, side-dish
obstantia	
obsto	to stand before, be opposite
obstruo	to build against, build up, block, stop up, bar, barricade, make impassable
obtineo	to hold fast, have, occupy, possess, preserve, keep, maintain
obtingo	to fall to the lot of, befall, occur
obturo	to stuff, stop up, close
obviam	in the way, towards, against, to meet, in face of
obvius	in the way, so as to meet, meeting, to meet
occaedes	
occasus	a falling, going down, setting
occidens	the sunset, west, occident
occido	
occulo	to cover, cover over
occulto	to hide, conceal, secrete
occupatio	a taking possession, occupying, seizure
occupatus	taken up, engrossed, absorbed, occupied, employed, busy, engaged
occupo	to take into possession, seize, occupy, master, win
octagoni	
octagonon	
octantibus	
octastyli	
octastylon	
octastylos	
octava	
octavus	the eighth
octo	eight
octogenarius	
octogensimo	
octogesimus	
octoginta	eighty
octoni	eight each, eight at a time, by eights
oculo	
oculus	an eye
odeum	
odor	
odoro	to make fragrant, perfume
odorus	emitting odor, scented, fragrant
oecus	
offendo	to hit
offensa	disfavor, displeasure, offence, hatred, enmity
offensio	a striking against, tripping, stumbling
offenso	to strike, dash against
offensum	
officina	a workshop, manufactory
officinator	
officio	to come in the way of, hinder, oppose, thwart, obstruct
officium	a service, kindness, favor, courtesy
olea	an olive, olive-berry
oleagineus	
olearis	
olearius	of oil, for oil
oleo	to emit a smell, smell of, smell
oleum	oil, olive-oil
olim	at that time, some time ago, once upon a time, once, formerly, of old
omne	
omnes	
omnia	
omnino	altogether, wholly, entirely, utterly, at all
omnis	all, every
oneraria	
onerarius	of burden, of transport, for freight
onero	to load, burden, fill, freight
onerosus	burdensome, heavy, oppressive
onus	a load, burden
opacus	in the shade, shaded, shady
oparum	
opas	
opera	service, pains, exertion, effort, work, labor
operarius	of labor
operatio	
operculo	
operculum	a cover, covering, lid
operimentum	a covering, cover
operio	to cover, cover over
opero	
operosus	full of labor, painstaking, active, busy, industrious, laborious
operto	
opertum	
opertus	hidden, concealed
ophiuchi	
ophiuchos	
opinio	opinion, supposition, conjecture, fancy, belief, expectation
opinor	to be of opinion, suppose, imagine, conjecture, deem, believe, think, judge
oportet	it is necessary, is proper, is becoming, behooves
oppidani	
oppidanus	of a town, of a country town, provincial, rustic
oppido	very, very much, completely, exceedingly, exactly, precisely
oppidum	a town, city, collection of dwellings
opportunitas	fitness, convenience, suitableness
oppressio	a pressing down, suppression, overthrow
opprimo	to press against, press together, press down, close
oppugnatio	a storming, besieging, attack, assault, siege
oppugnatorius	
oppugno	to fight against, attack, assail, assault, storm, besiege, war with
optice	
optimum	
opto	to choose, select, prefer
opulens	rich, wealthy, opulent
opulentus	rich, wealthy, opulent
opus	work, labor, toil
ora	
orba	
orbiculus	
orbis	a ring, circle, re-entering way, circular path, hoop, orbit
orbo	to deprive, strip, spoil, rob, make destitute
orbus	deprived, bereft, destitute, devoid
orchestra	part of the theatre in which the senate sat
ordinarius	of order, usual, regular, ordinary
ordinatio	
ordino	to order, set in order, arrange, adjust, dispose, regulate
ordo	a row, line, series, order, rank
organicus	
organum	a musical instrument
origo	a beginning, commencement, source, start, descent, lineage, birth, origin
orior	to arise, rise, stir, get up
ornamentum	apparatus, accoutrement, equipment, furniture, trappings
ornatio	
ornatus	
ornithias	
orno	to fit out, furnish, provide, supply, equip, get ready, prepare
oro	to speak
orthogonius	
orthographia	
orthostata	
ortus	
os	
ossum	
ostendo	to stretch out, spread before, expose to view, show, point out, exhibit, display
ostiaria	
ostiarium	a tax upon doors, door-tax
ostiarius	
ostium	a door
ostrum	the blood of the seasnail, purple
otior	to be at leisure, keep holiday
otium	leisure, vacant time, freedom from business
ovile	a sheepfold
ovilis	
ovis	a sheep
ovo	to exult, rejoice
ovum	an egg
Oceanum	
Oceanus	the great sea, outer sea, ocean
Odyssea	
Olympia	the Olympic games, games held every four years at Olympia
Olympio	
Olympium	
Olympius	
Orion	a mythical giant, afterwards a constellation
Ostia	
pabulum	food, nourishment, food for cattle, fodder, pasturage, grass
pacatum	
padi	
paenula	a woollen outer garment covering the body, travelling-cloak, mantle
pagina	a leaf of paper, sheet, page
pala	a spade
palaestra	a wrestling school, wrestling-place, place of exercise, gymnasium, palaestra
palatio	
pale	
palea	chaff
pallor	pale color, paleness, wanness, pallor
palma	the palm, flat hand
palmaris	of the palm, superior, excellent
palmeus	
palmipedalis	
palmo	
palmopedales	
palmopedali	
palmopede	
palmus	
palo	
palum	
palus	
paluster	fenny, marshy, swampy
palustres	
palustri	
palustria	
palustris	
pandatio	
pando	to spread out, extend, unfold, expand
pandus	bent, crooked, curved
pannum	
pannus	a piece of cloth, garment of cloth
pansa	
pansas	
pansis	
par	equal
paraetonium	
paralleloe	
parallelus	
paralysis	
paramese	
paranete	
parapegmatorum	
pararius	
parastados	
parastas	
parastata	
parastatica	
parastaticae	
parastaticus	
paratus	
parco	to act sparingly, be sparing, spare, refrain from, use moderately
parcus	sparing, frugal, thrifty, economical, niggardly, stingy, penurious, parsimonious
parens	
parento	to offer a solemn sacrifice in honor of dead kindred
pareo	to appear, be visible, be at hand
parergon	
parhypate	
paries	a wall
pario	to bring forth, bear, give birth, drop, lay, spawn, produce
pariter	equally, in an equal degree, in like manner, as well, as much, alike
parito	
parma	a small round shield, light shield, target
paro	
parotis	
parricidium	the murder of a father, assassination of parents, parricide
pars	a part, piece, portion, share, division, section
parta	
particula	a small part, little bit, particle, grain, jot
partio	to share, part, distribute, apportion, divide
partior	to share, part, distribute, apportion, divide
partitio	a sharing, parting, partition, division, distribution
partus	
parum	too little, not enough, insufficiently
parus	
parvulus	
parvus	little, small, petty, puny, inconsiderable
pasco	to cause to eat, feed, supply with food
pascor	
passim	spread, scattered about far and wide, at different places, generally, in every direction, at random
passum	
passus	
pasta	
pastor	a herdsman, shepherd
patefacio	to lay open, open, throw open
pateo	to stand open, lie open, be open
pater	a father, sire
patera	a low bowl, flattened dish, saucer, libation-saucer
patior	to bear, support, undergo, suffer, endure
patria	a fatherland, native land, own country, native place
patrimonium	an inheritance from a father, paternal estate, inheritance, patrimony
patrium	
patrius	
patro	to bring to pass, execute, perform, achieve, accomplish, bring about, effect, finish, conclude
pauca	
pauci	
paucus	few, little
paulatim	by little and little, by degrees, gradually
paululum	a little, a very little, somewhat
paululus	very little, very small
paulum	a little, somewhat
paulus	little, small
pavimento	
pavimentum	a level surface beaten firm, hard floor, pavement
pax	a compact, agreement, treaty, peace, treaty of peace, reconciliation
peccatum	a fault, error, mistake, transgression, sin
pecco	to miss, mistake, do amiss, transgress, commit a fault, offend, sin
pectinatim	
pectino	
pectus	a breast, breast-bone
pecunia	property, riches, wealth
pecus	
peda	
pedalion	
pedalis	of the size of a foot
pedis	
pedo	to break wind
pedum	a shepherd's crook, sheephook
pelagium	
pelagius	of the sea
pelagus	the sea
pelecinon	
pelecinos	
pelliceo	
pellicio	to allure, entice, inveigle, decoy, coax, wheedle
pellis	a skin, hide, felt, pelt
pello	to beat, strike, knock, push, drive, hurl, impel, propel
pelvis	a basin, laver
pendeo	to hang, hang down, be suspended
pendo	to suspend, weigh, weigh out
penetro	to enter, penetrate, betake oneself
penitus	inwardly, deeply, far within, into the inmost part
pensilia	
pensilis	hanging, pendent, pensile
pensio	a paying, payment, instalment
pentadoron	
pentaspaston	
penu	
penus	a store of food, provision, victuals
per	through, across, through the midst of, from side to side of, traversing
peraeque	quite equally, uniformly
peraequo	
perago	to thrust through, pierce through, transfix
percalefacio	
percalefieri	
percandefacio	
percipio	to take wholly, seize entirely, take possession of, seize, occupy
percolatio	
percolo	to deck, beautify, adorn
perconto	
percontor	to ask particularly, question strictly, inquire, interrogate, investigate
percoquo	to ripen
percrudus	
percurro	to run, run along, run all the way, run through, hasten through, traverse, run over, pass over
percussus	a beating, striking
percutio	to strike through and through, thrust through, pierce, transfix
perdisco	to learn thoroughly, get by heart
perdolo	
perduco	to lead through, lead, bring, conduct, guide
perductio	
perduro	to last, endure
peregre	abroad, away from home, out of the country
peregrinus	from foreign parts, strange, foreign, exotic, alien
pereo	to pass away, come to nothing, vanish, disappear, be lost
perfectio	a finishing, completing, perfection
perfectus	finished, complete, perfect, excellent, accomplished, exquisite
perfero	to bear through, bring home
perficio	to achieve, execute, carry out, accomplish, perform, despatch, bring about, bring to an end, finish, complete
perflatus	
perflo	to blow through, blow over
perfodio	to dig through, pierce through, transfix
perforo	to bore through, pierce through, perforate
perfricata	
perfundo	to pour over, wet, moisten, bedew, besprinkle, drench, bathe
periculosus	dangerous, hazardous, perilous
periculum	a trial, experiment, attempt, test, proof, essay
perimetros	
peripteris	
peripteroe	
peripteros	
peristylium	
peristylum	an open court surrounded by a colonnade, peristyle
peritretoe	
peritus	experienced, practised, trained, skilled, skilful, expert
perlego	to view all over, examine thoroughly, scan, survey
perlibratio	
perlibro	
perlimo	
perlucida	
perlucidae	
perlucidam	
perlucidas	
perlucidis	
perluciditatem	
permacero	
permaneo	to stay, hold out, last, continue, abide, be permanent, endure, remain, persist, persevere
permano	to flow to, penetrate, reach
permensus	
permetior	to measure through, measure out, measure
permitto	to let pass, let go, let loose
permulceo	to rub gently, stroke
permuto	to change throughout, alter completely
perpendiculum	a plummet, plumb-line
perpetuitas	uninterrupted duration, continuous succession, continuity, perpetuity
perpetuo	
perpetuum	
perpetuus	continuous, unbroken, uninterrupted, constant, entire, whole, perpetual
perpluo	
perquadratus	
per-quaero	
perrumpo	to break through, force a way through, get across
perscribo	to write in full, write at length, write out
perseco	to cut up, extirpate, cut out
persedeo	to remain sitting, sit continuously
persequor	to follow perseveringly, follow after, follow up, pursue
per-sequor	
persona	a mask, false face
persono	to sound through and through, resound, fill with sound, reëcho
personus	
perspecto	
perspicibilis	
perspicio	to look through, look into, look at, see through
perspicuus	transparent, clear
persterno	to pave throughout
perstruo	
pertego	
per-tento	
perterebro	to bore through
perterreo	to frighten thoroughly, terrify
pertinacia	perseverance, persistence, stubbornness, obstinacy, pertinacity
pertinax	persevering, unyielding, obstinate, pertinacious, stubborn
pertineo	to stretch out, reach, extend
pertingo	to reach, extend
pertraho	to draw along, drag, conduct forcibly
pertundo	to thrust through, bore through, perforate
perturbo	to confuse, disturb, confound, throw into disorder
perungo	to besmear, anoint
pervado	to go through, pass through, extend, prevail, spread through
pervagor	to wander over, range through, rove about, overrun
perveho	to bear through, convey through
pervenio	to come up, arrive
pervolitantia	
pervolito	to fly through, flit about
pervolo	
pes	a foot
pestilens	pestilential, infected, unhealthy, unwholesome
pestilentus	
peto	to strive for, seek, aim at, repair to, make for, travel to
phalangae	wooden rollers
phalangarius	
phalanx	a compact body of heavy armed men in battle array, battalion, phalanx
pharetra	a quiver
phellos	
philologia	love of study, literary culture
philologus	scholarly, learned
philosopha	
philosophia	philosophy
philosophus	philosophical
philotechinis	
philus	
physica	natural science, natural philosophy, physics
physice	like the naturalists
physicus	of natural philosophy, of physics, natural
pica	a pie, magpie
pico	
pictor	a painter
pictura	painting, the art of painting
picus	a woodpecker
pigeo	
pigritia	sloth, sluggishness, laziness, indolence
pila	a ball, playing-ball
pilatim	
pilo	
pilum	a heavy javelin, pilum
pilus	
pinacotheca	
pinacothece	
pingo	to paint, make by painting
pingue	
pinguis	fat
pinguitudo	
pinna	a feather, plume
pinnae	
pinnarum	
pinnas	
pinnis	
pinsum	
pinus	a pine, pine-tree, fir, firtree
pipo	
pisant	
piscatus	a catch of fish
piscina	a fish-pond
piscis	a fish
piscor	to fish
pistatione	
pistrina	
pistrinum	a corn-mill, poundingmill, mill
pistum	
placentia	
placeo	to please, give pleasure, be approved, be pleasing, be agreeable, be acceptable, suit, satisfy
placidus	gentle, quiet, still, calm, mild, peaceful, placid
placo	to quiet, soothe, assuage, allay, appease
plaga	
plago	
plana	
planitia	a flat surface, level ground, plain
planitie	
planitiem	
planities	
plano	
planum	
planus	
plastes	
plasticus	
platalea	a waterfowl, spoonbill
platanon	
platea	a broad way, street, avenue
plaudo	to clap, strike, beat
plausus	a clapping, flapping, noise from striking
plenitas	
plentigomatos	
plenum	
plenus	full, filled
pleo	
pleraque	
plerus	
pleuritis	
plexis	
plinthis	
plinthium	
plinthus	
plostra	
plostrorum	
plumarius	
plumbarium	
plumbarius	
plumbea	
plumbeum	
plumbeus	of lead, leaden
plumbo	
plumbum	lead
plurimus	most, very much, very many
pluteum	
pluteus	a penthouse, shed, mantlet
pneumaticus	
pnigeus	
poculum	a drinking-vessel, cup, goblet, bowl, beaker
podagricus	
podia	
podium	an elevated place, height
poema	a composition in verse, poem
poematorum	
poena	indemnification, compensation, recompense, retribution, satisfaction, expiation, punishment, penalty, price
poeta	a poet
poeto	
polio	to smooth, furbish, polish
politio	
politura	
polliceo	
polliceor	to hold forth, offer, promise
pollicitum	a promise, pledge
pollis	
polus	an end of an axis, pole
polygonoe	
polyspaston	
pomeridianus	
pomum	a fruit, tree-fruit, orchard-fruit
ponde	
ponderatio	
pondero	to weigh
ponderosus	weighty, full of meaning
pondo	by weight, in weight
pondus	a weight
pono	to put down, set down, put, place, set, fix, lay, deposit
ponticae	
ponticam	
ponto	a large flat boat
pontus	the sea
populeus	of poplars, poplar-
populo	to lay waste, ravage, plunder, pillage, spoil
populus	
porrectio	a stretching out, extension
porrectum	
porrigo	
porta	a city-gate, gate
portatio	a carrying, carriage, conveyance
porticus	a covered walk between columns, colonnade, piazza, arcade, gallery, porch, portico
portio	a share, part, portion, lot
porto	to bear, carry, convey, take
portus	a harbor, haven, port
positus	
possessio	a taking possession of, seizing, occupying, taking
possideo	to have and hold, be master of, own, possess
possido	to take possession of, occupy, seize
possum	to be able, have power, can
post	
postea	after this, after that, hereafter, thereafter, afterwards, later
posteaquam	
posteriora	
posteriores	
posteritas	the future, future time, futurity, after-ages
posterius	later, at a later day
postero	
posterus	m
posticum	
posticus	in the rear, behind, hinder, back-, posterior
postis	a post, door-post
postulo	to ask, demand, claim, require, request, desire
potens	able, mighty, strong, powerful, potent
potentia	might, force, power
poterint	
potestas	ability, power, capacity, force
potio	a drinking
potiono	
potior	to become master of, take possession of, get, obtain, acquire, receive
potis	able, capable
poto	to drink
potus	
praebeo	to hold forth, reach out, proffer, offer, tender
praecepto	
praeceptor	a teacher, instructor, preceptor
praeceptrix	a preceptress
praeceptum	a maxim, rule, precept, order, direction, command, injunction
praecido	to cut off in front, cut off
praecinctio	
praecinctura	
praecingo	to gird, encircle, enclose
praecipio	to take beforehand, get in advance
praecipitatio	
praecipitium	
praecipito	to throw headlong, cast down, hurl down, precipitate
praecisio	
praecisum	
praecludo	to shut off, shut, close
praeclusio	
praecoquo	
praeda	property taken in war, booty, spoil, plunder, pillage
praedico	
praefectura	the office of an overseer, overseership, superintendence
praeficio	to set over, place in authority over, place at the head, appoint to command
praefinio	to determine beforehand, ordain, prescribe
praefurnium	
praegno	
praeligo	to bind on before, bind to
praemium	an advantage, prerogative, favor, license, privilege
prae-obturo	
praeparatio	a making ready, preparation
praeparatus	prepared, provided, furnished, ready
praeparo	to make ready beforehand, prepare, equip, make preparations
praependeo	to hang before, hang down in front
praeripio	to snatch away, carry off
praesaepe	an enclosure, stable, stall, fold, pen
praescribo	to write before, prefix in writing
praescriptio	a prefix in writing, title, inscription, preface, introduction
praeseco	to cut off before, cut away, cut off, cut out
praeseminatio	
praesens	at hand, in sight, present, in person
praesentia	a being at hand, presence
praesento	
praesepis	
praesidium	defence, protection, guardianship, help, aid, assistance
praesto	
prae-sto	
praestringo	to draw together, fasten up, bind fast, compress
praestus	
praetempto	to examine previously, make trial
praetendo	to stretch forth, reach out, extend, present
praetento	
praeter	
praeterea	in addition, beyond this, further, besides, moreover
praetereo	to go by, go past, pass by, pass
praeterita	
praetermitto	to permit to go by, let pass, let go
praetero	
praeterquam	beyond, besides, except, other than, save
praetor	a leader, head, chief, president, chief magistrate, chief executive, commander
praeuro	
pransito	
pravus	crooked, distorted, misshapen, deformed
prelum	a press
premo	to press
pressio	a prop, support
presso	to press
pressus	
pretio	
pretiosus	of great value, costly, precious
pretium	a price, money value, value in exchange
prima	
primo	at first, at the beginning, first, in the first place
primus	the first, first
princeps	first in order, foremost
principatus	a beginning, origin
principes	
principia	
principio	
principium	a beginning, commencement, origin
principor	
prior	former, previous, prior, first
priores	
prisci	
priscus	of former times, of old, olden, ancient, primitive, antique
pristinum	
pristinus	former, early, original, primitive, pristine
privatim	apart from State affairs, as an individual, in private, privately, in a private capacity
privatus	apart from the State, peculiar, personal, individual, private
privo	to bereave, deprive, rob, strip
pro	
probabilis	worthy of approval, pleasing, agreeable, acceptable, commendable, laudable, good, fit
probata	
probatio	approbation, approval, assent
probo	to make good, esteem good, approve, esteem, commend
procedo	to go before, go forward, advance, proceed, march on, move forward, go forth
procella	a violent wind, storm, hurricane, tempest
procello	
proclinatio	
proclino	to bend forward, bend, incline
proclivis	sloping, steep, going downward, downhill
proclivus	
procreatio	a begetting, generation
procreo	to bring forth, beget, generate, procreate, produce
procumbo	to fall forwards, sink down, fall prostrate
procurro	to run forth, rush forward, charge
prodeo	to go forth, come forth, come forward
prodo	to put forth, exhibit, reveal
produco	to lead forth, lead forward, bring out
proelio	
proelior	to join battle, engage in battle, fight
proelium	a battle, combat
pro-eo	
profecto	actually, indeed, really, truly, assuredly, certainly
profectus	advance, effect, increase, profit, success
profero	to carry out, bring forth, produce
proficio	to make headway, advance, make progress, have success, profit, succeed, effect, accomplish
proficisco	
proficiscor	to set forward, set out, start, go, march, depart
profiteor	to declare publicly, own freely, acknowledge, avow, confess openly, profess
profluens	flowing along
profluenter	flowingly
profluentia	a flowing forth
profluo	to flow forth, flow along
profundo	to pour out, pour forth, shed copiously, cause to flow
profusio	
progero	
prognatus	born, descended, sprung
progredio	
progredior	to come forth, go forth, go forward, go on, advance
progressus	a going forward, advance, progress
proicio	to throw forth, cast before, throw out, throw down, throw
prolecto	to allure, entice forth, lead on
prolixo	
prolixus	well-disposed, obliging, courteous
promereo	to deserve, be deserving of, merit
promereor	to deserve, merit, earn, be worthy
prominens	prominent
prominentia	
promineo	to stand out, jut, be prominent, overhang, project, extend
promino	
promoveo	to move forward, cause to advance, push onward, advance
promunturium	a projecting part of a mountain, spur
pronaus	
pronuntiatio	a public declaration, publication, proclamation
pronuntio	to make publicly known, publish, proclaim, announce
pronus	turned forward, bent over, inclined, leaning, hanging, stooping, bending
propagatio	an extension, enlargement
prope	near, nigh
propello	to drive forward, drive forth, drive away, drive out
propinqua	
propinquitas	nearness, vicinity, proximity, propinquity
propinquum	
propinquus	near, nigh, neighboring
propiora	
propius	
propnigeum	
propono	to put forth, set forth, lay out, place before, expose to view, display
proportio	analogy
propositum	that which is proposed, a plan, intention, design, resolution, purpose
proprietas	a property, peculiarily, peculiar nature, quality
proprio	
proprium	
proprius	not common with others, own special, several, individual, peculiar, particular, proper
propter	
propterea	therefore, for that cause, on that account
prora	the forepart of a ship, bow, prow
proruo	to rush forth, make an onset, sally
proscaenium	the front part of the stage, proscenium
prosemino	to sow, scatter, plant
proslambanomenos	
prospectus	a lookout, distant view, prospect
prospex	
prospica	
prospicio	to look forward, look into the distance, have a view, look out, look, see
prospicus	
prostas	
prosto	to be on sale, be exposed for sale
prostylon	
prostylos	
prosum	fut
protervitas	wantonness, pertness, sauciness, impudence
prothyra	
protropum	
protrudo	to thrust forward, push out
providentia	foresight, foreknowledge
provideo	to see in advance, discern, descry
provincia	an office, duty, pursuit, charge, business, province
provindemiator	
proxime	nearest, very near, next
proximi	
proximitas	nearness, vicinity, proximity
proximo	very lately, shortly
proximum	
proximus	the nearest, next
pro-jacio	
projecto	
projectum	
projectura	
prudens	foreseeing, foreknowing
prudenter	sagaciously, intelligently, discreetly, circumspectly, learnedly, prudently
prudentia	a foreseeing
pruina	hoar-frost, rime
pruinosus	full of hoar-frost, frosty, rimy
pseudisodomos	
pseudodipteris	
pseudodipterive	
pseudodipteros	
pseudoperipterum	
pseudourbanus	
pteromatos	
pthisicis	
pthisis	
publica	
publicanus	of the public revenue
publico	to make public, adjudge to public use, confiscate
publicum	
publicus	of the people, of the state, done for the state, public, common
pudor	a shrinking from blame, desire of approval, shame, shamefastness, modesty, decency, propriety
puella	a female child, girl, maiden, lass
puer	a male child, boy, lad, young man
puerilis	boyish, childish, youthful
pugna	a hand-to-hand fight, fight at close quarters, battle, combat, action, engagement
pugno	to fight, combat, give battle, engage, contend
pullo	
pullum	
pullus	
pulpito	
pulpitum	
pulso	to push against, strike upon, beat, hammer, keep hitting, batter
pulsus	a pushing, beating, striking, stamping, push, blow, impulse, stroke
pulvero	
pulvinatus	
pulvinus	a cushion, bolster, squab, pillow
pulvis	dust, powder
pumex	a pumice-stone
pumicosus	
puncta	
punctum	a prick, puncture
punctus	
pungo	to prick, puncture
punior	to punish, correct, chastise
puppis	the hinder part of a ship, stern, poop
pupula	the pupil of the eye
pupulus	a little boy
purgo	to free from what is superfluous, make clean, make pure, clean, cleanse, purify
puro	
purpura	purple color, purple
purpuratus	one clad in purple, an officer of a royal court, king's attendant, courtier
purpureus	purple-colored, purple, dark-red
purpuro	
purum	
purus	free from dirt, free from admixture, clean, pure, unstained, unspotted
pusillum	
pusillus	very little, very small, petty, insignificant
pustula	a pimple, pustule
pustulo	
putea	
puteo	to stink
putesco	to rot, putrefy, decay
puteus	a well
puto	to clean, cleanse, trim, prune
putrescent	
putrescunt	
putus	pure, bright, splendid
pycnostyla	
pycnostylis	
pycnostylo	
pycnostylos	
pyra	a funeral pile, pyre
pyramis	a pyramid
pythion	
pytisma	that which is spit out
P	
Paconius	
Padus	
Paeonius	of Paeon
Pallas	a surname of Athene
Pallenses	
Pallensibus	
Panionium	
Panionius	
Paphlagonia	
Paphlagonius	
Paraetonium	
Paraetonius	
Parmenio	
Paros	
Patrae	
Patrocles	
Pausanias	
Peloponnenses	
Peloponnensis	
Peloponnensoque	
Pentelensis	
Pephrasmenos	
Pergaeus	
Pergamum	
Peripteros	
Persa	
Persae	the Persians
Perses	a Persian
Perseus	
Persica	
Persice	
Persicum	
Persicus	Persian, of Persia
Phaethon	
Phalereus	
Pharax	
Phasis	
Phidias	
Philadelphus	
Philippus	a king of Macedonia, father of Alexander the Great
Philo	
Philolaus	
Philus	
Phocaea	
Phocaeus	
Phryges	
Phrygia	
Phrygiae	
Phrygius	Phrygian, of Phrygia
Picenum	
Picenus	
Pinnae	
Piraceus	
Piraea	
Piraeeus	the port of Athens
Piraeus	of the Piraeus
Pisaurius	
Pisaurum	
Pisistratus	
Pitane	
Pixodaro	
Pixodarus	
Placentia	
Plataico	
Plato	
Poliorcetes	
Polla	
Polycles	
Polycletus	
Polyclitus	
Polyidus	
Pompejani	
Pompejanum	
Pompejanus	
Pomptinus	
Pontus	
Porinos	
Posidonius	
Posteaquam	
Pothereum	
Praxiteles	
Priene	
Prieni	
Proconnensio	
Proconnenso	
Proetus	
Proserpina	Proserpine, wife of Pluto, and queen of the Lower World
Prostylos	
Pseudodipteros	
Pteromatos	
Pthias	
Ptolomaeus	
Puteoli	
Pyrros	
Pythagoras	
Pythagorei	
Pythagoreus	
Pythagoricus	Pythagorean, of Pythagoras
Pytheos	
Pythia	
Pythium	
Pythius	
qua	on which side, at which place, in what direction, where, by what way
quadra	a square table, dining-table
quadragenarius	
quadrageni	forty each
quadraginta	forty
quadratio	
quadrator	
quadratum	a square, quadrate
quadratus	squared, square, quadrate
quadrifariam	fourfold, into four parts
quadrifarius	
quadrifluvium	
quadriforis	
quadrigae	a team of four, four-abreast, four-in-hand, four-horse team
quadringentesimus	the four hundredth
quadringenti	
quadro	to make square, put in order, arrange, complete
quadrum	a square
quadruplex	fourfold, quadruple
quadruplico	
quadrus	
quaero	to seek, look for
quaesitum	
quaesitus	sought out, select, special
quaeso	to beg, pray, beseech, entreat
quaestio	a questioning, examination, inquiry, investigation
quaestiono	
quaestus	a gaining, acquiring, gain, acquisition, profit, advantage
qualibet	where you will, everywhere
qualis	how constituted, of what sort, of what nature, what kind of a
qualitas	a quality, property, nature, state, condition
qualum	
qualus	a wicker basket, work-basket
quam	Relat., in what manner, to what degree, how greatly, how, how much
quamprimum	
quamvis	as you will, as much as you will, however much, as much as possible, very much, extremely, exceedingly
quando	at what time? when?: Do
quantitas	
quanto	by how much, by as much as, according as
quantum	as much as, so much as, to as great an extent
quantus	Relat
quapropter	—Interrog., for what, wherefore, why
quaque	
quare	
quarta	
quartum	for the fourth time
quartus	the fourth
quatenus	—Interrog., to what point, how far
quaterni	four each, by fours, four at a time
quattuor	four
que	and
quemadmodum	
queo	to be able, can
querceus	of oak
querco	
quercus	an oak, oak-tree, Italian oak
qui	
quia	because
quicumque	rel., whoever, whatever, whosoever, whatsoever, every one who, everything that, all that
quidam	a certain, a kind of, as one might say
quidem	assuredly, certainly, in fact, indeed
quiesco	to rest, repose, keep quiet, be inactive, be at peace
quietum	
quilibet	any one, any without distinction, whom you will, no matter who, the first that comes, all
quin	why not? wherefore not?
quinarius	
quindecim	fifteen
quindenum	
quingenti	
quini	five each
quinquagenarius	
quinquageni	fifty each
quinquagesima	
quinquagesimus	the fiftieth
quinquaginta	fifty
quinquennia	
quinquennis	of five years, five years old
quinquennium	a period of five years, five years
quinquies	
quintarius	
quintus	the fifth
quis	plur
quisnam	who then? who in the world? which, I insist? what, pray?
quisquam	indef
quisque	whoever it be, whatever, each, each one, every, everybody, every one, everything
quivis	whoever it be, whom you please, any one, any whatever, anything
quo	loci
quoad	as far as
quocumque	to whatever place, whithersoever
quodam	
quodsi	
quolibet	to any place whatever
quoniam	since now, since then, since, seeing that, as, because, whereas
quoqueversus	
quoquoversus	in every direction, every way
quot	how many?
quotannis	every year, year by year, annually, yearly
quotiens	how often? how many times?
quotienscumque	how often soever, as often soever as
quotmensibus	
Q	
Quirinus	
rabiem	
radico	
radio	
radius	a staff, rod
radix	a root
raeda	a travelling-carriage with four wheels
ramus	a branch, bough, twig
raritas	looseness of texture
rarus	of loose texture, thin, rare, not thick
ratio	a reckoning, numbering, casting up, account, calculation, computation
ratiocinatio	an exercise of the reasoning powers, calm reasoning, ratiocination
ratiocinor	to reckon, compute, calculate
rationata	
ratis	a raft, float
raudus	
recedo	to go back, fall back, give ground, retire, withdraw, recede
recens	
receptaculum	a place of deposit, reservoir, magazine, receptacle
recepto	to take back, wrest away
receptum	an engagement, obligation, guaranty
recessio	
recessus	a going back, receding, retiring, retreat, departure
rechamus	
recido	
recingo	to ungird, loosen, undo
recipero	
recipio	To take back, bring back, carry back, retake, get back, regain, recover
recito	to read out, read aloud, recite, declaim, rehearse
recognitio	a reviewing, investigation, examination
recognosco	to know again, recollect, recall to mind, recognize
rectum	good, uprightness, rectitude, virtue
recuperantur	
reddo	To give back, return, restore
redemptor	a contractor, undertaker, purveyor, farmer
redeo	to go back, turn back, return, turn around
redigo	to drive back, force back, lead back, bring back
redimo	to buy back, repurchase, redeem
reditus	a going back, returning, return
redivivum	
redivivus	freshened up, used again, renewed, renovated
reduco	imper
reductio	a bringing back, restoring, restoration
redundantia	an overflowing, excess, lavishness
redundatio	
redundo	to run over, pour over, stream over, overflow
reduresco	
refectio	
re-fero	
refero	to bear back, bring back, drive back, carry back
reficio	to make again, make anew, reconstruct, remake, restore, renew, rebuild, repair, refit, recruit
reflecto	to bend back, turn backwards, turn about, turn away
refragor	to oppose, resist, thwart, gainsay, hinder, withstand
refreno	to bridle, check, curb
refrigeratio	a cooling, coolness
refrigero	to make cool again, cool off, chill, cool
refringo	to break up, break open
refundo	to pour back, return, cause to flow back
regales	
regalia	
regia	a royal palace, castle, fortress, residence, court
regio	a direction, line
regius	of a king, kingly, royal, regal
regno	to have royal power, be king, rule, reign
regnum	kingly government, royal authority, kingship, royalty
rego	to keep straight, lead aright, guide, conduct, direct, control
regredior	to go back, turn back, return
regressus	a going back, return, regress
regula	a straight stick, bar, staff
regulo	
regulus	a ruler of a small country, petty king, prince, chieftain, lord
reicio	to throw back, fling back, hurl back
reipublicae	
relatio	a bringing back, throwing back, retorting
relaxo	to stretch out, widen again, make wider
relictio	a forsaking, abandoning
religio	conscientiousness, sense of right, moral obligation, duty
religo	to bind back, fasten up, bind fast
relinquo	to leave behind, not take along, not stay with, leave, move away from
reliqua	
reliquiae	what is left, a remainder, leavings, remains, relics, remnant, rest
reliquum	
reliquus	left, left over, remaining
remex	a rower, oarsman
remissa	
remissio	a sending back, sending away, releasing, returning
remitto	to let go back, send back, despatch back, drive back, cause to return
removeo	to move back, take away, set aside, put off, drive away, withdraw, remove
remus	an oar
renuntio	to bring back word, carry tidings back, report, give notice, declare, announce
reor	to reckon, calculate, believe, think, suppose, imagine, judge, deem
repello	to drive back, thrust back, drive away, reject, repulse, repel
repens	predic., suddenly, unexpectedly
repentinus	sudden, hasty, unlooked for, unexpected, impetuous
reperio	to find again, find, meet with, find out, discover
reperta	
repleo	to fill again, refill, fill up
repletae	
replico	to fold back, bend back, unroll, open
replum	
repo	to creep, crawl
repono	to put back, set back, replace, restore
repraesento	to make present, set in view, show, exhibit, display, manifest, represent, depict
reprehendo	to hold back, hold fast, take hold of, seize, catch
repugnatorius	
repugno	to fight back, oppose, make resistance, resist, struggle, defend oneself
repulsa	a rejection, denial, refusal, repulse
repulso	
requiesco	to rest, take rest, repose
res	a thing, object, matter, affair, business, event, fact, circumstance, occurrence, deed, condition, case
rescindo	to cut off, cut loose, cut down, tear open
re-sedeo	
resideo	to sit back, remain sitting, remain behind, be left, stay, remain, rest, linger, tarry, abide, reside
resido	to sit down, settle
residuus	left behind, over and above, remaining, residuary
resiliat	
resiliens	
resina	
resisto	to stand back, remain standing, stand still, halt, stop, stay, stay behind, remain, continue
resolvo	to untie, unfasten, unbind, loose, loosen, release, open
resonantia	
resono	to sound again, resound, ring, re-echo
respicio	to look back, look behind, look about, see behind, look back upon, gaze at, look for
respondeo	to answer, reply, respond, make answer
responso	to return, answer, re-echo
responsum	an answer, reply, response
responsus	
respublica	
respuo	to spit back, discharge by spitting, cast out, cast off, eject, expel
restagno	to run over, overflow
resticula	a cord, line
restituo	to set up again, replace, restore, reconstruct, rebuild, revive, renew, reform, rearrange
resto	to withstand, resist, oppose, stand firm, hold out, not yield
resupino	to bend back, turn back
retardatio	a delaying, retarding
retentio	a keeping back, holding back, holding in
reticulatus	
retinaculum	
retineo	to hold back, keep back, keep, detain, retain, restrain
retractio	
retroduco	
retroversus	turned back
re-tulo	
reus	concerned in a thing, party to an action
revivisceret	
revocatio	a calling back, recalling
revoco	to call again, call back, recall
revorto	
rex	an arbitrary ruler, absolute monarch, king
rhetor	a teacher of oratory, rhetorician
rhetorica	the art of oratory, rhetoric
rhetorice	in an oratorical manner, oratorically, rhetorically
rhetorico	
rhetoricus	of a rhetorician, rhetorical
rhodiacum	
ribus	
rigiditas	
rigido	
rigidus	stiff, hard, inflexible, rigid
rigor	stiffness, hardness, firmness, rigor
rima	a cleft, crack, chink, fissure
rimo	
rimosus	full of cracks, abounding in chinks
ripa	a bank, margin
rivus	a small stream, brook
robur	hard-wood, oak-wood, oak
robusteus	
rodo	to gnaw
rogatus	a request, suit, entreaty
rogo	to ask, question, interrogate: My
rosa	a rose
roscidus	full of dew, wet with dew, dewy
rostrum	a beak, bill, snout, muzzle, mouth
rota	a wheel
rotatio	
roto	to turn round, swing round, whirl about
rotundatio	
rotunditas	
rotundo	to make round, round off, round
rotundus	rolling, round, circular, spherical, rotund
rubia	
rubra	
rubrica	red earth, ruddle, red ochre, red chalk
rubrico	
rubrus	
ructus	a belching, eructation
rudens	a rope, line, cord, stay, halyard, sheet
ruderatio	
rudo	to roar, bellow, bray
rudus	broken stone, rubbish, debris
rufo	
rufus	red, reddish
ruga	a crease in the face, wrinkle
rugo	
ruina	a rushing down, tumbling, falling down, fall
ruinosus	fallen, tumbling, ruinous, ruined
rumor	a rustle, murmur, vague sound
rumpo	to break, burst, tear, rend, rive, rupture, break asunder, burst in pieces, force open
ruo	to fall with violence, rush down, fall down, tumble down, go to ruin
rursus	turned back, back, backwards
rus	the country, lands, fields, a country-seat, farm, estate
rustica	
rusticus	of the country, rural, rustic, country-
rutrum	an implement for digging, spade, shovel
rythmo	
R	
Ravenna	
Rex	
Rhenus	
Rhodanus	
Rhodienses	
Rhodiensis	
Rhodii	
Rhodius	
Rhodo	
Rhodos	
Roma	Rome, the mother city
Romanus	of Rome, Roman
Romulius	
Romulus	of Romulus
Rubrae	
sa	
sabulo	
sabulosus	
saburra	sand, ballast
saburralis	
saburro	
sacer	dedicated, consecrated, devoted, sacred
sacerdos	a priest, priestess
sacerdotium	the priesthood, office of a priest, sacerdotal office
sacoma	
sacomam	
sacrificium	a sacrifice
sacrifico	to make a sacrifice, offer sacrifice, sacrifice
sacrificor	
sacrificus	of sacrifices, for sacrificing, sacrificial
sacro	to set apart as sacred, consecrate, dedicate, devote
sacrum	something consecrated, a holy thing, sacred vessel, sacred utensil, holy place, sanctuary, temple
saepe	often, oft, oftentimes, many times, frequently
saepes	a hedge, fence
saepio	to surround with a hedge, hedge in, fence in, enclose
saepis	
saeptio	
saeptum	
saeta	a stiff hair, bristle
sagitta	an arrow, shaft, bolt
sagittarii	
sagittarius	an archer, bowman
sagitto	to discharge arrows, shoot with arrows
sal	salt water, brine, the sea
salem	
salientes	springs, fountains
salifodina	
salignus	of willow, of willow-wood, willow-
salinae	salt-works, salt-pits
salinum	a vessel for salt, salt-cellar
salio	to leap, spring, bound, jump, hop
salix	a willow-tree, willow, sallow
salmacidus	
salo	
salsa	
salsitudo	
salsugo	
saluberrimae	
saluberrimi	
saluberrimus	
salubris	health-giving, healthful, wholesome, salubrious, salutary
salubritas	healthfulness, wholesomeness, salubrity
salum	the open sea, high sea, main, deep
salus	soundness, health, good health, vigor
salutatio	a greeting, saluting, salutation
sambuca	
sancio	to make sacred, render inviolable, fix unalterably, establish, appoint, decree, ordain, confirm, ratify, enact
sanctum	
sanctus	consecrated, established as inviolable, sacred, inviolable
sandaraca	
sanguis	blood
saniem	
sanies	diseased blood, bloody matter, gore, sanies
sanitas	soundness of body, health
sano	to make sound, heal, cure, restore to health
sanus	sound, whole, healthy, well
sapiens	wise, knowing, sensible, well-advised, discreet, judicious
sapienter	sensibly, discreetly, prudently, judiciously, wisely
sapientia	good taste, good sense, discernment, discretion, prudence, intelligence, forethought
sapineus	
sapinus	
sapio	to taste of, smack of, savor of, have a flavor of
sapor	a taste, relish, flavor, savor
saporus	
sarcina	a package, bundle, burden, load, pack
sarmentum	a twig, light branch, fagot, fascine
sata	standing corn, crops
satietas	a sufficiency, abundance, adequacy
satio	
satum	
saturo	to fill, glut, cloy, satiate
satyricus	
satyrus	a Satyr, forest-god of the train of Bacchus, with goat's feet
saxeus	of rock, of stone, rocky, stony
saxum	a large stone, rough stone, broken rock, bowlder, rock
scaena	the stage, boards, scene
scaenica	
scaenicus	of the stage, scenic, dramatic, theatrical
scaenographia	
scaeva	
scaevus	
scala	
scalae	a flight of steps, stairs, staircase, ladder, scaling-ladder
scalaria	
scalaris	
scalmus	a peg to hold an oar, thole, thole-pin
scalpo	to scratch
scalptura	
scamillus	
scando	to rise, climb, mount, clamber, get up, ascend
scandula	
scansio	
scansorius	
scaphe	
scaphium	a boat-shaped drinking-vessel, ewer, basin
scapula	
scapulae	the shoulder-blades, shoulders
scapus	
sceptrum	a royal staff, sceptre
schema	
schidia	
schola	an intermission of work, leisure for learning, learned conversation, debate, disputation, lecture, dissertation
scientia	a knowing, knowledge, intelligence, science
scindo	to cut, tear, rend, force apart, split, cleave, divide
scio	to know, understand, perceive, have knowledge of, be skilled in
scobis	sawdust, scrapings, filings
scopa	
scopae	twigs, a broom, besom
scopo	
scorpion	
scorpiones	
scorpionibus	
scorpionis	
scorpionius	
scorpionum	
scorpius	a scorpion
scotia	
scriba	a public writer, official scribe, professional writer, clerk, secretary
scribo	to scratch, grave, engrave, draw
scriptor	one who writes, a writer, scribe, copyist, clerk
scriptum	something drawn, a space enclosed by lines
scriptura	a writing, written characters
scripturio	
scriptus	the office of a scribe, a clerkship, secretaryship
scripulum	the smallest measure of weight, a scruple, one twenty-fourth of an uncia
sculpo	to carve, cut, grave, chisel, form, fashion
sculptura	
scutula	a diamond-shaped figure, lozenge, rhombus
scutulum	a small shield
scutum	a shield, Roman shield, infantry shield, buckler
secerno	to put apart, sunder, sever, part, divide, separate
seco	to cut, cut off, cut up, reap, carve
secta	a beaten way, pathway, mode, manner, method, principle
sectilis	cut, cleft, divided
sectio	a cutting up, sale at auction of a confiscated estate, sale of goods forfeited to the public
secunda	
secundae	
secundo	
secundum	following, by, along, beside
secundus	following, next, second
securiclata	
securiclatus	
securiclis	
securicula	
sed	but, on the contrary, but also, but even, but in fact
sedecim	
sedeo	to sit
sedes	a seat, bench, chair, throne
sedigitalia	
sedo	to bring to rest, lay
segmen	
se-lego	
selinusiam	
semel	once, a single time
semen	seed
semicanaliculus	
semidigitalis	
semifastigium	
semilater	
semilateria	
semipedalis	
semipede	
semipedem	
semis	a half-unit, one half
semisso	
semita	a narrow way, side-way, path, foot-path, lane, by-way
semper	ever, always, at all times, continually, perpetually, forever
sempiternus	everlasting, everduring, perpetual, continual, imperishable, eternal, sempiternal
senator	a member of the Senate
senatus	the council of the elders, council of state, Senate, body of senators
senesco	to grow old, become aged, grow hoary
senex	old, aged, advanced in years
seni	six each
senium	old age, senility, decline
sensa	perceptions, ideas
sensibilis	
sensus	a perceiving, observation
sententia	a way of thinking, opinion, judgment, sentiment, thought, notion, purpose, determination, decision, will, desire
sentio	to discern by sense, feel, hear, see, perceive, be sensible of
separatim	asunder, apart, separately, severally
separo	to disjoin, sever, part, sunder, divide, separate
sepelio	to bury, inter
septem	seven
septeni	seven each
septentrio	
septentrionalia	
septentrionalis	
septentrione	
septentrionem	
septentriones	
septentrionis	
septimus	the seventh
sepultura	a burial, interment, funeral obsequies, sepulture
sequor	to follow, come after, follow after, attend, accompany
serapias	
serapion	
sereno	to make clear, clear up, make serene
serenum	
serenus	clear, fair, bright, serene
sermo	continued speech, talk, conversation, discourse
sero	late, at a late hour
serpens	a creeping thing, creeper, crawler, snake, serpent
serpo	to creep, crawl
serra	a saw
serracorum	
serratim	
serro	
servio	to be a servant, be enslaved, serve, be in service
servitus	the condition of a servant, slavery, serfdom, service, servitude
servo	to make safe, save, keep unharmed, preserve, guard, keep, protect, deliver, rescue
servus	
sescentesimus	the six hundredth
sesquialter	once and a half
sesquidigitalis	
sesquidigitus	
sesquipedalis	of a foot and a half, half a yard long
sesquipede	
sesquipedem	
sesquipedis	
sessio	a sitting
sestertium	
sestertius	two and a half
severus	serious, sober, grave, strict, austere, stern, severe
sex	six
sexagensimo	
sexa_ginta	
sexies	
sextantalis	
sextantem	
sextantes	
sextantum	
sextarius	the sixth part
sextus	the sixth
sexus	a sex
sejungo	
si	if, when, inasmuch as, since
sic	thus, in this way, as I do, as you see
siccesco	
siccitas	dryness, drought
sicco	to make dry, dry, dry up
siccum	
siccus	dry
sicilicus	
sicuti	
sido	to sit down, sink, settle, alight
sidus	a group of stars, constellation, heavenly body
sigilla	small statues, statuettes, little images, figures
sigillum	
signifer	sign-bearing, bearing the constellations, starry
significatio	a pointing out, indicating, expression, indication, mark, sign, token
significatus	
significo	to make signs, show by signs, show, point out, express, publish, make known, indicate, intimate, notify, signify
signinis	
signino	
signinum	
signo	to set a mark upon, mark, mark out, designate
signum	a mark, token, sign, indication, proof
sil	
silaceus	
silenda	things not to be spoken, secrets
silentes	
silentium	a being still, keeping silence, noiselessness, stillness, silence
sileo	to be noiseless, be still, be silent, keep silence, not speak of, keep silent about, suppress
silex	a hard stone, flint, flint-stone, fire-stone, granite
siliceus	
siliculorum	
silus	pug-nosed, snub-nosed
silva	a wood, forest, woodland
silvosus	full of woods, woody
sima	
simila	
similis	like, resembling, similar
similitas	
similitudo	likeness, resemblance, similitude
simo	
simplex	simple, single, plain, uncompounded, unmixed
simplico	
simul	at the same time, together, at once, simultaneously
simulacrum	a likeness, image, figure, portrait, effigy, statue
simus	flat-nosed, snub-nosed
sin	if however, if on the contrary, but if
sine	without
singillatim	one by one, singly, severally, individually
singularis	one by one, one at a time, alone, single, solitary, singular
singulus	
sinister	left, on the left, on the left hand, at the left side
sinisteriore	
sinisterioribus	
sinistra	
sinistrum	
sino	to let down, set, fix
sinum	a large vessel of earthenware, pot, jar
sinuo	to bend, wind, curve, bow, swell out in curves
sinus	a bent surface, curve, fold, hollow, coil
siticulosus	dry, parched, arid
situlos	
sive	or if
smyrna	
sol	the sun
solanum	
soleo	to use, be wont, be accustomed
solidatio	
solidesco	
soliditas	solidness, solidity
solido	to make firm, make dense, solidify, compact, strengthen
solidum	
solidus	undivided, unimpaired, whole, complete, entire
solitum	the customary, what is usual
solium	a seat, official seat, chair of state, chair, throne
sollertem	
sollertes	
sollerti	
sollertia	skill, shrewdness, ingenuity, dexterity, adroitness, expertness
solo	
solstitialis	of the summer solstice, solstitial
solstitium	a standing still of the sun, stoppage of the sun's motion, solstice
solum	
solus	alone, only, single, sole
solutum	
solvo	to loosen, unbind, unfasten, unfetter, untie, release
sonitus	a noise, sound, din
sono	to make a noise, sound, resound
sonor	a noise, sound, din
sonorus	noisy, loud, resounding, sonorous
sonus	a noise, sound
sordeo	to be dirty, be mean, be despised, be unvalued, appear worthless
sordes	dirt, filth, uncleanness, squalor
soror	a sister
spargo	to strew, throw here and there, cast, hurl, throw about, scatter, sprinkle
spartum	Spanish broom, esparto
spatior	to spread abroad, spread out, expand
spatiosus	roomy, of great extent, ample, spacious, extensive, large, long
spatium	a space, room, extent
species	a sight, look, view, appearance, aspect, mien
specio	
speciosus	good-looking, showy, handsome, beautiful, splendid, brilliant
spectaculum	a place from which shows are witnessed, spectator's seat, place in the theatre
spectatio	a beholding, contemplation, sight, view
spectator	a looker-on, beholder, observer, spectator
specto	to look on, look at, behold, gaze at, watch, observe, inspect, attend
speculator	a looker-out, spy, scout, explorer
speculum	a reflector, lookingglass, mirror
specus	a natural cavity, cave, cavern, grot, den, chasm, channel, pit
spelunca	a cave, cavern, den
spero	to hope, look for, trust, expect, promise oneself
spes	hope
sphaeroides	
spica	a point, ear, spike
spicatus	
spico	
spicum	an ear, spike
spina	a thorn
spira	a coil, fold, twist, spiral
spirabilis	that may be breathed, respirable
spiramentum	a breathing-hole, vent, pore, spiracle
spiritus	a breathing, breath
spiro	to breathe, draw breath, respire
spissitas	
spisso	
spissus	thick, crowded, close, compact, dense
splendor	brightness, brilliance, lustre, splendor, sheen
splenem	
spolium	the skin, hide, fell
spongia	a sponge
spongio	
spongius	
spuma	foam, froth, scum, spume
stabilio	to make firm, confirm, stay, support
stabilis	firm, steadfast, steady, stable, fixed
stabilitas	a standing fast, steadfastness, firmness, stability
stabiliter	
stabulo	to have an abode, dwell, be stabled
stabulor	to be stabled, kennel, harbor
stabulum	a standing-place, fixed abode
stadiatus	
stadium	a stade, stadium, furlong
stamen	the foundation threads, basis, warp
statera	a steelyard, balance
statim	steadily, regularly
statio	a standing, standing firm
stativa	
stativus	set, stationary, fixed
stator	an attendant upon a proconsul in his province, messenger, orderly
statua	an image, statue, monumental figure, representation in metal
statuaria	
statuarius	
statuminatio	
statumine	
statumino	
statuo	to cause to stand, set up, set, station, fix upright, erect, plant
statura	height, size, stature
status	
statutio	
statutum	
statutus	
stella	a star
stello	
stercus	dung, excrements, ordure, manure
stereobates	
sterno	to spread out, spread abroad, stretch out, extend, strew, scatter
stigma	a mark burned in, brand
stigmo	
stilla	a drop, viscous drop
stillicidium	a trickling liquid, drippings from the eaves, rain from the roof
stillo	to make drops, give drops, drop, distil, drip
stilus	a pointed instrument
stipes	a log, stock, post, trunk, stake
sto	to stand, stand still, remain standing, be upright, be erect
stola	a woman's upper garment, long robe, gown, stole
stolatae	
stolatus	
stramentum	that which is spread over, a covering, housing
strata	
stratum	a covering, horse-cloth, housing, saddle
stratus	prostrate, prone, lying
stria	
striata	
striatura	
stridor	a harsh noise, shrill sound, creak, grating, hiss, rattle, buzz
striglium	
strio	
stropha	a trick, artifice
strophus	
structilis	
structio	
structura	a building, mode of building, construction
structus	
struma	a scrofulous tumor, swollen gland, struma
struo	to place together, heap up, pile, arrange
studens	
studeo	to give attention, be eager, be zealous, take pains, be diligent, be busy with, be devoted, strive after, apply oneself, pursue, desire, wish
studiosi	
studiosus	eager, zealous, assiduous, anxious, fond, studious
studium	application, assiduity, zeal, eagerness, fondness, inclination, desire, exertion, endeavor, study
stupeo	to be struck senseless, be stunned, be benumbed, be aghast, be astounded, be amazed, be stupefied
stupor	numbness, dulness, insensibility, stupor
stylobata	
sua	
suavio	
suavior	to kiss
suavis	sweet, agreeable, grateful
suavitas	sweetness, pleasantness, agreeableness
sub	under, below, beneath, underneath, behind
subactio	a thorough working
subactus	
subarescens	
sub-cerno	
subditus	
subdiu	
subdo	to put under, set to, apply
subduco	to draw away, take away, lead away, carry off, wrest, withdraw, remove
subductio	a withdrawal, drawing up, hauling ashore
subeo	to come under, go under, enter
subgrundiis	
subicio	to throw under, place under, cast below
subigo	to drive up, bring up
subinde	immediately after, just after, presently, forthwith, thereupon
subindo	
subis	
sublevo	to lift from beneath, raise up, hold up, support
sublica	a stake, pile, palisade
sublimo	
sub-mano	
sub-ministro	
sub-reicio	
subscribo	to write underneath, inscribe below, write down
subscudes	
subscudibus	
subsellium	a low bench, seat, form
subsidentia	
subsiderit	
subsido	to sit down, crouch down, squat, settle down, sink down
substerno	to strew under, scatter below, spread beneath
substructio	a foundation, substructure
substructum	
substruo	to build beneath, underbuild, lay
subsum	to be under, be behind
subtemen	that which is woven in, a woof, weft
subtendo	
subter	
subterfluo	
subterraneum	
subterraneus	underground, subterranean
subtilia	
subtilis	fine, nice, delicate
subtilitas	keenness, acuteness, penetration, definiteness, exactness, subtlety
subtiliter	finely, acutely, minutely, accurately, in detail
subtus	below, beneath, underneath
subvectio	a carrying up, conveying
subvesperus	
sub-jacio	
subjectio	
subjecto	
subjectum	
subjectus	
subjugia	
subjugius	
subjungo	
succerno	
succido	
succingo	to gird below, tuck up, gird, gird about, girdle
succumbo	to fall down, lie down, sink
succuneatus	
succurro	to run under, run to help, hasten to the aid of, help, aid, assist, succor
suco	a sucker
sucula	
suculus	
sucus	a juice, moisture, sap, liquor
sudatio	
sudis	a stake, pile
sudo	to sweat, perspire
sudor	sweat, perspiration
sudorus	
suffero	to take up, submit to, undergo, bear, endure, suffer
suffossio	
suffragium	a voting-tablet, ballot, vote, voice, suffrage
suffundo	to pour below, pour into, pour upon, overspread, suffuse, infuse
suggrunda	
suggrundationem	
sugo	to suck
sui	Reflex
sulphur	
sulphurati	
sulphure	
sulphurosi	
sulphurosum	
sum	to be, exist, live
summa	the top, summit
summas	
summatim	summarily, cursorily, briefly, compendiously
summissa	
summitto	
summum	at the utmost, at farthest, at most
summus	uppermost, highest, topmost
sumo	to take, take up, take in hand, lay hold of, assume
sumptio	a taking
sumptuosus	very expensive, costing much, dear, sumptuous
sumptus	outlay, expense, cost, charge
suo	to sew, stitch, sew up, sew together
super	
supera	above
superatio	
superbia	loftiness, haughtiness, pride, arrogance
superbio	to be haughty, take pride, plume oneself
supercilium	an eyebrow
superius	
supernas	
supernatibus	
superne	from above, above, upwards
supernus	that is above, celestial, supernal
supero	to go over, rise above, overtop, surmount, transcend
superus	that is above, upper, higher
supervacuus	useless, needless, unnecessary, superfluous, redundant
supinus	backwards, bent backwards, thrown backwards, on the back, supine
supo	
supplanto	to trip up the heels of, throw down
supplementum	that which fills out, supplies, reinforcements
supplicatio	a public prayer, supplication, religious solemnity, day of prayer, day of humiliation, thanksgiving day, festival
supplico	to kneel down, humble oneself, pray humbly, beseech, beg, implore, supplicate
suppono	to put below, set under
suppressor	
supprimo	to sink, send to the bottom
supra	
surdus	deaf
surgo	to rise, arise, get up, stand up
surrotatus	
surrufus	
surruo	
sursum	from below, up, upwards, on high
sus	a swine, hog, pig, boar, sow
suscipio	to take, catch, take up, lift up, receive
suscito	to lift up, raise, elevate
suspectus	
suspendo	to hang up, hang, suspend
suspensio	
suspensura	
suspicio	
suspiciosus	full of suspicion, mistrustful, ready to suspect, suspicious
suspicor	to mistrust, suspect
sustinentia	
sustineo	to hold up, hold upright, uphold, bear up, keep up, support, sustain
sutrina	
sutrinus	of shoemakers
suum	
suus	of oneself, belonging to oneself, his own, her own, his, her, its, their
symmetria	
symmetros	
sympathia	
symphonia	an agreement of sounds, concord, harmony, symphony
synhemmenon	
systylos	
S	
Salmacis	a fountain in Caria
Salpia	
Salpinus	
Samiramis	
Samius	of Samos
Samos	an island near Ephesus
Samus	
Sardiani	
Sardianus	
Sarnacus	
Saturnius	of Saturn, Saturnian
Saturnus	Saturn, the ancient Latin god of agriculture and of civilization, identified with the Grecian Kronos
Scopas	
Scopinas	
Scorpionem	
Septimius	
Sicilia	
Silanio	
Silenus	the snub-nosed and drunken tutor of Bacchus
Sinope	
SK	
Smyrna	
Smyrnaei	
Smyrnaeus	
Socrates	
Socraticus	
Soli	
Soractinae	
Statonensi	
Stator	
Stratoniceum	
Stratoniceus	
Sunium	
Susa	
Susis	
Syene	
Syracusae	
Syracusius	
Syria	
Syrie	
Syrius	
tabella	a small board
taberna	a rude dwelling, hut, cabin
tablinum	
tabula	a board, plank
tabulatio	a planking, flooring, floor
tabulatum	a board-work, flooring, floor, story
tabulatus	
tabulinum	
tactus	a touching, touch, handling
taeda	a resinous pine-tree, pitch-pine
taenia	a band, hair-band, ribbon, fillet
talea	a slender staff, rod, stick, stake, bar
talentum	a talent, half a hundred-weight
talis	such, of such a kind, such like, the like
talus	an ankle, ankle-bone, pasternbone, knuckle-bone
tam	quam
tamen	notwithstanding, nevertheless, for all that, however, yet, still
tametsi	notwithstanding that, although, though
tamquam	as much as, so as, just as, like as, as if, so to speak: Ge
tandem	at length, at last, in the end, finally
tango	to touch
tanti	
tanto	
tantundem	just so much, just as much, the same amount
tantus	of such size, of such a measure, so great, such
tarditas	slowness, tardiness, sluggishness
tardus	slow, not swift, sluggish, tardy
taurus	a bull, bullock, steer
taxillus	a small die
tector	a plasterer, stuccoworker, pargeter
tectorium	
tectorius	relating to overlaying, concerned with surface decoration
tectum	a covered structure, roofed enclosure, shelter, house, dwelling, abode, roof
tego	to cover, cover over
tegula	a tile, roof-tile
tegulae	
tegulum	
tela	a web
telamo	
telis	
tellus	the earth, globe
telum	a missile weapon, missile, dart, spear, shaft, javelin
temerarius	rash, heedless, thoughtless, imprudent, inconsiderate, indiscreet, unadvised, precipitate
temperatio	a due mingling, fit proportion, proper combination, symmetry, constitution, temperament
temperatura	
tempero	to observe proper measure, be moderate, restrain oneself, forbear, abstain, be temperate, act temperately
tempestas	a portion of time, point of time, time, season, period
tempestivus	of the right time, at the proper time, timely, seasonable, opportune, fitting, appropriate, suitable
templum	an open place for observation, place marked off by the augur's staff
tempus	
temulenti	
temulentus	drunk, drunken, intoxicated, tipsy
tendo	to stretch, make tense, stretch out, spread out, distend, extend
tenebra	
tenebrae	darkness, gloom
tenebro	
teneo	to hold, keep, have, grasp, hold fast
tener	soft, delicate, tender, yielding
teneri	
teneritas	softness, tenderness
tenor	a holding on, continuance, uninterrupted course, career
tentiones	
tenue	
tenuis	drawn out, meagre, slim, thin, lank, slender
tenuitas	thinness, slenderness, fineness, smallness, tenuity
tenuo	to make thin, make slender, wear away, dilute, rarefy, attenuate
tenus	a stretched cord, noose
tepesco	to become warm, grow lukewarm, be warmed
tepidarium	
tepidarius	
tepidus	moderately warm, lukewarm, tepid
tepor	a gentle warmth, lukewarmness, tepidity, tepor
teporus	
ter	three times, thrice
terdecies	
terebra	
terebrata	
terebratione	
terebrationem	
terebrationes	
terebratur	
teredo	a boring worm, wood-fretter, moth
teres	rounded off, rounded, well-turned, round, smooth
terminatio	a bounding, fixing of limits, establishing lines
termino	to set bounds, mark off by boundaries, bound, limit
terni	three each
tero	to rub, rub away, wear away, bruise, grind, bray triturate
terra	the earth
terrena	
terrenum	
terrenus	of the globe, on the earth, earthly, terrestrial, terrene
terrestria	
terrestris	of the earth, on land, earth-, land-, terrestrial
terrosus	
tertiae	
tertiarium	
tertiarius	
tertio	for the third time
tertius	the third
tessera	a die, cube
testa	a piece of burned clay, brick, tile
testaceum	
testaceus	
testimonium	witness, evidence, attestation, testimony
testis	
testo	
testudineatus	
testudo	a tortoise
tetrachordon	
tetrachordos	
tetradoron	
tetrante	
tetrantem	
tetrantes	
tetrantibus	
tetrantorum	
tetraphoris	
tetraphororum	
tetrastylon	
tetrastylos	
textae	
textrina	
textrinum	a weaver's shop, place for weaving cloths
thalamus	an inner room, chamber, apartment
theatrum	a play-house, theatre
theca	an envelope, hull, cover, case, sheath
thesaurus	something laid up, a hoard, treasure, provision, store
tholus	a dome, cupola, rotunda
thracias	
thymelici	
thymelicus	
thyretri	
thyroma	
thyromaton	
tiburtina	
tignum	building-materials, a piece of timber, trunk of a tree, log, stick, post, beam
tigris	a tiger, tigress
tilia	the linden-tree, lime-tree
timidus	fearful, afraid, faint-hearted, cowardly, timid
timor	fear, dread, apprehension, timidity, alarm, anxiety
tincta	dyed cloths, colored stuffs
tinctus	
tinea	a gnawing worm, moth, bookworm
tingo	to wet, moisten, bathe, dip, imbue
tofus	tufa, tuff, porous stone
tollo	to lift, take up, raise, elevate, exalt
tomice	
tonitrus	thunder
tonitruum	
tono	to make a loud noise, roar, resound, thunder
tonor	
tonsor	a shearer, clipper, shaver, hair-cutter, barber
tonus	
topeodis	
topia	
torcular	
torcularium	
torcularius	
tores	
tormentum	an engine for hurling
torno	to turn in a lathe, round off
tornus	a turner's wheel, lathe
torqueo	to turn, turn about, turn away, twist, bend, wind
torta	
tortum	
torulus	
torum	
torus	a swelling, protuberance, fleshy part, muscle, brawn
totidem	just so many, just as many, the same number of
totus	all, all the, all at once, the whole, entire, total
trabecula	
trabs	a beam, timber, rafter
tracta	
tractabilis	that may be handled, workable, tangible, manageable, tractable
tractabilitas	
tractatio	a handling, wielding, management, treatment
tracto	to draw violently, drag, tug, haul, pull
tractoria	
tractoriae	
tractorius	
tractum	
tractus	
traditor	a betrayer, traitor
traditus	
trado	to give up, hand over, deliver, transmit, surrender, consign
traduco	
traductor	a conveyer, transferrer
tragicus	of tragedy, tragic
tragoedia	a tragedy
traho	to draw, drag, haul, train along, draw off, pull forth, drag away
traicio	to throw across, cause to cross, cause to go across, put over, transfer, throw over, shoot across
trans	across, over, to the farther side of
transeo	perf
transfero	to bear across, bring through, carry over, convey over, transport, transfer
transiliendo	
transitio	a going across, going over, passing over, passage
transitus	a going over, passing over, passage
translatio	a carrying across, removal, transporting, transferring
transmarinus	beyond sea, from over the sea, transmarine
transmigro	to remove, migrate, transmigrale
transmuto	to change, shift, transmute
trans-reicio	
transtrum	a cross-beam, crossbank, bank for rowers, thwart
transversaria	
transversarius	lying across, transverse
transversum	
transverto	
trans-jacio	
trajectio	
trajecto	
trajectura	
trajectus	
trecentesimus	the three-hundredth
trecenties	three hundred times
tredecim	thirteen
tres	three
tribunal	a raised platform for the seats of magistrates, judgment-seat, tribunal
tribunalia	
tribuo	to assign, impart, allot, bestow, confer, yield, give
tribus	a third part of the people
tributim	through each tribe, tribe by tribe, by tribes
tributum	a stated payment, contribution, tribute
tributus	formed into tribes, marshalled by tribes
tricenarius	
triceni	thirty at a time, thirty each, thirty
tricensimo	
trichalcon	
tricies	
triclinium	a couch for three persons reclining at meals, eating-couch, dinner-sofa, table-couch
triduum	three days' time, three days
triens	a third part, third
trientalis	
triginta	thirty
triglyphus	
trigon	a ball stuffed with hair, playing-ball
trigonium	
trigonoe	
trigonum	
trigonus	
tripertito	in three parts, into three parts
triplex	threefold, triple
triplicia	
triplico	
triplinthius	
trispastos	
trite	
tritus	
triumpho	to march in triumphal procession, celebrate a triumph, triumph
triumphus	a triumphal procession, triumph, celebration of victory by a public entrance into Rome
trochilus	
trochlea	
troianas	
tropaeum	a memorial of victory, trophy
tropaeus	
trucido	to cut to pieces, slaughter, butcher, massacre
trudo	to thrust, push, shove, crowd forward, press on, drive, impel
trullissatio	
trullisso	
trullizetur	
trunco	to maim, mutilate, shorten, cut off
truncus	
trutina	a balance, pair of scales
tu	thou, you
tuba	a trumpet, war-trumpet
tubula	
tubulus	
tueor	to look at, gaze upon, behold, watch, view, regard, consider, examine
tugurium	a hut, cot, cottage
tulo	
tum	then, at that time, in those times
tumeo	to swell, be swollen, be tumid, puff out, be inflated
tumesco	to begin to swell, swell up
tumidus	swollen, swelling, rising high, protuberant, tumid
tumor	the state of being swollen, swelling, tumor
tumulus	a heap of earth, mound, hill, hillock
tunc	then, at that time, just then, on that occasion
tundo	to beat, strike, thump, buffet
turgentes	
turgesco	to begin to swell, swell up, swell
turgidus	swollen, inflated, distended, turgid
turibulum	an incense-pan, incense-burner, censer
turifer	incense-bearing, yielding incense
turricula	
turris	a tower
tuscanica	
tuscanicis	
tuscanico	
tuscanicorum	
tuscanicum	
tussio	to cough, have a cough
tussis	a cough
tute	safely, securely, in safety, without danger
tutela	a watching, keeping, charge, care, safeguard, defence, protection
tuto	safely, securely, in safety, without danger
tutum	
tuus	thy, thine, your, yours
tympanium	
tympanum	a drum, timbrel, tambour, tambourine
T	
Tanais	
Tarentini	
Tarentinus	
Tarentum	
Tarentus	
Tarquinienses	
Tarquiniensis	of Tarquinii
Tarsus	
Teanum	
Teos	
Terentius	
Terracina	
Terracinae	
Tertius	
Thales	
Thasius	
Thasus	
Thebaicus	
Themistocles	
Theo	
Theocydes	
Theodorus	
Theodosius	
Theodotus	
Theophrastus	
Thessali	
Thessalia	
Thessalius	
Thessalus	
Thracia	
Thracius	
Tiberinus	
Tiberis	
Tiburtinum	
Tiburtinus	
Tigris	
Timaeus	
Timavus	
Timotheus	
Tmoliten	
Tralles	
Tritonem	
Troezene	
Troezenius	
Troius	of Troy, Trojan
Troja	
Trojani	
Trojanum	
Trojanus	
Trypho	
Tyana	
Tyrius	
Tyrrenico	
uber	
ubi	Relat., in which place, in what place, where
udo	
udus	wet, moist, damp, humid
ullus	negation
ulmus	an elm, elm-tree
ulter	
ulterior	farther, on the farther side, that is beyond, more remote
ulteriore	
ultima	
ultimi	
ultimum	finally, for the last time
ultra	
ultro	to the farther side, beyond, on the other side
ulva	swamp-grass, sedge
um	
umbilicus	the navel
umbra	a shade, shadow
umbro	
umbrosa	
umbrosus	full of shade, rich in shade, shady, umbrageous
umerus	the upper arm, shoulder
umidum	
umidus	moist, humid, damp, dank, wet
umor	a liquid, fluid, moisture
unaquaeque	
uncinus	
unctum	a rich banquet, savory dish
unctus	anointed, oiled
unda	a wave, billow
unde	Relat., from which place, whence
undecim	eleven
undenas	
undetriginta	
undo	to rise in waves, throw up waves, surge, swell
ungo	to smear, besmear, anoint
unguis	a nail
ungula	a hoof, claw, talon
uniuscuiusque	
universi	
universum	
universus	all together, all in one, whole, entire, collective
uno	
unoquoque	
unus	One, a single
ur	
urbanus	of the city, of the town, in the city, in Rome
urbs	a walled town, city
urceus	a pitcher, water-pot, ewer
urina	urine
urinus	
uro	to burn
usque	all the way, right on, without interruption, continuously, even
usta	
ustilatae	
ustilatis	
usus	use, practice, employment, exercise, enjoyment
ut	
uter	
uti	
utile	
utilis	useful, serviceable, beneficial, profitable, advantageous, expedient, to good purpose
utilitas	use, usefulness, utility, serviceableness, service, expediency, benefit, profit, advantage, welfare
utiliter	usefully, profitably, beneficially, advantageously
utinam	oh that! I wish that! if only! would to heaven! would that!
utique	
uto	
utor	to use, make use of, employ, profit by, take advantage of, enjoy, serve oneself with
utrasque	
utrimque	on both sides, on either hand, from each side, on the one side and on the other
utroque	to both places, on both sides, in each direction
utrum	ne
uxor	a wife, spouse, consort
Ulixes	
Umbria	
Uticenses	
Uticensis	
vaccinium	a blueberry, whortleberry
vacuitas	a being without, freedom, absence, exemption
vacuum	
vacuus	empty, void, unoccupied, vacant, free, clear, devoid of, without
vado	to go, walk, go hastily, proceed rapidly, rush
vago	
vagor	to stroll about, go to and fro, ramble, wander, roam, range, rove
valeo	to be strong, be vigorous, have strength, be able
valetudo	habit, state of body, state of health, health
validus	strong, stout, able, powerful, robust, vigorous
valles	a valley, vale
vallo	to fortify with a rampart, surround with palisades, intrench, circumvallate
valva	
valvae	a pair of doorleaves
valvatus	
vanus	containing nothing, empty, void, vacant
vapor	steam, exhalation, vapor
vaporo	to steam, smoke, fumigate, heat, warm
vaporus	
vara	
varia	
varicus	with feet apart, stradlling
varietas	difference, diversity, variety
vario	to diversify, variegate, change
varius	variegated, party-colored, mottled, diverse, various
varo	
varus	bent, turned awry, crooked
vasarium	furniture-money, equipage-money, outfit
vastatio	a laying waste, desolating, ravaging, devastation
vastitas	an empty place, waste, desert
vasto	to make empty, deprive of occupants, desert, vacate, void, empty, lay waste, desolate, ravage, devastate, destroy
vastus	empty, unoccupied, waste, desert, devastated
vasum	
vectiarius	
vectigal	a payment to the state, revenue, toll, tax, impost, excise, duty, tribute
vectigalis	of imposts, of taxes
vectis	a strong pole, bar, lever
vecto	to bear, carry, convey
vectura	a bearing, carriage, conveyance, transportation
vehemens	eager, violent, furious, impetuous, ardent, vehement
vehementer	eagerly, impetuously, ardently, violently, earnestly, vehemently
vehementia	
veho	to bear, carry, convey, draw
vel	
vela	
vello	to pluck, pull, tear away, pull out
vellus	wool shorn off, a fleece
velo	to cover, cover up, enfold, wrap, envelop, veil
velum	that which propels, a sail
velut	even as, just as, like as, like
vena	a blood-vessel, vein
venalis	of selling, to be sold, for sale, purchasable, venal
veneno	to poison, injure by slander
veneria	
venerio	
venio	to come
venor	to hunt, chase
venter	the belly, paunch
vento	
ventosus	full of wind, windy
ventus	wind
venum	that which is sold, that which is for sale, sale
venustas	loveliness, comeliness, charm, grace, beauty, elegance, attractiveness
venusto	
venustus	charming, pleasing, winning, agreeable, beautiful
verbum	a word
vergiliarum	
vergilias	
vergiliis	
vergo	to bend, turn, be inclined, lie, be situated
veritas	truth, truthfulness, verity, reality
verna	a home-born slave, house-servant, family slave
verno	to spring, feel new life, grow young
vernum	
vernus	of spring, spring
vero	in truth, in fact, certainly, truly, to be sure, surely, assuredly
verro	to sweep, brush, scour, sweep out, sweep together
versabundus	
versatilis	versatile
versatio	
verso	to turn often, keep turning, handle, whirl about, turn over
versor	
versum	turned in the direction of, towards
versura	a conversion, funding, borrowing to pay a debt
versus	
vertex	a whirl, eddy, whirlpool, vortex
verticula	
verticulum	
verticulus	
verto	to turn, turn up, turn back, direct
verum	
verus	true, real, actual, genuine
vesco	
vesica	the bladder, urinary bladder
vespertinus	of evening, of even-tide, evening
vesperugo	
vesperus	
vester	your, yours, of you
vestibulum	an enclosed space before a house, fore-court, entrance-court, vestibule
vestigium	the bottom of the foot, sole
vestimentum	clothing, a garment, vestment, article of clothing, dress
vestio	to cover with a garment, provide with clothing, dress, clothe, vest
vestis	collect., a covering for the body, clothes, clothing, attire, vesture
vestitus	clothing, clothes, dress, apparel, raiment, attire, vesture
vestutatem	
vetera	
veteres	
vetero	
veto	not to suffer, not to permit, to oppose, forbid, prohibit
vetus	old, aged, advanced in years
vetustas	old age, age, long existence
vetustus	aged, old, ancient, of long standing
vexo	to shake, jolt, toss violently
via	a way, highway, road, path, street
viaticum	travellingmoney, provision for a journey, viaticum
viaticus	
viator	a wayfarer, traveller
viatorius	
vicenarius	
vicesimus	the twentieth
vicinitas	neighborhood, nearness, proximity, vicinity
vicinum	
vicinus	of the neighborhood, near, neighboring, in the vicinity
vicis	change, interchange, alternation, succession, vicissitude
victor	a conqueror, vanquisher, victor
victoria	victory
victus	that which sustains life, means of living, sustenance, nourishment, provisions, victuals
vicus	a row of houses, street, quarter, ward
videns	
video	to see, discern, perceive
viduatus	
viduo	to deprive, bereave
vigilantia	wakefulness
vigilo	to watch, keep awake, not to sleep, be wakeful
viginti	twenty
vigor	liveliness, activity, force, vigor
villa	a country-house, country-seat, farm, villa
villum	a sup of wine
villus	a tuft of hair, shaggy hair, wool, fleece
vinarium	
vinarius	of wine, for wine
vincio	to bind, bind about, fetter, tie, fasten, surround, encircle
vinco	to conquer, overcome, get the better of, defeat, subdue, vanquish, be victorious
vindico	to assert a claim to, demand formally, ask judgment for
vinea	a plantation of vines, vine-garden, vineyard
vineus	
vinum	wine
vinus	
vio	
viola	the violet, gillyflower
violaceus	
violo	to treat with violence, injure, dishonor, outrage, violate
vipereus	of a viper, of a serpent
vir	a male person, adult male, man
vira	
vireo	to be green, be verdant
virga	a slender green branch, twig, sprout
virginale	
virginalis	of a maiden, of a virgin, maidenly, virgin, virginal
virgo	a maid, maiden, virgin
virgula	a little twig, small rod, wand
viride	
viridia	
viridis	green
virilia	
virilis	of a man, like a man, manly, masculine, virile
viror	
virtus	manliness, manhood, strength, vigor, bravery, courage, excellence
virus	a potent juice, medicinal liquid, poison, venom, virus
vis	strength, force, vigor, power, energy, virtue
visitatio	
visito	to go to see, visit
visium	
viso	to look at attentively, view, behold, survey
visum	a thing seen, sight, appearance, vision
visus	a looking, look, act of seeing, power of sight, vision
vita	life
vitalis	of life, vital
vitex	
vitio	to make faulty, injure, spoil, mar, taint, corrupt, infect, vitiate, defile
vitiosa	
vitiosus	full of faults, faulty, defective, invalid
vitis	a vine, grape-vine
vitium	a fault, defect, blemish, imperfection, vice
vito	to shun, seek to escape, avoid, evade
vitrum	glass
vitupero	to inflict censure, find fault with, blame, censure, reproach, disparage, vituperate
vivo	to live, be alive, have life
vivum	
vivus	alive, living, having life
vix	with difficulty, with much ado, hardly, scarcely, barely
vocabulum	an appellation, designation, name
vocito	to be wont to call, call habitually, name
voco	to call, summon, invoke, call together, convoke
volo	a volunteer
volturnus	
volucra	
volucris	
volumen	that which is rolled, a coil, whirl, wreath, fold, eddy
volun	
voluntas	will, free-will, wish, choice, desire, inclination
voluptas	satisfaction, enjoyment, pleasure, delight
voluta	
voluto	to roll, turn, twist, tumble about
volvo	to cause to revolve, roll, turn about, turn round
vomo	to puke, spew, throw up, vomit
vorago	an abyss, gulf, whirlpool, depth, chasm
votivus	of a vow, promised by a vow, given under a vow, votive
votum	a promise to a god, solemn pledge, religious engagement, vow
voveo	to vow, promise solemnly, engage religiously, pledge, devote, dedicate, consecrate
vox	a voice, sound, tone, utterance, cry, call
vulgo	
vulgus	
vulnero	
vulnus	
vus	
V	
Varro	
Velinus	
Venetia	
Venus	
Vesta	daughter of Saturn and Ops, goddess of flocks and herds, and of the household; in her temple the Vestal virgins maintained a perpetual fire
Vestinus	
Vestorius	
Vesuvius	
Vejovis	
VII	
VIII	
VIIII	
Volcanius	of Vulcan, Vulcanian
Volcanus	Vulcan, the fire-god, son of Jupiter and Juno
Volsiniensis	
VSF	
xanthos	
xenium	
xis	
xystum	
xystus	a covered colonnade for winter exercise
X	
Xantho	
Xanthus	
Xenophanes	
XII	
XIII	
XIIII	
XL	
XLII	
XLVI	
Xuthus	
XV	
XVI	
XVII	
XVIII	
XVIIII	
XX	
XXI	
XXIII	
XXIIII	
XXIV	
XXV	
XXVII	
XXVIII	
XXVIIII	
XXX	
XXXII	
XXXIV	
XXXVI	
XXXXII	
XXXXV	
zelo	
zelus	
zona	a woman's girdle, belt, zone
zophora	
zophoro	
zophoroe	
zophorum	
zophorus	
Z	
Zacynthus	
Zama	
Zeno	
Zoilus	
jaceo	
jacio	
jacto	
jactus	
jaculor	
jam	
jamjam	
janua	
jejunitas	
juba	
jubeo	
jucunditas	
jucundus	
judex	
judicatus	
judicium	
judico	
jugis	
jugo	
jugum	
jugumento	
jugus	
jumentum	
junctura	
junctus	
juncus	
jungo	
juniperus	
jurisconsultus	
juro	
jus	
justa	
justum	
justus	
juxta	
Jovius	
Juba	
Julius	
Juno	
Junonius	
